OBJECTID,GEOID,Block,Block_Group,Census_Tract,County,State,Total,Hispanic_or_Latino,Not_Hispanic,Population_of_One_Race,White_Alone,Black_Alone,Some_other_race_alone,Population_of_two_or_more_ra_14
-1,131210007002000.000000000000000,Block 2000, Block Group 2, Census Tract 7, Fulton County, Georgia,2553,93,2460,2458,204,2246,0,2
-1,131210035002037.000000000000000,Block 2037, Block Group 2, Census Tract 35, Fulton County, Georgia,2425,547,1878,1877,439,1407,13,1
-1,131210076042000.000000000000000,Block 2000, Block Group 2, Census Tract 76.04, Fulton County, Georgia,2368,17,2351,2331,17,2314,0,20
-1,131210028011010.000000000000000,Block 1010, Block Group 1, Census Tract 28.01, Fulton County, Georgia,2082,132,1950,1880,415,1247,11,70
-1,131210116181000.000000000000000,Block 1000, Block Group 1, Census Tract 116.18, Fulton County, Georgia,2024,246,1778,1731,876,272,20,47
-1,131210114321001.000000000000000,Block 1001, Block Group 1, Census Tract 114.32, Fulton County, Georgia,1976,587,1389,1302,540,616,15,87
-1,131210068011001.000000000000000,Block 1001, Block Group 1, Census Tract 68.01, Fulton County, Georgia,1950,310,1640,1638,415,1209,0,2
-1,131210114244001.000000000000000,Block 4001, Block Group 4, Census Tract 114.24, Fulton County, Georgia,1944,128,1816,1752,1162,213,0,64
-1,131210116561000.000000000000000,Block 1000, Block Group 1, Census Tract 116.56, Fulton County, Georgia,1886,112,1774,1689,1082,87,30,85
-1,131210019011000.000000000000000,Block 1000, Block Group 1, Census Tract 19.01, Fulton County, Georgia,1864,109,1755,1644,1446,62,16,111
-1,131210100062004.000000000000000,Block 2004, Block Group 2, Census Tract 100.06, Fulton County, Georgia,1836,132,1704,1648,988,451,19,56
-1,131210116273000.000000000000000,Block 3000, Block Group 3, Census Tract 116.27, Fulton County, Georgia,1777,107,1670,1646,509,238,28,24
-1,131210101294000.000000000000000,Block 4000, Block Group 4, Census Tract 101.29, Fulton County, Georgia,1716,595,1121,1077,623,353,9,44
-1,131210101371000.000000000000000,Block 1000, Block Group 1, Census Tract 101.37, Fulton County, Georgia,1671,162,1509,1458,1145,206,22,51
-1,131210113092002.000000000000000,Block 2002, Block Group 2, Census Tract 113.09, Fulton County, Georgia,1670,37,1633,1615,68,1532,9,18
-1,131210102161000.000000000000000,Block 1000, Block Group 1, Census Tract 102.16, Fulton County, Georgia,1647,270,1377,1328,674,505,12,49
-1,131210114294000.000000000000000,Block 4000, Block Group 4, Census Tract 114.29, Fulton County, Georgia,1629,148,1481,1401,1010,134,5,80
-1,131210114401000.000000000000000,Block 1000, Block Group 1, Census Tract 114.40, Fulton County, Georgia,1624,99,1525,1476,1053,268,10,49
-1,131210116532000.000000000000000,Block 2000, Block Group 2, Census Tract 116.53, Fulton County, Georgia,1598,69,1529,1477,1021,177,10,52
-1,131210081032001.000000000000000,Block 2001, Block Group 2, Census Tract 81.03, Fulton County, Georgia,1575,39,1536,1521,10,1507,3,15
-1,131210116502000.000000000000000,Block 2000, Block Group 2, Census Tract 116.50, Fulton County, Georgia,1547,69,1478,1434,369,147,17,44
-1,131210096012001.000000000000000,Block 2001, Block Group 2, Census Tract 96.01, Fulton County, Georgia,1533,128,1405,1357,897,323,21,48
-1,131210116241000.000000000000000,Block 1000, Block Group 1, Census Tract 116.24, Fulton County, Georgia,1520,81,1439,1382,825,132,0,57
-1,131210100061000.000000000000000,Block 1000, Block Group 1, Census Tract 100.06, Fulton County, Georgia,1487,95,1392,1314,891,266,6,78
-1,131210116453002.000000000000000,Block 3002, Block Group 3, Census Tract 116.45, Fulton County, Georgia,1474,108,1366,1312,725,243,8,54
-1,131210114431000.000000000000000,Block 1000, Block Group 1, Census Tract 114.43, Fulton County, Georgia,1472,49,1423,1392,1035,40,5,31
-1,131210102122000.000000000000000,Block 2000, Block Group 2, Census Tract 102.12, Fulton County, Georgia,1462,1354,108,99,36,45,1,9
-1,131210077081001.000000000000000,Block 1001, Block Group 1, Census Tract 77.08, Fulton County, Georgia,1446,18,1428,1399,2,1397,0,29
-1,131210105223001.000000000000000,Block 3001, Block Group 3, Census Tract 105.22, Fulton County, Georgia,1435,28,1407,1397,11,1356,3,10
-1,131210010022007.000000000000000,Block 2007, Block Group 2, Census Tract 10.02, Fulton County, Georgia,1433,98,1335,1289,1124,57,0,46
-1,131210078103005.000000000000000,Block 3005, Block Group 3, Census Tract 78.10, Fulton County, Georgia,1398,10,1388,1372,5,1359,4,16
-1,131210103112005.000000000000000,Block 2005, Block Group 2, Census Tract 103.11, Fulton County, Georgia,1391,21,1370,1349,8,1341,0,21
-1,131210116302000.000000000000000,Block 2000, Block Group 2, Census Tract 116.30, Fulton County, Georgia,1368,139,1229,1183,693,186,8,46
-1,131210096041002.000000000000000,Block 1002, Block Group 1, Census Tract 96.04, Fulton County, Georgia,1349,160,1189,1162,834,230,9,27
-1,131210078081010.000000000000000,Block 1010, Block Group 1, Census Tract 78.08, Fulton County, Georgia,1344,0,1344,1325,0,1323,0,19
-1,131210010022015.000000000000000,Block 2015, Block Group 2, Census Tract 10.02, Fulton County, Georgia,1332,86,1246,1197,1046,26,4,49
-1,131210095042002.000000000000000,Block 2002, Block Group 2, Census Tract 95.04, Fulton County, Georgia,1313,107,1206,1146,747,334,2,60
-1,131210091061003.000000000000000,Block 1003, Block Group 1, Census Tract 91.06, Fulton County, Georgia,1311,143,1168,1105,585,415,9,63
-1,131210073012000.000000000000000,Block 2000, Block Group 2, Census Tract 73.01, Fulton County, Georgia,1302,35,1267,1258,4,1250,3,9
-1,131210105341001.000000000000000,Block 1001, Block Group 1, Census Tract 105.34, Fulton County, Georgia,1297,62,1235,1228,118,1075,3,7
-1,131210114211002.000000000000000,Block 1002, Block Group 1, Census Tract 114.21, Fulton County, Georgia,1275,564,711,682,222,436,9,29
-1,131210114384001.000000000000000,Block 4001, Block Group 4, Census Tract 114.38, Fulton County, Georgia,1272,464,808,768,345,349,11,40
-1,131210114173003.000000000000000,Block 3003, Block Group 3, Census Tract 114.17, Fulton County, Georgia,1264,83,1181,1134,938,94,7,47
-1,131210098032002.000000000000000,Block 2002, Block Group 2, Census Tract 98.03, Fulton County, Georgia,1261,56,1205,1171,724,398,11,34
-1,131210116353013.000000000000000,Block 3013, Block Group 3, Census Tract 116.35, Fulton County, Georgia,1252,26,1226,1210,85,73,12,16
-1,131210103102000.000000000000000,Block 2000, Block Group 2, Census Tract 103.10, Fulton County, Georgia,1247,16,1231,1209,21,1186,0,22
-1,131210116432001.000000000000000,Block 2001, Block Group 2, Census Tract 116.43, Fulton County, Georgia,1236,105,1131,1089,331,208,19,42
-1,131210116314000.000000000000000,Block 4000, Block Group 4, Census Tract 116.31, Fulton County, Georgia,1232,93,1139,1090,495,178,14,49
-1,131210116581000.000000000000000,Block 1000, Block Group 1, Census Tract 116.58, Fulton County, Georgia,1232,89,1143,1103,642,169,10,40
-1,131210092021000.000000000000000,Block 1000, Block Group 1, Census Tract 92.02, Fulton County, Georgia,1224,92,1132,1083,665,291,8,49
-1,131210096071000.000000000000000,Block 1000, Block Group 1, Census Tract 96.07, Fulton County, Georgia,1222,15,1207,1202,1154,36,0,5
-1,131210090012001.000000000000000,Block 2001, Block Group 2, Census Tract 90.01, Fulton County, Georgia,1218,115,1103,1063,647,296,2,40
-1,131210113105000.000000000000000,Block 5000, Block Group 5, Census Tract 113.10, Fulton County, Georgia,1215,147,1068,1046,25,1014,4,22
-1,131210101263000.000000000000000,Block 3000, Block Group 3, Census Tract 101.26, Fulton County, Georgia,1213,299,914,876,325,329,1,38
-1,131210118011000.000000000000000,Block 1000, Block Group 1, Census Tract 118.01, Fulton County, Georgia,1212,55,1157,1125,370,584,0,32
-1,131210105192011.000000000000000,Block 2011, Block Group 2, Census Tract 105.19, Fulton County, Georgia,1210,26,1184,1169,51,1115,0,15
-1,131210114392000.000000000000000,Block 2000, Block Group 2, Census Tract 114.39, Fulton County, Georgia,1206,253,953,921,418,414,1,32
-1,131210115121002.000000000000000,Block 1002, Block Group 1, Census Tract 115.12, Fulton County, Georgia,1191,43,1148,1118,998,69,0,30
-1,131210114303000.000000000000000,Block 3000, Block Group 3, Census Tract 114.30, Fulton County, Georgia,1186,630,556,546,150,338,19,10
-1,131210116242002.000000000000000,Block 2002, Block Group 2, Census Tract 116.24, Fulton County, Georgia,1186,41,1145,1078,727,73,1,67
-1,131210114322000.000000000000000,Block 2000, Block Group 2, Census Tract 114.32, Fulton County, Georgia,1180,214,966,931,529,295,12,35
-1,131210092012003.000000000000000,Block 2003, Block Group 2, Census Tract 92.01, Fulton County, Georgia,1178,537,641,632,251,290,3,9
-1,131210105362009.000000000000000,Block 2009, Block Group 2, Census Tract 105.36, Fulton County, Georgia,1178,32,1146,1121,26,1071,15,25
-1,131210116433002.000000000000000,Block 3002, Block Group 3, Census Tract 116.43, Fulton County, Georgia,1177,165,1012,992,241,168,8,20
-1,131210114432003.000000000000000,Block 2003, Block Group 2, Census Tract 114.43, Fulton County, Georgia,1162,54,1108,1086,411,159,1,22
-1,131210114262000.000000000000000,Block 2000, Block Group 2, Census Tract 114.26, Fulton County, Georgia,1154,41,1113,1060,818,59,8,53
-1,131210116582000.000000000000000,Block 2000, Block Group 2, Census Tract 116.58, Fulton County, Georgia,1150,105,1045,1018,464,218,19,27
-1,131210114213000.000000000000000,Block 3000, Block Group 3, Census Tract 114.21, Fulton County, Georgia,1144,533,611,586,293,198,11,25
-1,131210105352001.000000000000000,Block 2001, Block Group 2, Census Tract 105.35, Fulton County, Georgia,1143,114,1029,1006,113,885,1,23
-1,131210116522000.000000000000000,Block 2000, Block Group 2, Census Tract 116.52, Fulton County, Georgia,1123,85,1038,1018,504,123,4,20
-1,131210114352000.000000000000000,Block 2000, Block Group 2, Census Tract 114.35, Fulton County, Georgia,1122,168,954,917,651,213,21,37
-1,131210096072000.000000000000000,Block 2000, Block Group 2, Census Tract 96.07, Fulton County, Georgia,1121,87,1034,1007,682,209,2,27
-1,131210011013009.000000000000000,Block 3009, Block Group 3, Census Tract 11.01, Fulton County, Georgia,1101,95,1006,978,740,98,10,28
-1,131210102131000.000000000000000,Block 1000, Block Group 1, Census Tract 102.13, Fulton County, Georgia,1099,130,969,919,338,481,9,50
-1,131210102192000.000000000000000,Block 2000, Block Group 2, Census Tract 102.19, Fulton County, Georgia,1099,90,1009,959,383,462,18,50
-1,131210101302005.000000000000000,Block 2005, Block Group 2, Census Tract 101.30, Fulton County, Georgia,1097,48,1049,1011,510,190,10,38
-1,131210101305000.000000000000000,Block 5000, Block Group 5, Census Tract 101.30, Fulton County, Georgia,1096,28,1068,1059,247,92,0,9
-1,131210116493009.000000000000000,Block 3009, Block Group 3, Census Tract 116.49, Fulton County, Georgia,1096,45,1051,1029,369,64,1,22
-1,131210105202000.000000000000000,Block 2000, Block Group 2, Census Tract 105.20, Fulton County, Georgia,1094,9,1085,1073,55,1006,3,12
-1,131210101063000.000000000000000,Block 3000, Block Group 3, Census Tract 101.06, Fulton County, Georgia,1092,106,986,938,535,349,6,48
-1,131210086011000.000000000000000,Block 1000, Block Group 1, Census Tract 86.01, Fulton County, Georgia,1089,11,1078,1066,0,1065,0,12
-1,131210101333006.000000000000000,Block 3006, Block Group 3, Census Tract 101.33, Fulton County, Georgia,1088,98,990,955,455,298,2,35
-1,131210005013012.000000000000000,Block 3012, Block Group 3, Census Tract 5.01, Fulton County, Georgia,1087,97,990,952,528,253,9,38
-1,131210028022004.000000000000000,Block 2004, Block Group 2, Census Tract 28.02, Fulton County, Georgia,1071,82,989,952,272,531,9,37
-1,131210103152008.000000000000000,Block 2008, Block Group 2, Census Tract 103.15, Fulton County, Georgia,1070,18,1052,1028,1,1020,1,24
-1,131210114342000.000000000000000,Block 2000, Block Group 2, Census Tract 114.34, Fulton County, Georgia,1064,210,854,824,540,192,6,30
-1,131210114391000.000000000000000,Block 1000, Block Group 1, Census Tract 114.39, Fulton County, Georgia,1062,66,996,975,893,52,0,21
-1,131210102193000.000000000000000,Block 3000, Block Group 3, Census Tract 102.19, Fulton County, Georgia,1060,168,892,831,360,419,4,61
-1,131210114332000.000000000000000,Block 2000, Block Group 2, Census Tract 114.33, Fulton County, Georgia,1059,46,1013,978,786,76,1,35
-1,131210114392006.000000000000000,Block 2006, Block Group 2, Census Tract 114.39, Fulton County, Georgia,1056,39,1017,980,866,43,5,37
-1,131210028011009.000000000000000,Block 1009, Block Group 1, Census Tract 28.01, Fulton County, Georgia,1051,82,969,927,237,556,6,42
-1,131210103141000.000000000000000,Block 1000, Block Group 1, Census Tract 103.14, Fulton County, Georgia,1039,12,1027,1011,12,992,4,16
-1,131210116281000.000000000000000,Block 1000, Block Group 1, Census Tract 116.28, Fulton County, Georgia,1036,47,989,967,430,159,3,22
-1,131210116321001.000000000000000,Block 1001, Block Group 1, Census Tract 116.32, Fulton County, Georgia,1021,65,956,936,179,173,5,20
-1,131210105272000.000000000000000,Block 2000, Block Group 2, Census Tract 105.27, Fulton County, Georgia,1010,62,948,924,12,906,5,24
-1,131210116431005.000000000000000,Block 1005, Block Group 1, Census Tract 116.43, Fulton County, Georgia,1010,76,934,903,406,207,6,31
-1,131210105242000.000000000000000,Block 2000, Block Group 2, Census Tract 105.24, Fulton County, Georgia,999,14,985,974,0,967,0,11
-1,131210116402002.000000000000000,Block 2002, Block Group 2, Census Tract 116.40, Fulton County, Georgia,995,122,873,844,644,108,12,29
-1,131210116371001.000000000000000,Block 1001, Block Group 1, Census Tract 116.37, Fulton County, Georgia,992,50,942,898,663,67,0,44
-1,131210101173000.000000000000000,Block 3000, Block Group 3, Census Tract 101.17, Fulton County, Georgia,987,127,860,834,318,430,9,26
-1,131210078064001.000000000000000,Block 4001, Block Group 4, Census Tract 78.06, Fulton County, Georgia,974,2,972,969,3,963,0,3
-1,131210103063013.000000000000000,Block 3013, Block Group 3, Census Tract 103.06, Fulton County, Georgia,967,24,943,915,16,887,1,28
-1,131210114232000.000000000000000,Block 2000, Block Group 2, Census Tract 114.23, Fulton County, Georgia,967,53,914,902,834,22,1,12
-1,131210094071000.000000000000000,Block 1000, Block Group 1, Census Tract 94.07, Fulton County, Georgia,964,101,863,812,431,292,6,51
-1,131210101292000.000000000000000,Block 2000, Block Group 2, Census Tract 101.29, Fulton County, Georgia,960,176,784,740,390,250,11,44
-1,131210011022003.000000000000000,Block 2003, Block Group 2, Census Tract 11.02, Fulton County, Georgia,954,62,892,864,629,114,3,28
-1,131210012063001.000000000000000,Block 3001, Block Group 3, Census Tract 12.06, Fulton County, Georgia,950,81,869,806,584,62,9,63
-1,131210113063001.000000000000000,Block 3001, Block Group 3, Census Tract 113.06, Fulton County, Georgia,948,16,932,924,3,921,0,8
-1,131210105173006.000000000000000,Block 3006, Block Group 3, Census Tract 105.17, Fulton County, Georgia,938,15,923,919,17,901,0,4
-1,131210101171001.000000000000000,Block 1001, Block Group 1, Census Tract 101.17, Fulton County, Georgia,936,121,815,794,247,294,10,21
-1,131210116443000.000000000000000,Block 3000, Block Group 3, Census Tract 116.44, Fulton County, Georgia,935,103,832,800,391,203,3,32
-1,131210116601001.000000000000000,Block 1001, Block Group 1, Census Tract 116.60, Fulton County, Georgia,935,90,845,830,459,167,6,15
-1,131210116474006.000000000000000,Block 4006, Block Group 4, Census Tract 116.47, Fulton County, Georgia,929,351,578,556,340,162,8,22
-1,131210105253000.000000000000000,Block 3000, Block Group 3, Census Tract 105.25, Fulton County, Georgia,928,29,899,896,14,876,2,3
-1,131210105332006.000000000000000,Block 2006, Block Group 2, Census Tract 105.33, Fulton County, Georgia,928,8,920,909,11,885,13,11
-1,131210114333000.000000000000000,Block 3000, Block Group 3, Census Tract 114.33, Fulton County, Georgia,928,76,852,796,615,116,10,56
-1,131210114233001.000000000000000,Block 3001, Block Group 3, Census Tract 114.23, Fulton County, Georgia,925,73,852,824,620,153,10,28
-1,131210073022000.000000000000000,Block 2000, Block Group 2, Census Tract 73.02, Fulton County, Georgia,923,12,911,893,11,879,3,18
-1,131210116384000.000000000000000,Block 4000, Block Group 4, Census Tract 116.38, Fulton County, Georgia,923,54,869,854,670,52,5,15
-1,131210116572000.000000000000000,Block 2000, Block Group 2, Census Tract 116.57, Fulton County, Georgia,923,91,832,782,459,106,6,50
-1,131210101361000.000000000000000,Block 1000, Block Group 1, Census Tract 101.36, Fulton County, Georgia,922,528,394,378,302,30,5,16
-1,131210116421000.000000000000000,Block 1000, Block Group 1, Census Tract 116.42, Fulton County, Georgia,921,71,850,836,485,168,0,14
-1,131210116541000.000000000000000,Block 1000, Block Group 1, Census Tract 116.54, Fulton County, Georgia,913,89,824,816,408,317,8,8
-1,131210116482001.000000000000000,Block 2001, Block Group 2, Census Tract 116.48, Fulton County, Georgia,912,34,878,855,191,60,0,23
-1,131210094082005.000000000000000,Block 2005, Block Group 2, Census Tract 94.08, Fulton County, Georgia,910,106,804,769,309,290,16,35
-1,131210092031000.000000000000000,Block 1000, Block Group 1, Census Tract 92.03, Fulton County, Georgia,905,85,820,800,419,284,1,20
-1,131210077102001.000000000000000,Block 2001, Block Group 2, Census Tract 77.10, Fulton County, Georgia,902,18,884,865,8,852,0,19
-1,131210105292006.000000000000000,Block 2006, Block Group 2, Census Tract 105.29, Fulton County, Georgia,898,19,879,856,13,836,5,23
-1,131210091032000.000000000000000,Block 2000, Block Group 2, Census Tract 91.03, Fulton County, Georgia,897,79,818,792,579,140,6,26
-1,131210116452000.000000000000000,Block 2000, Block Group 2, Census Tract 116.45, Fulton County, Georgia,895,91,804,736,439,98,15,68
-1,131210101323000.000000000000000,Block 3000, Block Group 3, Census Tract 101.32, Fulton County, Georgia,892,80,812,786,344,273,15,26
-1,131210114413002.000000000000000,Block 3002, Block Group 3, Census Tract 114.41, Fulton County, Georgia,891,166,725,690,503,130,14,35
-1,131210100031007.000000000000000,Block 1007, Block Group 1, Census Tract 100.03, Fulton County, Georgia,887,55,832,810,683,79,2,22
-1,131210114312000.000000000000000,Block 2000, Block Group 2, Census Tract 114.31, Fulton County, Georgia,885,790,95,90,46,43,0,5
-1,131210043001000.000000000000000,Block 1000, Block Group 1, Census Tract 43, Fulton County, Georgia,879,31,848,845,0,845,0,3
-1,131210067011000.000000000000000,Block 1000, Block Group 1, Census Tract 67.01, Fulton County, Georgia,879,22,857,847,26,819,0,10
-1,131210102124000.000000000000000,Block 4000, Block Group 4, Census Tract 102.12, Fulton County, Georgia,879,141,738,704,461,122,5,34
-1,131210101282001.000000000000000,Block 2001, Block Group 2, Census Tract 101.28, Fulton County, Georgia,876,540,336,318,95,190,2,18
-1,131210095032000.000000000000000,Block 2000, Block Group 2, Census Tract 95.03, Fulton County, Georgia,875,44,831,800,548,205,5,31
-1,131210103101006.000000000000000,Block 1006, Block Group 1, Census Tract 103.10, Fulton County, Georgia,874,30,844,793,39,748,2,51
-1,131210081033006.000000000000000,Block 3006, Block Group 3, Census Tract 81.03, Fulton County, Georgia,871,135,736,732,0,732,0,4
-1,131210091033000.000000000000000,Block 3000, Block Group 3, Census Tract 91.03, Fulton County, Georgia,867,52,815,764,504,142,1,51
-1,131210114292003.000000000000000,Block 2003, Block Group 2, Census Tract 114.29, Fulton County, Georgia,865,206,659,644,474,92,16,15
-1,131210079004001.000000000000000,Block 4001, Block Group 4, Census Tract 79, Fulton County, Georgia,860,2,858,857,7,848,2,1
-1,131210113072006.000000000000000,Block 2006, Block Group 2, Census Tract 113.07, Fulton County, Georgia,851,17,834,833,4,827,0,1
-1,131210114301001.000000000000000,Block 1001, Block Group 1, Census Tract 114.30, Fulton County, Georgia,851,343,508,493,144,306,21,15
-1,131210094092002.000000000000000,Block 2002, Block Group 2, Census Tract 94.09, Fulton County, Georgia,847,207,640,617,313,197,2,23
-1,131210004002009.000000000000000,Block 2009, Block Group 2, Census Tract 4, Fulton County, Georgia,842,39,803,775,652,66,0,28
-1,131210086022012.000000000000000,Block 2012, Block Group 2, Census Tract 86.02, Fulton County, Georgia,841,31,810,789,45,726,7,21
-1,131210102142000.000000000000000,Block 2000, Block Group 2, Census Tract 102.14, Fulton County, Georgia,836,132,704,674,221,412,15,30
-1,131210102171000.000000000000000,Block 1000, Block Group 1, Census Tract 102.17, Fulton County, Georgia,830,53,777,741,360,283,2,36
-1,131210070013000.000000000000000,Block 3000, Block Group 3, Census Tract 70.01, Fulton County, Georgia,829,33,796,793,9,779,2,3
-1,131210103131007.000000000000000,Block 1007, Block Group 1, Census Tract 103.13, Fulton County, Georgia,827,7,820,810,5,796,9,10
-1,131210099005004.000000000000000,Block 5004, Block Group 5, Census Tract 99, Fulton County, Georgia,825,50,775,740,623,62,3,35
-1,131210028011011.000000000000000,Block 1011, Block Group 1, Census Tract 28.01, Fulton County, Georgia,824,62,762,719,410,220,2,43
-1,131210095013009.000000000000000,Block 3009, Block Group 3, Census Tract 95.01, Fulton County, Georgia,824,26,798,781,617,136,1,17
-1,131210091062001.000000000000000,Block 2001, Block Group 2, Census Tract 91.06, Fulton County, Georgia,822,67,755,710,280,353,14,45
-1,131210116451000.000000000000000,Block 1000, Block Group 1, Census Tract 116.45, Fulton County, Georgia,822,82,740,718,349,217,0,22
-1,131210116612001.000000000000000,Block 2001, Block Group 2, Census Tract 116.61, Fulton County, Georgia,821,49,772,744,658,49,1,28
-1,131210100032000.000000000000000,Block 2000, Block Group 2, Census Tract 100.03, Fulton County, Georgia,818,61,757,740,466,142,0,17
-1,131210101353000.000000000000000,Block 3000, Block Group 3, Census Tract 101.35, Fulton County, Georgia,818,330,488,461,76,327,14,27
-1,131210076032001.000000000000000,Block 2001, Block Group 2, Census Tract 76.03, Fulton County, Georgia,816,8,808,793,5,783,3,15
-1,131210114441002.000000000000000,Block 1002, Block Group 1, Census Tract 114.44, Fulton County, Georgia,814,24,790,758,598,24,4,32
-1,131210017022003.000000000000000,Block 2003, Block Group 2, Census Tract 17.02, Fulton County, Georgia,811,55,756,730,577,68,0,26
-1,131210116351001.000000000000000,Block 1001, Block Group 1, Census Tract 116.35, Fulton County, Georgia,810,11,799,785,222,104,3,14
-1,131210116592001.000000000000000,Block 2001, Block Group 2, Census Tract 116.59, Fulton County, Georgia,806,27,779,731,390,86,0,48
-1,131210101151000.000000000000000,Block 1000, Block Group 1, Census Tract 101.15, Fulton County, Georgia,805,13,792,763,686,25,0,29
-1,131210105183000.000000000000000,Block 3000, Block Group 3, Census Tract 105.18, Fulton County, Georgia,805,7,798,777,10,758,7,21
-1,131210106031002.000000000000000,Block 1002, Block Group 1, Census Tract 106.03, Fulton County, Georgia,802,8,794,790,28,761,1,4
-1,131210113073005.000000000000000,Block 3005, Block Group 3, Census Tract 113.07, Fulton County, Georgia,801,11,790,777,4,773,0,13
-1,131210078063000.000000000000000,Block 3000, Block Group 3, Census Tract 78.06, Fulton County, Georgia,799,8,791,776,3,760,11,15
-1,131210089072001.000000000000000,Block 2001, Block Group 2, Census Tract 89.07, Fulton County, Georgia,798,52,746,727,381,307,0,19
-1,131210114331001.000000000000000,Block 1001, Block Group 1, Census Tract 114.33, Fulton County, Georgia,798,24,774,725,649,40,6,49
-1,131210099004000.000000000000000,Block 4000, Block Group 4, Census Tract 99, Fulton County, Georgia,791,33,758,727,576,91,8,31
-1,131210103111000.000000000000000,Block 1000, Block Group 1, Census Tract 103.11, Fulton County, Georgia,789,26,763,759,25,727,4,4
-1,131210105262004.000000000000000,Block 2004, Block Group 2, Census Tract 105.26, Fulton County, Georgia,789,33,756,745,9,733,3,11
-1,131210114241006.000000000000000,Block 1006, Block Group 1, Census Tract 114.24, Fulton County, Georgia,789,89,700,683,458,182,10,17
-1,131210010022006.000000000000000,Block 2006, Block Group 2, Census Tract 10.02, Fulton County, Georgia,788,59,729,704,610,54,1,25
-1,131210113062002.000000000000000,Block 2002, Block Group 2, Census Tract 113.06, Fulton County, Georgia,788,11,777,766,11,752,3,11
-1,131210114171003.000000000000000,Block 1003, Block Group 1, Census Tract 114.17, Fulton County, Georgia,785,72,713,693,617,49,0,20
-1,131210077051007.000000000000000,Block 1007, Block Group 1, Census Tract 77.05, Fulton County, Georgia,782,1,781,777,0,773,4,4
-1,131210091043002.000000000000000,Block 3002, Block Group 3, Census Tract 91.04, Fulton County, Georgia,779,35,744,716,534,148,6,28
-1,131210018012002.000000000000000,Block 2002, Block Group 2, Census Tract 18.01, Fulton County, Georgia,774,59,715,695,417,184,5,20
-1,131210076033020.000000000000000,Block 3020, Block Group 3, Census Tract 76.03, Fulton County, Georgia,773,11,762,751,11,739,1,11
-1,131210114161000.000000000000000,Block 1000, Block Group 1, Census Tract 114.16, Fulton County, Georgia,771,46,725,696,569,59,7,29
-1,131210115102006.000000000000000,Block 2006, Block Group 2, Census Tract 115.10, Fulton County, Georgia,768,31,737,711,585,31,1,26
-1,131210011011001.000000000000000,Block 1001, Block Group 1, Census Tract 11.01, Fulton County, Georgia,763,56,707,686,479,94,3,21
-1,131210116401005.000000000000000,Block 1005, Block Group 1, Census Tract 116.40, Fulton County, Georgia,761,119,642,631,162,107,8,11
-1,131210050002014.000000000000000,Block 2014, Block Group 2, Census Tract 50, Fulton County, Georgia,759,32,727,714,302,373,2,13
-1,131210089054000.000000000000000,Block 4000, Block Group 4, Census Tract 89.05, Fulton County, Georgia,758,46,712,688,469,147,6,24
-1,131210114421000.000000000000000,Block 1000, Block Group 1, Census Tract 114.42, Fulton County, Georgia,757,105,652,619,361,212,0,33
-1,131210055031000.000000000000000,Block 1000, Block Group 1, Census Tract 55.03, Fulton County, Georgia,754,11,743,735,6,726,1,8
-1,131210089032000.000000000000000,Block 2000, Block Group 2, Census Tract 89.03, Fulton County, Georgia,751,53,698,669,289,302,0,29
-1,131210044001005.000000000000000,Block 1005, Block Group 1, Census Tract 44, Fulton County, Georgia,749,5,744,736,2,734,0,8
-1,131210114302000.000000000000000,Block 2000, Block Group 2, Census Tract 114.30, Fulton County, Georgia,749,393,356,346,133,192,2,10
-1,131210103062003.000000000000000,Block 2003, Block Group 2, Census Tract 103.06, Fulton County, Georgia,748,12,736,723,6,710,2,13
-1,131210078093001.000000000000000,Block 3001, Block Group 3, Census Tract 78.09, Fulton County, Georgia,746,2,744,741,1,735,0,3
-1,131210038001020.000000000000000,Block 1020, Block Group 1, Census Tract 38, Fulton County, Georgia,741,2,739,738,0,738,0,1
-1,131210116282000.000000000000000,Block 2000, Block Group 2, Census Tract 116.28, Fulton County, Georgia,741,39,702,684,355,96,1,18
-1,131210116361000.000000000000000,Block 1000, Block Group 1, Census Tract 116.36, Fulton County, Georgia,741,30,711,700,59,42,46,11
-1,131210114463000.000000000000000,Block 3000, Block Group 3, Census Tract 114.46, Fulton County, Georgia,740,12,728,711,653,35,4,17
-1,131210096052003.000000000000000,Block 2003, Block Group 2, Census Tract 96.05, Fulton County, Georgia,738,59,679,660,466,140,5,19
-1,131210114222002.000000000000000,Block 2002, Block Group 2, Census Tract 114.22, Fulton County, Georgia,738,111,627,591,315,267,5,36
-1,131210101252005.000000000000000,Block 2005, Block Group 2, Census Tract 101.25, Fulton County, Georgia,735,75,660,629,206,320,12,31
-1,131210105222030.000000000000000,Block 2030, Block Group 2, Census Tract 105.22, Fulton County, Georgia,735,19,716,707,2,703,1,9
-1,131210068021005.000000000000000,Block 1005, Block Group 1, Census Tract 68.02, Fulton County, Georgia,734,15,719,716,3,712,0,3
-1,131210116512008.000000000000000,Block 2008, Block Group 2, Census Tract 116.51, Fulton County, Georgia,734,49,685,670,216,98,2,15
-1,131210096011002.000000000000000,Block 1002, Block Group 1, Census Tract 96.01, Fulton County, Georgia,728,113,615,597,496,55,3,18
-1,131210078083000.000000000000000,Block 3000, Block Group 3, Census Tract 78.08, Fulton County, Georgia,725,4,721,721,1,720,0,0
-1,131210091042001.000000000000000,Block 2001, Block Group 2, Census Tract 91.04, Fulton County, Georgia,724,71,653,633,429,144,6,20
-1,131210103153000.000000000000000,Block 3000, Block Group 3, Census Tract 103.15, Fulton County, Georgia,724,3,721,714,19,693,2,7
-1,131210115092000.000000000000000,Block 2000, Block Group 2, Census Tract 115.09, Fulton County, Georgia,724,23,701,697,569,68,1,4
-1,131210101064006.000000000000000,Block 4006, Block Group 4, Census Tract 101.06, Fulton County, Georgia,723,27,696,688,617,39,7,8
-1,131210114381004.000000000000000,Block 1004, Block Group 1, Census Tract 114.38, Fulton County, Georgia,722,63,659,632,529,54,3,27
-1,131210103071002.000000000000000,Block 1002, Block Group 1, Census Tract 103.07, Fulton County, Georgia,719,0,719,717,5,702,8,2
-1,131210116123002.000000000000000,Block 3002, Block Group 3, Census Tract 116.12, Fulton County, Georgia,719,12,707,686,468,40,9,21
-1,131210081031002.000000000000000,Block 1002, Block Group 1, Census Tract 81.03, Fulton County, Georgia,716,119,597,591,10,579,0,6
-1,131210114221003.000000000000000,Block 1003, Block Group 1, Census Tract 114.22, Fulton County, Georgia,713,55,658,640,549,36,5,18
-1,131210078102002.000000000000000,Block 2002, Block Group 2, Census Tract 78.10, Fulton County, Georgia,712,29,683,677,3,659,15,6
-1,131210114281000.000000000000000,Block 1000, Block Group 1, Census Tract 114.28, Fulton County, Georgia,711,25,686,674,625,20,2,12
-1,131210114242000.000000000000000,Block 2000, Block Group 2, Census Tract 114.24, Fulton County, Georgia,709,79,630,599,433,104,0,31
-1,131210114241000.000000000000000,Block 1000, Block Group 1, Census Tract 114.24, Fulton County, Georgia,708,43,665,649,507,86,6,16
-1,131210116293000.000000000000000,Block 3000, Block Group 3, Census Tract 116.29, Fulton County, Georgia,708,21,687,668,282,37,1,19
-1,131210114411001.000000000000000,Block 1001, Block Group 1, Census Tract 114.41, Fulton County, Georgia,707,81,626,586,399,131,8,40
-1,131210103132000.000000000000000,Block 2000, Block Group 2, Census Tract 103.13, Fulton County, Georgia,706,6,700,691,21,668,0,9
-1,131210101061002.000000000000000,Block 1002, Block Group 1, Census Tract 101.06, Fulton County, Georgia,704,122,582,550,203,333,1,32
-1,131210116311008.000000000000000,Block 1008, Block Group 1, Census Tract 116.31, Fulton County, Georgia,704,60,644,627,283,143,2,17
-1,131210105243000.000000000000000,Block 3000, Block Group 3, Census Tract 105.24, Fulton County, Georgia,702,19,683,667,17,642,7,16
-1,131210114442009.000000000000000,Block 2009, Block Group 2, Census Tract 114.44, Fulton County, Georgia,702,11,691,670,561,35,6,21
-1,131210116382000.000000000000000,Block 2000, Block Group 2, Census Tract 116.38, Fulton County, Georgia,702,96,606,580,360,96,3,26
-1,131210116333000.000000000000000,Block 3000, Block Group 3, Census Tract 116.33, Fulton County, Georgia,701,85,616,587,385,97,3,29
-1,131210095014001.000000000000000,Block 4001, Block Group 4, Census Tract 95.01, Fulton County, Georgia,700,18,682,673,614,32,2,9
-1,131210101341002.000000000000000,Block 1002, Block Group 1, Census Tract 101.34, Fulton County, Georgia,700,180,520,488,164,287,6,32
-1,131210116122000.000000000000000,Block 2000, Block Group 2, Census Tract 116.12, Fulton County, Georgia,699,27,672,646,358,118,0,26
-1,131210078051033.000000000000000,Block 1033, Block Group 1, Census Tract 78.05, Fulton County, Georgia,695,6,689,684,7,677,0,5
-1,131210101152014.000000000000000,Block 2014, Block Group 2, Census Tract 101.15, Fulton County, Georgia,695,58,637,622,429,114,2,15
-1,131210114162002.000000000000000,Block 2002, Block Group 2, Census Tract 114.16, Fulton County, Georgia,694,32,662,650,515,66,0,12
-1,131210115132000.000000000000000,Block 2000, Block Group 2, Census Tract 115.13, Fulton County, Georgia,692,33,659,638,594,25,0,21
-1,131210100062000.000000000000000,Block 2000, Block Group 2, Census Tract 100.06, Fulton County, Georgia,688,33,655,623,433,131,4,32
-1,131210116422000.000000000000000,Block 2000, Block Group 2, Census Tract 116.42, Fulton County, Georgia,688,50,638,610,456,47,5,28
-1,131210102232003.000000000000000,Block 2003, Block Group 2, Census Tract 102.23, Fulton County, Georgia,687,31,656,648,528,103,0,8
-1,131210077112006.000000000000000,Block 2006, Block Group 2, Census Tract 77.11, Fulton County, Georgia,686,4,682,672,8,662,0,10
-1,131210105221003.000000000000000,Block 1003, Block Group 1, Census Tract 105.22, Fulton County, Georgia,683,7,676,648,6,628,11,28
-1,131210114412001.000000000000000,Block 2001, Block Group 2, Census Tract 114.41, Fulton County, Georgia,683,35,648,633,586,23,1,15
-1,131210103122020.000000000000000,Block 2020, Block Group 2, Census Tract 103.12, Fulton County, Georgia,681,9,672,668,4,648,7,4
-1,131210116413001.000000000000000,Block 3001, Block Group 3, Census Tract 116.41, Fulton County, Georgia,681,44,637,607,481,26,5,30
-1,131210101072000.000000000000000,Block 2000, Block Group 2, Census Tract 101.07, Fulton County, Georgia,680,21,659,653,594,37,1,6
-1,131210116322002.000000000000000,Block 2002, Block Group 2, Census Tract 116.32, Fulton County, Georgia,679,19,660,649,244,50,0,11
-1,131210101303000.000000000000000,Block 3000, Block Group 3, Census Tract 101.30, Fulton County, Georgia,678,48,630,625,67,122,2,5
-1,131210102125001.000000000000000,Block 5001, Block Group 5, Census Tract 102.12, Fulton County, Georgia,678,425,253,243,140,84,3,10
-1,131210105263002.000000000000000,Block 3002, Block Group 3, Census Tract 105.26, Fulton County, Georgia,678,13,665,660,2,651,2,5
-1,131210114191003.000000000000000,Block 1003, Block Group 1, Census Tract 114.19, Fulton County, Georgia,677,30,647,635,604,8,0,12
-1,131210114192012.000000000000000,Block 2012, Block Group 2, Census Tract 114.19, Fulton County, Georgia,677,86,591,570,485,40,13,21
-1,131210094091000.000000000000000,Block 1000, Block Group 1, Census Tract 94.09, Fulton County, Georgia,673,26,647,632,366,150,0,15
-1,131210069002001.000000000000000,Block 2001, Block Group 2, Census Tract 69, Fulton County, Georgia,669,168,501,497,119,373,0,4
-1,131210105192000.000000000000000,Block 2000, Block Group 2, Census Tract 105.19, Fulton County, Georgia,666,17,649,647,17,630,0,2
-1,131210076032000.000000000000000,Block 2000, Block Group 2, Census Tract 76.03, Fulton County, Georgia,664,9,655,644,26,613,4,11
-1,131210115081000.000000000000000,Block 1000, Block Group 1, Census Tract 115.08, Fulton County, Georgia,664,40,624,609,519,33,5,15
-1,131210116301004.000000000000000,Block 1004, Block Group 1, Census Tract 116.30, Fulton County, Georgia,663,35,628,585,259,69,1,43
-1,131210011021002.000000000000000,Block 1002, Block Group 1, Census Tract 11.02, Fulton County, Georgia,661,43,618,594,359,205,4,24
-1,131210090021002.000000000000000,Block 1002, Block Group 1, Census Tract 90.02, Fulton County, Georgia,660,20,640,627,594,12,0,13
-1,131210094111004.000000000000000,Block 1004, Block Group 1, Census Tract 94.11, Fulton County, Georgia,660,59,601,585,279,208,3,16
-1,131210010012024.000000000000000,Block 2024, Block Group 2, Census Tract 10.01, Fulton County, Georgia,659,114,545,498,368,12,5,47
-1,131210089081000.000000000000000,Block 1000, Block Group 1, Census Tract 89.08, Fulton County, Georgia,658,42,616,600,224,291,7,16
-1,131210073021003.000000000000000,Block 1003, Block Group 1, Census Tract 73.02, Fulton County, Georgia,657,0,657,648,13,633,2,9
-1,131210019021012.000000000000000,Block 1012, Block Group 1, Census Tract 19.02, Fulton County, Georgia,656,40,616,584,166,340,7,32
-1,131210077101003.000000000000000,Block 1003, Block Group 1, Census Tract 77.10, Fulton County, Georgia,655,6,649,639,19,613,0,10
-1,131210116313000.000000000000000,Block 3000, Block Group 3, Census Tract 116.31, Fulton County, Georgia,655,38,617,598,229,104,0,19
-1,131210116301001.000000000000000,Block 1001, Block Group 1, Census Tract 116.30, Fulton County, Georgia,654,65,589,566,459,56,0,23
-1,131210101172001.000000000000000,Block 2001, Block Group 2, Census Tract 101.17, Fulton County, Georgia,651,102,549,516,204,292,7,33
-1,131210116562000.000000000000000,Block 2000, Block Group 2, Census Tract 116.56, Fulton County, Georgia,651,46,605,568,466,39,0,37
-1,131210057002011.000000000000000,Block 2011, Block Group 2, Census Tract 57, Fulton County, Georgia,649,3,646,642,9,633,0,4
-1,131210101202000.000000000000000,Block 2000, Block Group 2, Census Tract 101.20, Fulton County, Georgia,645,51,594,578,449,97,8,16
-1,131210032002005.000000000000000,Block 2005, Block Group 2, Census Tract 32, Fulton County, Georgia,644,50,594,571,442,107,4,23
-1,131210101304002.000000000000000,Block 4002, Block Group 4, Census Tract 101.30, Fulton County, Georgia,640,33,607,603,294,51,0,4
-1,131210103123000.000000000000000,Block 3000, Block Group 3, Census Tract 103.12, Fulton County, Georgia,640,2,638,632,8,624,0,6
-1,131210077052001.000000000000000,Block 2001, Block Group 2, Census Tract 77.05, Fulton County, Georgia,639,3,636,627,3,616,5,9
-1,131210105291005.000000000000000,Block 1005, Block Group 1, Census Tract 105.29, Fulton County, Georgia,638,13,625,612,5,607,0,13
-1,131210093023000.000000000000000,Block 3000, Block Group 3, Census Tract 93.02, Fulton County, Georgia,636,52,584,573,449,88,0,11
-1,131210115051000.000000000000000,Block 1000, Block Group 1, Census Tract 115.05, Fulton County, Georgia,636,18,618,588,542,32,0,30
-1,131210012052000.000000000000000,Block 2000, Block Group 2, Census Tract 12.05, Fulton County, Georgia,632,55,577,553,181,193,11,24
-1,131210103081007.000000000000000,Block 1007, Block Group 1, Census Tract 103.08, Fulton County, Georgia,631,18,613,608,5,601,0,5
-1,131210114291000.000000000000000,Block 1000, Block Group 1, Census Tract 114.29, Fulton County, Georgia,631,50,581,554,455,53,9,27
-1,131210101321003.000000000000000,Block 1003, Block Group 1, Census Tract 101.32, Fulton County, Georgia,630,218,412,405,313,63,0,7
-1,131210101262000.000000000000000,Block 2000, Block Group 2, Census Tract 101.26, Fulton County, Georgia,628,45,583,536,310,168,5,47
-1,131210100032002.000000000000000,Block 2002, Block Group 2, Census Tract 100.03, Fulton County, Georgia,627,46,581,567,390,107,0,14
-1,131210105231018.000000000000000,Block 1018, Block Group 1, Census Tract 105.23, Fulton County, Georgia,627,29,598,595,15,578,2,3
-1,131210094052004.000000000000000,Block 2004, Block Group 2, Census Tract 94.05, Fulton County, Georgia,626,31,595,578,262,108,1,17
-1,131210105312006.000000000000000,Block 2006, Block Group 2, Census Tract 105.31, Fulton County, Georgia,625,8,617,601,6,592,3,16
-1,131210116482008.000000000000000,Block 2008, Block Group 2, Census Tract 116.48, Fulton County, Georgia,625,26,599,594,336,59,4,5
-1,131210078072004.000000000000000,Block 2004, Block Group 2, Census Tract 78.07, Fulton County, Georgia,624,3,621,618,0,616,2,3
-1,131210102212000.000000000000000,Block 2000, Block Group 2, Census Tract 102.21, Fulton County, Georgia,621,55,566,549,270,192,2,17
-1,131210101311005.000000000000000,Block 1005, Block Group 1, Census Tract 101.31, Fulton County, Georgia,620,41,579,546,275,101,2,33
-1,131210114223004.000000000000000,Block 3004, Block Group 3, Census Tract 114.22, Fulton County, Georgia,618,36,582,566,538,24,0,16
-1,131210005011004.000000000000000,Block 1004, Block Group 1, Census Tract 5.01, Fulton County, Georgia,616,28,588,580,251,205,5,8
-1,131210001005006.000000000000000,Block 5006, Block Group 5, Census Tract 1, Fulton County, Georgia,615,37,578,575,386,129,1,3
-1,131210082032000.000000000000000,Block 2000, Block Group 2, Census Tract 82.03, Fulton County, Georgia,614,3,611,596,2,594,0,15
-1,131210116492005.000000000000000,Block 2005, Block Group 2, Census Tract 116.49, Fulton County, Georgia,613,16,597,583,190,24,0,14
-1,131210116512001.000000000000000,Block 2001, Block Group 2, Census Tract 116.51, Fulton County, Georgia,613,57,556,541,333,48,1,15
-1,131210092032000.000000000000000,Block 2000, Block Group 2, Census Tract 92.03, Fulton County, Georgia,612,40,572,543,163,337,2,29
-1,131210103061014.000000000000000,Block 1014, Block Group 1, Census Tract 103.06, Fulton County, Georgia,612,16,596,582,9,572,1,14
-1,131210115072005.000000000000000,Block 2005, Block Group 2, Census Tract 115.07, Fulton County, Georgia,612,17,595,587,554,22,3,8
-1,131210102143000.000000000000000,Block 3000, Block Group 3, Census Tract 102.14, Fulton County, Georgia,611,31,580,569,472,30,1,11
-1,131210114353000.000000000000000,Block 3000, Block Group 3, Census Tract 114.35, Fulton County, Georgia,611,64,547,529,467,31,13,18
-1,131210116492000.000000000000000,Block 2000, Block Group 2, Census Tract 116.49, Fulton County, Georgia,611,22,589,566,231,63,4,23
-1,131210116571000.000000000000000,Block 1000, Block Group 1, Census Tract 116.57, Fulton County, Georgia,611,28,583,554,298,102,1,29
-1,131210073014002.000000000000000,Block 4002, Block Group 4, Census Tract 73.01, Fulton County, Georgia,610,20,590,586,5,577,3,4
-1,131210012062007.000000000000000,Block 2007, Block Group 2, Census Tract 12.06, Fulton County, Georgia,609,35,574,551,438,34,5,23
-1,131210077031000.000000000000000,Block 1000, Block Group 1, Census Tract 77.03, Fulton County, Georgia,607,4,603,603,0,600,3,0
-1,131210116271004.000000000000000,Block 1004, Block Group 1, Census Tract 116.27, Fulton County, Georgia,607,32,575,561,222,54,7,14
-1,131210102181003.000000000000000,Block 1003, Block Group 1, Census Tract 102.18, Fulton County, Georgia,605,55,550,539,219,294,2,11
-1,131210116342002.000000000000000,Block 2002, Block Group 2, Census Tract 116.34, Fulton County, Georgia,605,46,559,553,270,104,4,6
-1,131210006012012.000000000000000,Block 2012, Block Group 2, Census Tract 6.01, Fulton County, Georgia,603,72,531,506,263,220,0,25
-1,131210078092000.000000000000000,Block 2000, Block Group 2, Census Tract 78.09, Fulton County, Georgia,602,6,596,595,18,576,1,1
-1,131210116182000.000000000000000,Block 2000, Block Group 2, Census Tract 116.18, Fulton County, Georgia,602,16,586,569,351,14,6,17
-1,131210028022010.000000000000000,Block 2010, Block Group 2, Census Tract 28.02, Fulton County, Georgia,600,38,562,542,151,344,0,20
-1,131210115142012.000000000000000,Block 2012, Block Group 2, Census Tract 115.14, Fulton County, Georgia,600,21,579,555,503,17,0,24
-1,131210116121002.000000000000000,Block 1002, Block Group 1, Census Tract 116.12, Fulton County, Georgia,599,11,588,577,450,25,0,11
-1,131210114463003.000000000000000,Block 3003, Block Group 3, Census Tract 114.46, Fulton County, Georgia,597,13,584,561,520,17,0,23
-1,131210012061001.000000000000000,Block 1001, Block Group 1, Census Tract 12.06, Fulton County, Georgia,596,61,535,514,262,85,6,21
-1,131210018021000.000000000000000,Block 1000, Block Group 1, Census Tract 18.02, Fulton County, Georgia,594,44,550,531,277,215,0,19
-1,131210104012001.000000000000000,Block 2001, Block Group 2, Census Tract 104.01, Fulton County, Georgia,594,75,519,495,54,438,3,24
-1,131210010012015.000000000000000,Block 2015, Block Group 2, Census Tract 10.01, Fulton County, Georgia,593,46,547,532,349,55,3,15
-1,131210114452000.000000000000000,Block 2000, Block Group 2, Census Tract 114.45, Fulton County, Georgia,592,12,580,562,520,22,4,18
-1,131210077032008.000000000000000,Block 2008, Block Group 2, Census Tract 77.03, Fulton County, Georgia,591,10,581,578,9,569,0,3
-1,131210114451008.000000000000000,Block 1008, Block Group 1, Census Tract 114.45, Fulton County, Georgia,591,34,557,549,521,14,5,8
-1,131210012061005.000000000000000,Block 1005, Block Group 1, Census Tract 12.06, Fulton County, Georgia,589,33,556,538,402,37,0,18
-1,131210116591000.000000000000000,Block 1000, Block Group 1, Census Tract 116.59, Fulton County, Georgia,588,113,475,455,148,103,4,20
-1,131210102123000.000000000000000,Block 3000, Block Group 3, Census Tract 102.12, Fulton County, Georgia,586,400,186,185,152,24,5,1
-1,131210116292000.000000000000000,Block 2000, Block Group 2, Census Tract 116.29, Fulton County, Georgia,586,14,572,563,207,64,6,9
-1,131210035001001.000000000000000,Block 1001, Block Group 1, Census Tract 35, Fulton County, Georgia,585,23,562,544,285,199,7,18
-1,131210089031008.000000000000000,Block 1008, Block Group 1, Census Tract 89.03, Fulton County, Georgia,585,157,428,405,122,255,7,23
-1,131210105372000.000000000000000,Block 2000, Block Group 2, Census Tract 105.37, Fulton County, Georgia,585,13,572,562,6,547,9,10
-1,131210116381004.000000000000000,Block 1004, Block Group 1, Census Tract 116.38, Fulton County, Georgia,585,23,562,537,366,49,0,25
-1,131210103052000.000000000000000,Block 2000, Block Group 2, Census Tract 103.05, Fulton County, Georgia,584,10,574,565,5,550,8,9
-1,131210105241001.000000000000000,Block 1001, Block Group 1, Census Tract 105.24, Fulton County, Georgia,581,56,525,523,23,500,0,2
-1,131210105261034.000000000000000,Block 1034, Block Group 1, Census Tract 105.26, Fulton County, Georgia,580,8,572,559,3,553,0,13
-1,131210010022013.000000000000000,Block 2013, Block Group 2, Census Tract 10.02, Fulton County, Georgia,578,23,555,530,466,15,3,25
-1,131210105351001.000000000000000,Block 1001, Block Group 1, Census Tract 105.35, Fulton County, Georgia,578,32,546,535,64,467,0,11
-1,131210021001014.000000000000000,Block 1014, Block Group 1, Census Tract 21, Fulton County, Georgia,575,52,523,477,225,219,6,46
-1,131210074001003.000000000000000,Block 1003, Block Group 1, Census Tract 74, Fulton County, Georgia,575,12,563,555,30,522,1,8
-1,131210002011002.000000000000000,Block 1002, Block Group 1, Census Tract 2.01, Fulton County, Georgia,574,28,546,532,464,40,1,14
-1,131210102221006.000000000000000,Block 1006, Block Group 1, Census Tract 102.22, Fulton County, Georgia,574,27,547,541,491,26,0,6
-1,131210112041006.000000000000000,Block 1006, Block Group 1, Census Tract 112.04, Fulton County, Georgia,574,8,566,550,13,529,0,16
-1,131210089071000.000000000000000,Block 1000, Block Group 1, Census Tract 89.07, Fulton County, Georgia,571,44,527,491,381,74,0,36
-1,131210105262001.000000000000000,Block 2001, Block Group 2, Census Tract 105.26, Fulton County, Georgia,571,20,551,549,4,544,1,2
-1,131210095031002.000000000000000,Block 1002, Block Group 1, Census Tract 95.03, Fulton County, Georgia,569,33,536,503,256,209,2,33
-1,131210095031001.000000000000000,Block 1001, Block Group 1, Census Tract 95.03, Fulton County, Georgia,566,59,507,491,295,157,2,16
-1,131210074003006.000000000000000,Block 3006, Block Group 3, Census Tract 74, Fulton County, Georgia,564,28,536,529,6,520,1,7
-1,131210011022002.000000000000000,Block 2002, Block Group 2, Census Tract 11.02, Fulton County, Georgia,563,47,516,503,392,40,5,13
-1,131210101332001.000000000000000,Block 2001, Block Group 2, Census Tract 101.33, Fulton County, Georgia,562,32,530,509,441,36,2,21
-1,131210113101000.000000000000000,Block 1000, Block Group 1, Census Tract 113.10, Fulton County, Georgia,562,45,517,514,12,498,3,3
-1,131210077053013.000000000000000,Block 3013, Block Group 3, Census Tract 77.05, Fulton County, Georgia,561,8,553,552,0,552,0,1
-1,131210114293000.000000000000000,Block 3000, Block Group 3, Census Tract 114.29, Fulton County, Georgia,561,23,538,502,326,33,7,36
-1,131210097001016.000000000000000,Block 1016, Block Group 1, Census Tract 97, Fulton County, Georgia,560,15,545,535,227,286,0,10
-1,131210018011000.000000000000000,Block 1000, Block Group 1, Census Tract 18.01, Fulton County, Georgia,558,2,556,541,35,496,4,15
-1,131210094102002.000000000000000,Block 2002, Block Group 2, Census Tract 94.10, Fulton County, Georgia,557,61,496,474,323,119,3,22
-1,131210103152002.000000000000000,Block 2002, Block Group 2, Census Tract 103.15, Fulton County, Georgia,556,12,544,544,8,536,0,0
-1,131210105322000.000000000000000,Block 2000, Block Group 2, Census Tract 105.32, Fulton County, Georgia,555,4,551,540,6,530,4,11
-1,131210101311003.000000000000000,Block 1003, Block Group 1, Census Tract 101.31, Fulton County, Georgia,554,20,534,529,154,46,0,5
-1,131210103074000.000000000000000,Block 4000, Block Group 4, Census Tract 103.07, Fulton County, Georgia,554,12,542,538,2,535,1,4
-1,131210114243001.000000000000000,Block 3001, Block Group 3, Census Tract 114.24, Fulton County, Georgia,554,53,501,484,414,31,1,17
-1,131210105284000.000000000000000,Block 4000, Block Group 4, Census Tract 105.28, Fulton County, Georgia,552,14,538,530,8,522,0,8
-1,131210078051025.000000000000000,Block 1025, Block Group 1, Census Tract 78.05, Fulton County, Georgia,551,4,547,543,10,531,0,4
-1,131210101352000.000000000000000,Block 2000, Block Group 2, Census Tract 101.35, Fulton County, Georgia,551,175,376,366,66,269,7,10
-1,131210102211000.000000000000000,Block 1000, Block Group 1, Census Tract 102.21, Fulton County, Georgia,550,43,507,475,401,45,9,32
-1,131210114351002.000000000000000,Block 1002, Block Group 1, Census Tract 114.35, Fulton County, Georgia,548,292,256,236,82,129,17,20
-1,131210115103003.000000000000000,Block 3003, Block Group 3, Census Tract 115.10, Fulton County, Georgia,548,28,520,498,439,36,1,22
-1,131210102181000.000000000000000,Block 1000, Block Group 1, Census Tract 102.18, Fulton County, Georgia,547,31,516,502,253,227,1,14
-1,131210088022012.000000000000000,Block 2012, Block Group 2, Census Tract 88.02, Fulton County, Georgia,546,27,519,491,302,171,0,28
-1,131210116611001.000000000000000,Block 1001, Block Group 1, Census Tract 116.61, Fulton County, Georgia,546,15,531,503,402,33,0,28
-1,131210103153006.000000000000000,Block 3006, Block Group 3, Census Tract 103.15, Fulton County, Georgia,545,24,521,519,22,497,0,2
-1,131210101291000.000000000000000,Block 1000, Block Group 1, Census Tract 101.29, Fulton County, Georgia,543,46,497,482,329,99,5,15
-1,131210094061000.000000000000000,Block 1000, Block Group 1, Census Tract 94.06, Fulton County, Georgia,542,41,501,483,173,241,3,18
-1,131210104012011.000000000000000,Block 2011, Block Group 2, Census Tract 104.01, Fulton County, Georgia,542,37,505,502,144,357,0,3
-1,131210105361015.000000000000000,Block 1015, Block Group 1, Census Tract 105.36, Fulton County, Georgia,541,12,529,519,5,502,4,10
-1,131210006021003.000000000000000,Block 1003, Block Group 1, Census Tract 6.02, Fulton County, Georgia,540,34,506,497,218,69,2,9
-1,131210100031000.000000000000000,Block 1000, Block Group 1, Census Tract 100.03, Fulton County, Georgia,539,27,512,492,430,38,5,20
-1,131210078052005.000000000000000,Block 2005, Block Group 2, Census Tract 78.05, Fulton County, Georgia,538,40,498,495,1,492,0,3
-1,131210101331004.000000000000000,Block 1004, Block Group 1, Census Tract 101.33, Fulton County, Georgia,538,20,518,506,245,69,0,12
-1,131210101252001.000000000000000,Block 2001, Block Group 2, Census Tract 101.25, Fulton County, Georgia,537,41,496,468,316,118,9,28
-1,131210091041001.000000000000000,Block 1001, Block Group 1, Census Tract 91.04, Fulton County, Georgia,535,40,495,487,404,72,0,8
-1,131210096051001.000000000000000,Block 1001, Block Group 1, Census Tract 96.05, Fulton County, Georgia,535,28,507,472,308,105,2,35
-1,131210087012002.000000000000000,Block 2002, Block Group 2, Census Tract 87.01, Fulton County, Georgia,534,7,527,517,3,513,1,10
-1,131210105083011.000000000000000,Block 3011, Block Group 3, Census Tract 105.08, Fulton County, Georgia,534,8,526,522,1,516,0,4
-1,131210044001004.000000000000000,Block 1004, Block Group 1, Census Tract 44, Fulton County, Georgia,529,6,523,517,0,514,0,6
-1,131210102042004.000000000000000,Block 2004, Block Group 2, Census Tract 102.04, Fulton County, Georgia,529,19,510,507,467,20,0,3
-1,131210091042002.000000000000000,Block 2002, Block Group 2, Census Tract 91.04, Fulton County, Georgia,528,26,502,483,410,43,0,19
-1,131210105281008.000000000000000,Block 1008, Block Group 1, Census Tract 105.28, Fulton County, Georgia,527,126,401,397,15,378,0,4
-1,131210113081002.000000000000000,Block 1002, Block Group 1, Census Tract 113.08, Fulton County, Georgia,527,5,522,516,14,500,0,6
-1,131210116331002.000000000000000,Block 1002, Block Group 1, Census Tract 116.33, Fulton County, Georgia,526,31,495,482,235,25,4,13
-1,131210087013000.000000000000000,Block 3000, Block Group 3, Census Tract 87.01, Fulton County, Georgia,525,66,459,451,43,404,0,8
-1,131210103053004.000000000000000,Block 3004, Block Group 3, Census Tract 103.05, Fulton County, Georgia,523,6,517,509,0,506,3,8
-1,131210101201004.000000000000000,Block 1004, Block Group 1, Census Tract 101.20, Fulton County, Georgia,522,73,449,416,151,233,14,33
-1,131210105282006.000000000000000,Block 2006, Block Group 2, Census Tract 105.28, Fulton County, Georgia,522,28,494,487,7,472,1,7
-1,131210105402018.000000000000000,Block 2018, Block Group 2, Census Tract 105.40, Fulton County, Georgia,521,25,496,480,13,461,0,16
-1,131210101261000.000000000000000,Block 1000, Block Group 1, Census Tract 101.26, Fulton County, Georgia,520,27,493,483,273,90,1,10
-1,131210116472011.000000000000000,Block 2011, Block Group 2, Census Tract 116.47, Fulton County, Georgia,520,151,369,353,250,80,3,16
-1,131210077091014.000000000000000,Block 1014, Block Group 1, Census Tract 77.09, Fulton County, Georgia,519,32,487,483,13,462,1,4
-1,131210029002000.000000000000000,Block 2000, Block Group 2, Census Tract 29, Fulton County, Georgia,518,23,495,470,416,37,0,25
-1,131210116311011.000000000000000,Block 1011, Block Group 1, Census Tract 116.31, Fulton County, Georgia,518,49,469,450,227,99,0,19
-1,131210101312005.000000000000000,Block 2005, Block Group 2, Census Tract 101.31, Fulton County, Georgia,517,19,498,473,148,101,1,25
-1,131210116271006.000000000000000,Block 1006, Block Group 1, Census Tract 116.27, Fulton County, Georgia,517,9,508,491,340,17,7,17
-1,131210006021004.000000000000000,Block 1004, Block Group 1, Census Tract 6.02, Fulton County, Georgia,516,24,492,484,140,130,0,8
-1,131210116503002.000000000000000,Block 3002, Block Group 3, Census Tract 116.50, Fulton County, Georgia,516,87,429,426,273,69,5,3
-1,131210010012000.000000000000000,Block 2000, Block Group 2, Census Tract 10.01, Fulton County, Georgia,515,16,499,494,325,112,0,5
-1,131210089052013.000000000000000,Block 2013, Block Group 2, Census Tract 89.05, Fulton County, Georgia,515,32,483,473,209,230,1,10
-1,131210010011005.000000000000000,Block 1005, Block Group 1, Census Tract 10.01, Fulton County, Georgia,514,52,462,442,221,164,0,20
-1,131210077092002.000000000000000,Block 2002, Block Group 2, Census Tract 77.09, Fulton County, Georgia,513,4,509,499,7,481,3,10
-1,131210101373000.000000000000000,Block 3000, Block Group 3, Census Tract 101.37, Fulton County, Georgia,513,105,408,400,201,166,4,8
-1,131210101343000.000000000000000,Block 3000, Block Group 3, Census Tract 101.34, Fulton County, Georgia,512,70,442,411,159,203,4,31
-1,131210106042004.000000000000000,Block 2004, Block Group 2, Census Tract 106.04, Fulton County, Georgia,512,18,494,489,1,488,0,5
-1,131210116493023.000000000000000,Block 3023, Block Group 3, Census Tract 116.49, Fulton County, Georgia,512,21,491,485,146,96,1,6
-1,131210116491000.000000000000000,Block 1000, Block Group 1, Census Tract 116.49, Fulton County, Georgia,510,18,492,473,228,33,8,19
-1,131210102231007.000000000000000,Block 1007, Block Group 1, Census Tract 102.23, Fulton County, Georgia,508,19,489,485,439,24,0,4
-1,131210030003001.000000000000000,Block 3001, Block Group 3, Census Tract 30, Fulton County, Georgia,507,26,481,459,388,27,3,22
-1,131210116361012.000000000000000,Block 1012, Block Group 1, Census Tract 116.36, Fulton County, Georgia,507,138,369,356,100,112,14,13
-1,131210089052020.000000000000000,Block 2020, Block Group 2, Census Tract 89.05, Fulton County, Georgia,506,24,482,465,138,296,0,17
-1,131210114233000.000000000000000,Block 3000, Block Group 3, Census Tract 114.23, Fulton County, Georgia,506,21,485,471,400,10,2,14
-1,131210006022000.000000000000000,Block 2000, Block Group 2, Census Tract 6.02, Fulton County, Georgia,505,45,460,441,193,137,6,19
-1,131210094081000.000000000000000,Block 1000, Block Group 1, Census Tract 94.08, Fulton County, Georgia,504,57,447,425,170,152,6,22
-1,131210011021000.000000000000000,Block 1000, Block Group 1, Census Tract 11.02, Fulton County, Georgia,503,29,474,465,394,35,1,9
-1,131210114441000.000000000000000,Block 1000, Block Group 1, Census Tract 114.44, Fulton County, Georgia,503,25,478,470,269,25,0,8
-1,131210094051003.000000000000000,Block 1003, Block Group 1, Census Tract 94.05, Fulton County, Georgia,502,38,464,450,125,242,5,14
-1,131210103121000.000000000000000,Block 1000, Block Group 1, Census Tract 103.12, Fulton County, Georgia,502,1,501,496,0,491,0,5
-1,131210101242002.000000000000000,Block 2002, Block Group 2, Census Tract 101.24, Fulton County, Georgia,500,95,405,397,80,296,11,8
-1,131210094053000.000000000000000,Block 3000, Block Group 3, Census Tract 94.05, Fulton County, Georgia,499,30,469,450,106,140,6,19
-1,131210103131022.000000000000000,Block 1022, Block Group 1, Census Tract 103.13, Fulton County, Georgia,499,1,498,494,5,489,0,4
-1,131210105302016.000000000000000,Block 2016, Block Group 2, Census Tract 105.30, Fulton County, Georgia,499,0,499,494,2,491,0,5
-1,131210116423000.000000000000000,Block 3000, Block Group 3, Census Tract 116.42, Fulton County, Georgia,498,42,456,435,299,47,4,21
-1,131210116521013.000000000000000,Block 1013, Block Group 1, Census Tract 116.52, Fulton County, Georgia,498,39,459,452,88,54,0,7
-1,131210116342000.000000000000000,Block 2000, Block Group 2, Census Tract 116.34, Fulton County, Georgia,497,37,460,446,235,40,5,14
-1,131210102202005.000000000000000,Block 2005, Block Group 2, Census Tract 102.20, Fulton County, Georgia,496,25,471,463,208,191,5,8
-1,131210103083011.000000000000000,Block 3011, Block Group 3, Census Tract 103.08, Fulton County, Georgia,496,9,487,486,23,461,0,1
-1,131210116541006.000000000000000,Block 1006, Block Group 1, Census Tract 116.54, Fulton County, Georgia,495,19,476,465,377,45,0,11
-1,131210072002001.000000000000000,Block 2001, Block Group 2, Census Tract 72, Fulton County, Georgia,494,15,479,476,10,466,0,3
-1,131210103052002.000000000000000,Block 2002, Block Group 2, Census Tract 103.05, Fulton County, Georgia,494,2,492,480,0,480,0,12
-1,131210105401000.000000000000000,Block 1000, Block Group 1, Census Tract 105.40, Fulton County, Georgia,494,7,487,482,3,476,0,5
-1,131210016002004.000000000000000,Block 2004, Block Group 2, Census Tract 16, Fulton County, Georgia,492,31,461,434,380,21,0,27
-1,131210092022013.000000000000000,Block 2013, Block Group 2, Census Tract 92.02, Fulton County, Georgia,492,25,467,443,156,261,5,24
-1,131210116462003.000000000000000,Block 2003, Block Group 2, Census Tract 116.46, Fulton County, Georgia,492,103,389,361,260,63,0,28
-1,131210116292004.000000000000000,Block 2004, Block Group 2, Census Tract 116.29, Fulton County, Georgia,491,51,440,424,280,64,0,16
-1,131210116481001.000000000000000,Block 1001, Block Group 1, Census Tract 116.48, Fulton County, Georgia,491,27,464,454,303,51,0,10
-1,131210081033008.000000000000000,Block 3008, Block Group 3, Census Tract 81.03, Fulton County, Georgia,490,3,487,481,0,480,0,6
-1,131210113071009.000000000000000,Block 1009, Block Group 1, Census Tract 113.07, Fulton County, Georgia,489,19,470,467,0,467,0,3
-1,131210006011010.000000000000000,Block 1010, Block Group 1, Census Tract 6.01, Fulton County, Georgia,488,17,471,455,180,61,1,16
-1,131210094052001.000000000000000,Block 2001, Block Group 2, Census Tract 94.05, Fulton County, Georgia,488,40,448,426,269,94,3,22
-1,131210105291013.000000000000000,Block 1013, Block Group 1, Census Tract 105.29, Fulton County, Georgia,488,9,479,470,9,457,3,9
-1,131210101332013.000000000000000,Block 2013, Block Group 2, Census Tract 101.33, Fulton County, Georgia,485,47,438,423,224,146,16,15
-1,131210116333006.000000000000000,Block 3006, Block Group 3, Census Tract 116.33, Fulton County, Georgia,485,53,432,423,264,55,0,9
-1,131210116442001.000000000000000,Block 2001, Block Group 2, Census Tract 116.44, Fulton County, Georgia,485,63,422,408,258,56,7,14
-1,131210116531006.000000000000000,Block 1006, Block Group 1, Census Tract 116.53, Fulton County, Georgia,484,19,465,449,321,39,0,16
-1,131210089082000.000000000000000,Block 2000, Block Group 2, Census Tract 89.08, Fulton County, Georgia,483,30,453,432,240,142,6,21
-1,131210105311000.000000000000000,Block 1000, Block Group 1, Census Tract 105.31, Fulton County, Georgia,482,4,478,472,12,450,10,6
-1,131210116412000.000000000000000,Block 2000, Block Group 2, Census Tract 116.41, Fulton County, Georgia,482,20,462,448,386,37,1,14
-1,131210017021002.000000000000000,Block 1002, Block Group 1, Census Tract 17.02, Fulton County, Georgia,480,27,453,423,343,47,1,30
-1,131210106041008.000000000000000,Block 1008, Block Group 1, Census Tract 106.04, Fulton County, Georgia,479,30,449,437,10,423,4,12
-1,131210018022001.000000000000000,Block 2001, Block Group 2, Census Tract 18.02, Fulton County, Georgia,478,30,448,432,195,217,6,16
-1,131210039002016.000000000000000,Block 2016, Block Group 2, Census Tract 39, Fulton County, Georgia,478,1,477,468,3,461,0,9
-1,131210094102001.000000000000000,Block 2001, Block Group 2, Census Tract 94.10, Fulton County, Georgia,478,24,454,446,305,114,2,8
-1,131210077082006.000000000000000,Block 2006, Block Group 2, Census Tract 77.08, Fulton County, Georgia,477,96,381,377,4,370,3,4
-1,131210094051007.000000000000000,Block 1007, Block Group 1, Census Tract 94.05, Fulton County, Georgia,477,28,449,428,171,212,1,21
-1,131210116183016.000000000000000,Block 3016, Block Group 3, Census Tract 116.18, Fulton County, Georgia,477,29,448,444,291,7,2,4
-1,131210011022005.000000000000000,Block 2005, Block Group 2, Census Tract 11.02, Fulton County, Georgia,476,33,443,415,338,23,5,28
-1,131210077072006.000000000000000,Block 2006, Block Group 2, Census Tract 77.07, Fulton County, Georgia,476,9,467,465,3,456,1,2
-1,131210114382002.000000000000000,Block 2002, Block Group 2, Census Tract 114.38, Fulton County, Georgia,476,23,453,446,369,46,5,7
-1,131210106012001.000000000000000,Block 2001, Block Group 2, Census Tract 106.01, Fulton County, Georgia,475,3,472,469,9,456,0,3
-1,131210116461016.000000000000000,Block 1016, Block Group 1, Census Tract 116.46, Fulton County, Georgia,475,45,430,417,296,80,4,13
-1,131210114442012.000000000000000,Block 2012, Block Group 2, Census Tract 114.44, Fulton County, Georgia,474,15,459,445,353,18,0,14
-1,131210101083000.000000000000000,Block 3000, Block Group 3, Census Tract 101.08, Fulton County, Georgia,471,34,437,432,354,46,0,5
-1,131210068021000.000000000000000,Block 1000, Block Group 1, Census Tract 68.02, Fulton County, Georgia,470,12,458,456,0,456,0,2
-1,131210105391015.000000000000000,Block 1015, Block Group 1, Census Tract 105.39, Fulton County, Georgia,470,11,459,447,9,438,0,12
-1,131210115111008.000000000000000,Block 1008, Block Group 1, Census Tract 115.11, Fulton County, Georgia,470,21,449,431,286,15,5,18
-1,131210094062003.000000000000000,Block 2003, Block Group 2, Census Tract 94.06, Fulton County, Georgia,466,431,35,27,14,7,2,8
-1,131210101333007.000000000000000,Block 3007, Block Group 3, Census Tract 101.33, Fulton County, Georgia,465,42,423,410,219,94,2,13
-1,131210105381002.000000000000000,Block 1002, Block Group 1, Census Tract 105.38, Fulton County, Georgia,465,9,456,452,219,231,0,4
-1,131210103073000.000000000000000,Block 3000, Block Group 3, Census Tract 103.07, Fulton County, Georgia,464,3,461,454,8,442,0,7
-1,131210105361011.000000000000000,Block 1011, Block Group 1, Census Tract 105.36, Fulton County, Georgia,464,4,460,458,8,447,0,2
-1,131210101211005.000000000000000,Block 1005, Block Group 1, Census Tract 101.21, Fulton County, Georgia,463,13,450,436,420,11,1,14
-1,131210028022011.000000000000000,Block 2011, Block Group 2, Census Tract 28.02, Fulton County, Georgia,462,49,413,388,125,222,0,25
-1,131210116491002.000000000000000,Block 1002, Block Group 1, Census Tract 116.49, Fulton County, Georgia,462,16,446,431,134,70,1,15
-1,131210116572001.000000000000000,Block 2001, Block Group 2, Census Tract 116.57, Fulton County, Georgia,462,26,436,426,144,69,0,10
-1,131210100062005.000000000000000,Block 2005, Block Group 2, Census Tract 100.06, Fulton County, Georgia,461,25,436,409,266,69,2,27
-1,131210101082001.000000000000000,Block 2001, Block Group 2, Census Tract 101.08, Fulton County, Georgia,461,12,449,439,368,31,0,10
-1,131210101293005.000000000000000,Block 3005, Block Group 3, Census Tract 101.29, Fulton County, Georgia,460,23,437,406,370,15,0,31
-1,131210116271000.000000000000000,Block 1000, Block Group 1, Census Tract 116.27, Fulton County, Georgia,459,27,432,418,101,47,2,14
-1,131210086011008.000000000000000,Block 1008, Block Group 1, Census Tract 86.01, Fulton County, Georgia,457,7,450,443,18,425,0,7
-1,131210101351000.000000000000000,Block 1000, Block Group 1, Census Tract 101.35, Fulton County, Georgia,456,35,421,404,293,50,0,17
-1,131210081042000.000000000000000,Block 2000, Block Group 2, Census Tract 81.04, Fulton County, Georgia,455,4,451,445,12,433,0,6
-1,131210113072009.000000000000000,Block 2009, Block Group 2, Census Tract 113.07, Fulton County, Georgia,455,2,453,439,8,426,4,14
-1,131210011012000.000000000000000,Block 2000, Block Group 2, Census Tract 11.01, Fulton County, Georgia,454,47,407,396,329,34,0,11
-1,131210105082000.000000000000000,Block 2000, Block Group 2, Census Tract 105.08, Fulton County, Georgia,454,3,451,446,9,436,0,5
-1,131210105361005.000000000000000,Block 1005, Block Group 1, Census Tract 105.36, Fulton County, Georgia,454,3,451,447,22,423,0,4
-1,131210116521018.000000000000000,Block 1018, Block Group 1, Census Tract 116.52, Fulton County, Georgia,454,10,444,433,97,77,0,11
-1,131210116302004.000000000000000,Block 2004, Block Group 2, Census Tract 116.30, Fulton County, Georgia,453,26,427,398,163,64,1,29
-1,131210103081004.000000000000000,Block 1004, Block Group 1, Census Tract 103.08, Fulton County, Georgia,452,8,444,427,27,391,7,17
-1,131210116461010.000000000000000,Block 1010, Block Group 1, Census Tract 116.46, Fulton County, Georgia,450,65,385,373,182,92,8,12
-1,131210116612000.000000000000000,Block 2000, Block Group 2, Census Tract 116.61, Fulton County, Georgia,450,22,428,411,336,30,0,17
-1,131210105292002.000000000000000,Block 2002, Block Group 2, Census Tract 105.29, Fulton County, Georgia,449,10,439,427,7,416,1,12
-1,131210006021002.000000000000000,Block 1002, Block Group 1, Census Tract 6.02, Fulton County, Georgia,448,31,417,399,196,78,2,18
-1,131210101171000.000000000000000,Block 1000, Block Group 1, Census Tract 101.17, Fulton County, Georgia,448,31,417,395,216,143,9,22
-1,131210102125000.000000000000000,Block 5000, Block Group 5, Census Tract 102.12, Fulton County, Georgia,448,391,57,54,23,27,0,3
-1,131210098022010.000000000000000,Block 2010, Block Group 2, Census Tract 98.02, Fulton County, Georgia,446,11,435,432,328,97,0,3
-1,131210116401010.000000000000000,Block 1010, Block Group 1, Census Tract 116.40, Fulton County, Georgia,446,8,438,430,353,27,4,8
-1,131210075001001.000000000000000,Block 1001, Block Group 1, Census Tract 75, Fulton County, Georgia,445,9,436,432,15,415,0,4
-1,131210105264017.000000000000000,Block 4017, Block Group 4, Census Tract 105.26, Fulton County, Georgia,445,10,435,435,14,418,0,0
-1,131210011013002.000000000000000,Block 3002, Block Group 3, Census Tract 11.01, Fulton County, Georgia,444,40,404,375,223,76,0,29
-1,131210105382011.000000000000000,Block 2011, Block Group 2, Census Tract 105.38, Fulton County, Georgia,444,14,430,422,0,422,0,8
-1,131210006023008.000000000000000,Block 3008, Block Group 3, Census Tract 6.02, Fulton County, Georgia,443,17,426,394,168,120,5,32
-1,131210113015008.000000000000000,Block 5008, Block Group 5, Census Tract 113.01, Fulton County, Georgia,443,18,425,419,23,395,0,6
-1,131210078082005.000000000000000,Block 2005, Block Group 2, Census Tract 78.08, Fulton County, Georgia,442,10,432,422,5,414,2,10
-1,131210094052000.000000000000000,Block 2000, Block Group 2, Census Tract 94.05, Fulton County, Georgia,442,23,419,389,199,138,3,30
-1,131210115053007.000000000000000,Block 3007, Block Group 3, Census Tract 115.05, Fulton County, Georgia,442,16,426,402,329,34,0,24
-1,131210116551012.000000000000000,Block 1012, Block Group 1, Census Tract 116.55, Fulton County, Georgia,442,18,424,420,395,5,0,4
-1,131210105181000.000000000000000,Block 1000, Block Group 1, Census Tract 105.18, Fulton County, Georgia,441,4,437,431,19,396,15,6
-1,131210087013003.000000000000000,Block 3003, Block Group 3, Census Tract 87.01, Fulton County, Georgia,439,30,409,400,19,380,1,9
-1,131210116341004.000000000000000,Block 1004, Block Group 1, Census Tract 116.34, Fulton County, Georgia,439,48,391,377,111,102,3,14
-1,131210116572002.000000000000000,Block 2002, Block Group 2, Census Tract 116.57, Fulton County, Georgia,439,35,404,385,145,51,5,19
-1,131210101213001.000000000000000,Block 3001, Block Group 3, Census Tract 101.21, Fulton County, Georgia,438,34,404,394,266,86,0,10
-1,131210101333016.000000000000000,Block 3016, Block Group 3, Census Tract 101.33, Fulton County, Georgia,438,38,400,389,198,88,0,11
-1,131210044002020.000000000000000,Block 2020, Block Group 2, Census Tract 44, Fulton County, Georgia,437,5,432,432,3,426,3,0
-1,131210115072000.000000000000000,Block 2000, Block Group 2, Census Tract 115.07, Fulton County, Georgia,437,8,429,407,376,12,0,22
-1,131210005012003.000000000000000,Block 2003, Block Group 2, Census Tract 5.01, Fulton County, Georgia,436,22,414,399,165,143,0,15
-1,131210106032009.000000000000000,Block 2009, Block Group 2, Census Tract 106.03, Fulton County, Georgia,436,3,433,428,16,412,0,5
-1,131210116541004.000000000000000,Block 1004, Block Group 1, Census Tract 116.54, Fulton County, Georgia,435,7,428,412,371,17,7,16
-1,131210087021004.000000000000000,Block 1004, Block Group 1, Census Tract 87.02, Fulton County, Georgia,434,8,426,414,47,349,0,12
-1,131210116551002.000000000000000,Block 1002, Block Group 1, Census Tract 116.55, Fulton County, Georgia,434,25,409,397,372,7,0,12
-1,131210077093002.000000000000000,Block 3002, Block Group 3, Census Tract 77.09, Fulton County, Georgia,432,13,419,412,2,409,1,7
-1,131210102182000.000000000000000,Block 2000, Block Group 2, Census Tract 102.18, Fulton County, Georgia,432,30,402,383,307,44,4,19
-1,131210105274002.000000000000000,Block 4002, Block Group 4, Census Tract 105.27, Fulton County, Georgia,432,27,405,399,14,378,3,6
-1,131210119021006.000000000000000,Block 1006, Block Group 1, Census Tract 119.02, Fulton County, Georgia,432,8,424,422,13,408,0,2
-1,131210102112000.000000000000000,Block 2000, Block Group 2, Census Tract 102.11, Fulton County, Georgia,431,31,400,393,226,136,6,7
-1,131210116123005.000000000000000,Block 3005, Block Group 3, Census Tract 116.12, Fulton County, Georgia,431,21,410,395,264,19,1,15
-1,131210017022000.000000000000000,Block 2000, Block Group 2, Census Tract 17.02, Fulton County, Georgia,429,33,396,382,323,34,7,14
-1,131210018022000.000000000000000,Block 2000, Block Group 2, Census Tract 18.02, Fulton County, Georgia,429,11,418,402,78,309,4,16
-1,131210089091002.000000000000000,Block 1002, Block Group 1, Census Tract 89.09, Fulton County, Georgia,429,29,400,385,253,104,1,15
-1,131210114261005.000000000000000,Block 1005, Block Group 1, Census Tract 114.26, Fulton County, Georgia,429,69,360,349,223,78,1,11
-1,131210077033004.000000000000000,Block 3004, Block Group 3, Census Tract 77.03, Fulton County, Georgia,428,0,428,426,2,424,0,2
-1,131210102141000.000000000000000,Block 1000, Block Group 1, Census Tract 102.14, Fulton County, Georgia,428,61,367,351,115,204,7,16
-1,131210105171013.000000000000000,Block 1013, Block Group 1, Census Tract 105.17, Fulton County, Georgia,428,16,412,407,4,400,3,5
-1,131210010021003.000000000000000,Block 1003, Block Group 1, Census Tract 10.02, Fulton County, Georgia,427,17,410,382,121,155,5,28
-1,131210105212013.000000000000000,Block 2013, Block Group 2, Census Tract 105.21, Fulton County, Georgia,427,7,420,418,5,410,3,2
-1,131210105284002.000000000000000,Block 4002, Block Group 4, Census Tract 105.28, Fulton County, Georgia,427,49,378,377,19,355,0,1
-1,131210114363000.000000000000000,Block 3000, Block Group 3, Census Tract 114.36, Fulton County, Georgia,427,5,422,413,382,10,2,9
-1,131210115071014.000000000000000,Block 1014, Block Group 1, Census Tract 115.07, Fulton County, Georgia,427,19,408,401,358,22,0,7
-1,131210116272000.000000000000000,Block 2000, Block Group 2, Census Tract 116.27, Fulton County, Georgia,427,31,396,385,161,34,3,11
-1,131210105274000.000000000000000,Block 4000, Block Group 4, Census Tract 105.27, Fulton County, Georgia,426,17,409,403,18,382,1,6
-1,131210096042001.000000000000000,Block 2001, Block Group 2, Census Tract 96.04, Fulton County, Georgia,425,33,392,378,302,45,1,14
-1,131210101361002.000000000000000,Block 1002, Block Group 1, Census Tract 101.36, Fulton County, Georgia,425,20,405,396,261,109,0,9
-1,131210015012002.000000000000000,Block 2002, Block Group 2, Census Tract 15.01, Fulton County, Georgia,424,21,403,393,187,185,0,10
-1,131210012063000.000000000000000,Block 3000, Block Group 3, Census Tract 12.06, Fulton County, Georgia,423,28,395,373,276,57,0,22
-1,131210089051008.000000000000000,Block 1008, Block Group 1, Census Tract 89.05, Fulton County, Georgia,423,12,411,395,150,216,0,16
-1,131210101281001.000000000000000,Block 1001, Block Group 1, Census Tract 101.28, Fulton County, Georgia,423,271,152,148,62,60,1,4
-1,131210102162000.000000000000000,Block 2000, Block Group 2, Census Tract 102.16, Fulton County, Georgia,423,29,394,373,258,102,0,21
-1,131210105274006.000000000000000,Block 4006, Block Group 4, Census Tract 105.27, Fulton County, Georgia,423,129,294,284,25,256,3,10
-1,131210102041003.000000000000000,Block 1003, Block Group 1, Census Tract 102.04, Fulton County, Georgia,422,18,404,397,372,17,0,7
-1,131210105203006.000000000000000,Block 3006, Block Group 3, Census Tract 105.20, Fulton County, Georgia,422,17,405,399,41,358,0,6
-1,131210114412006.000000000000000,Block 2006, Block Group 2, Census Tract 114.41, Fulton County, Georgia,422,9,413,400,320,34,6,13
-1,131210096051005.000000000000000,Block 1005, Block Group 1, Census Tract 96.05, Fulton County, Georgia,420,41,379,366,247,66,5,13
-1,131210105171008.000000000000000,Block 1008, Block Group 1, Census Tract 105.17, Fulton County, Georgia,420,6,414,407,0,394,5,7
-1,131210100033000.000000000000000,Block 3000, Block Group 3, Census Tract 100.03, Fulton County, Georgia,419,18,401,392,352,16,0,9
-1,131210012062004.000000000000000,Block 2004, Block Group 2, Census Tract 12.06, Fulton County, Georgia,418,27,391,365,246,65,2,26
-1,131210078101000.000000000000000,Block 1000, Block Group 1, Census Tract 78.10, Fulton County, Georgia,418,6,412,406,6,397,0,6
-1,131210101362004.000000000000000,Block 2004, Block Group 2, Census Tract 101.36, Fulton County, Georgia,417,52,365,359,282,55,0,6
-1,131210104011024.000000000000000,Block 1024, Block Group 1, Census Tract 104.01, Fulton County, Georgia,417,9,408,405,10,390,5,3
-1,131210116592007.000000000000000,Block 2007, Block Group 2, Census Tract 116.59, Fulton County, Georgia,417,5,412,402,278,19,0,10
-1,131210115102002.000000000000000,Block 2002, Block Group 2, Census Tract 115.10, Fulton County, Georgia,416,16,400,389,269,5,0,11
-1,131210116473015.000000000000000,Block 3015, Block Group 3, Census Tract 116.47, Fulton County, Georgia,416,277,139,128,62,56,3,11
-1,131210011011000.000000000000000,Block 1000, Block Group 1, Census Tract 11.01, Fulton County, Georgia,415,22,393,382,321,33,5,11
-1,131210098021016.000000000000000,Block 1016, Block Group 1, Census Tract 98.02, Fulton County, Georgia,415,7,408,395,363,3,0,13
-1,131210103073001.000000000000000,Block 3001, Block Group 3, Census Tract 103.07, Fulton County, Georgia,415,2,413,402,3,399,0,11
-1,131210018021003.000000000000000,Block 1003, Block Group 1, Census Tract 18.02, Fulton County, Georgia,413,19,394,372,149,194,2,22
-1,131210095041005.000000000000000,Block 1005, Block Group 1, Census Tract 95.04, Fulton County, Georgia,413,13,400,392,357,22,1,8
-1,131210103091024.000000000000000,Block 1024, Block Group 1, Census Tract 103.09, Fulton County, Georgia,413,10,403,402,28,374,0,1
-1,131210114164002.000000000000000,Block 4002, Block Group 4, Census Tract 114.16, Fulton County, Georgia,412,23,389,365,255,43,0,24
-1,131210053001007.000000000000000,Block 1007, Block Group 1, Census Tract 53, Fulton County, Georgia,411,10,401,390,265,107,3,11
-1,131210094053002.000000000000000,Block 3002, Block Group 3, Census Tract 94.05, Fulton County, Georgia,411,20,391,380,106,104,4,11
-1,131210105302020.000000000000000,Block 2020, Block Group 2, Census Tract 105.30, Fulton County, Georgia,411,8,403,400,3,397,0,3
-1,131210011022006.000000000000000,Block 2006, Block Group 2, Census Tract 11.02, Fulton County, Georgia,410,31,379,370,261,74,4,9
-1,131210038001000.000000000000000,Block 1000, Block Group 1, Census Tract 38, Fulton County, Georgia,410,0,410,410,0,410,0,0
-1,131210105222025.000000000000000,Block 2025, Block Group 2, Census Tract 105.22, Fulton County, Georgia,409,7,402,399,4,391,3,3
-1,131210115131010.000000000000000,Block 1010, Block Group 1, Census Tract 115.13, Fulton County, Georgia,409,7,402,386,355,22,0,16
-1,131210116242005.000000000000000,Block 2005, Block Group 2, Census Tract 116.24, Fulton County, Georgia,409,26,383,357,286,28,1,26
-1,131210077093000.000000000000000,Block 3000, Block Group 3, Census Tract 77.09, Fulton County, Georgia,407,3,404,402,2,400,0,2
-1,131210084002005.000000000000000,Block 2005, Block Group 2, Census Tract 84, Fulton County, Georgia,407,5,402,401,29,370,0,1
-1,131210116302001.000000000000000,Block 2001, Block Group 2, Census Tract 116.30, Fulton County, Georgia,407,35,372,363,140,69,7,9
-1,131210053003006.000000000000000,Block 3006, Block Group 3, Census Tract 53, Fulton County, Georgia,406,8,398,384,282,87,1,14
-1,131210077101005.000000000000000,Block 1005, Block Group 1, Census Tract 77.10, Fulton County, Georgia,406,2,404,404,12,391,0,0
-1,131210094062009.000000000000000,Block 2009, Block Group 2, Census Tract 94.06, Fulton County, Georgia,406,64,342,329,153,114,1,13
-1,131210103063007.000000000000000,Block 3007, Block Group 3, Census Tract 103.06, Fulton County, Georgia,405,8,397,394,8,379,7,3
-1,131210002012013.000000000000000,Block 2013, Block Group 2, Census Tract 2.01, Fulton County, Georgia,404,14,390,384,363,7,4,6
-1,131210105391002.000000000000000,Block 1002, Block Group 1, Census Tract 105.39, Fulton County, Georgia,404,10,394,391,1,390,0,3
-1,131210116441000.000000000000000,Block 1000, Block Group 1, Census Tract 116.44, Fulton County, Georgia,404,34,370,362,101,95,3,8
-1,131210103072003.000000000000000,Block 2003, Block Group 2, Census Tract 103.07, Fulton County, Georgia,402,2,400,392,7,378,5,8
-1,131210095041014.000000000000000,Block 1014, Block Group 1, Census Tract 95.04, Fulton County, Georgia,401,21,380,377,284,68,5,3
-1,131210116602009.000000000000000,Block 2009, Block Group 2, Census Tract 116.60, Fulton County, Georgia,400,25,375,364,275,25,0,11
-1,131210071001007.000000000000000,Block 1007, Block Group 1, Census Tract 71, Fulton County, Georgia,399,1,398,396,8,387,0,2
-1,131210113091004.000000000000000,Block 1004, Block Group 1, Census Tract 113.09, Fulton County, Georgia,399,25,374,366,26,336,4,8
-1,131210115053012.000000000000000,Block 3012, Block Group 3, Census Tract 115.05, Fulton County, Georgia,399,7,392,383,327,27,0,9
-1,131210115072002.000000000000000,Block 2002, Block Group 2, Census Tract 115.07, Fulton County, Georgia,399,6,393,374,334,17,0,19
-1,131210093011002.000000000000000,Block 1002, Block Group 1, Census Tract 93.01, Fulton County, Georgia,398,42,356,349,224,103,2,7
-1,131210103092011.000000000000000,Block 2011, Block Group 2, Census Tract 103.09, Fulton County, Georgia,397,9,388,388,18,370,0,0
-1,131210114422000.000000000000000,Block 2000, Block Group 2, Census Tract 114.42, Fulton County, Georgia,397,27,370,361,322,25,0,9
-1,131210012051001.000000000000000,Block 1001, Block Group 1, Census Tract 12.05, Fulton County, Georgia,396,44,352,340,281,20,0,12
-1,131210115052000.000000000000000,Block 2000, Block Group 2, Census Tract 115.05, Fulton County, Georgia,396,9,387,365,308,31,0,22
-1,131210010012008.000000000000000,Block 2008, Block Group 2, Census Tract 10.01, Fulton County, Georgia,395,24,371,357,232,32,0,14
-1,131210077112001.000000000000000,Block 2001, Block Group 2, Census Tract 77.11, Fulton County, Georgia,395,4,391,391,2,384,2,0
-1,131210116552008.000000000000000,Block 2008, Block Group 2, Census Tract 116.55, Fulton County, Georgia,395,20,375,363,327,19,6,12
-1,131210031002000.000000000000000,Block 2000, Block Group 2, Census Tract 31, Fulton County, Georgia,394,30,364,356,237,98,0,8
-1,131210031002004.000000000000000,Block 2004, Block Group 2, Census Tract 31, Fulton County, Georgia,393,43,350,326,193,92,1,24
-1,131210098023008.000000000000000,Block 3008, Block Group 3, Census Tract 98.02, Fulton County, Georgia,393,30,363,359,308,19,1,4
-1,131210114212001.000000000000000,Block 2001, Block Group 2, Census Tract 114.21, Fulton County, Georgia,393,63,330,322,182,84,3,8
-1,131210105282000.000000000000000,Block 2000, Block Group 2, Census Tract 105.28, Fulton County, Georgia,392,256,136,136,15,113,0,0
-1,131210116391011.000000000000000,Block 1011, Block Group 1, Census Tract 116.39, Fulton County, Georgia,392,42,350,328,160,64,1,22
-1,131210096053000.000000000000000,Block 3000, Block Group 3, Census Tract 96.05, Fulton County, Georgia,391,32,359,338,206,105,0,21
-1,131210030001026.000000000000000,Block 1026, Block Group 1, Census Tract 30, Fulton County, Georgia,390,17,373,359,279,53,0,14
-1,131210101322000.000000000000000,Block 2000, Block Group 2, Census Tract 101.32, Fulton County, Georgia,390,39,351,333,159,115,0,18
-1,131210115132002.000000000000000,Block 2002, Block Group 2, Census Tract 115.13, Fulton County, Georgia,390,3,387,377,364,8,3,10
-1,131210116361014.000000000000000,Block 1014, Block Group 1, Census Tract 116.36, Fulton County, Georgia,390,127,263,258,97,100,10,5
-1,131210114163008.000000000000000,Block 3008, Block Group 3, Census Tract 114.16, Fulton County, Georgia,389,39,350,335,314,7,0,15
-1,131210116333003.000000000000000,Block 3003, Block Group 3, Census Tract 116.33, Fulton County, Georgia,389,41,348,336,230,55,5,12
-1,131210055032000.000000000000000,Block 2000, Block Group 2, Census Tract 55.03, Fulton County, Georgia,388,6,382,373,1,370,0,9
-1,131210096044004.000000000000000,Block 4004, Block Group 4, Census Tract 96.04, Fulton County, Georgia,388,12,376,358,299,44,1,18
-1,131210105083004.000000000000000,Block 3004, Block Group 3, Census Tract 105.08, Fulton County, Georgia,388,11,377,377,11,364,0,0
-1,131210105252000.000000000000000,Block 2000, Block Group 2, Census Tract 105.25, Fulton County, Georgia,388,4,384,382,0,378,1,2
-1,131210075002000.000000000000000,Block 2000, Block Group 2, Census Tract 75, Fulton County, Georgia,387,16,371,365,24,333,6,6
-1,131210103072011.000000000000000,Block 2011, Block Group 2, Census Tract 103.07, Fulton County, Georgia,387,17,370,366,16,350,0,4
-1,131210103141001.000000000000000,Block 1001, Block Group 1, Census Tract 103.14, Fulton County, Georgia,386,9,377,370,9,358,3,7
-1,131210114193002.000000000000000,Block 3002, Block Group 3, Census Tract 114.19, Fulton County, Georgia,386,4,382,379,352,6,7,3
-1,131210116411015.000000000000000,Block 1015, Block Group 1, Census Tract 116.41, Fulton County, Georgia,386,14,372,369,244,3,2,3
-1,131210077111000.000000000000000,Block 1000, Block Group 1, Census Tract 77.11, Fulton County, Georgia,385,5,380,377,5,369,0,3
-1,131210081041003.000000000000000,Block 1003, Block Group 1, Census Tract 81.04, Fulton County, Georgia,385,11,374,370,3,366,1,4
-1,131210019023000.000000000000000,Block 3000, Block Group 3, Census Tract 19.02, Fulton County, Georgia,384,12,372,365,123,212,6,7
-1,131210006011002.000000000000000,Block 1002, Block Group 1, Census Tract 6.01, Fulton County, Georgia,383,31,352,338,248,62,0,14
-1,131210010021011.000000000000000,Block 1011, Block Group 1, Census Tract 10.02, Fulton County, Georgia,383,27,356,349,120,34,1,7
-1,131210096041000.000000000000000,Block 1000, Block Group 1, Census Tract 96.04, Fulton County, Georgia,383,46,337,330,282,22,0,7
-1,131210114452011.000000000000000,Block 2011, Block Group 2, Census Tract 114.45, Fulton County, Georgia,383,30,353,341,316,8,4,12
-1,131210100071004.000000000000000,Block 1004, Block Group 1, Census Tract 100.07, Fulton County, Georgia,382,8,374,368,345,15,0,6
-1,131210115152004.000000000000000,Block 2004, Block Group 2, Census Tract 115.15, Fulton County, Georgia,382,2,380,357,338,1,1,23
-1,131210116383013.000000000000000,Block 3013, Block Group 3, Census Tract 116.38, Fulton County, Georgia,382,22,360,354,210,41,3,6
-1,131210116551010.000000000000000,Block 1010, Block Group 1, Census Tract 116.55, Fulton County, Georgia,382,17,365,362,302,6,0,3
-1,131210094062010.000000000000000,Block 2010, Block Group 2, Census Tract 94.06, Fulton County, Georgia,381,19,362,341,126,162,1,21
-1,131210102152003.000000000000000,Block 2003, Block Group 2, Census Tract 102.15, Fulton County, Georgia,381,11,370,365,321,19,4,5
-1,131210103101014.000000000000000,Block 1014, Block Group 1, Census Tract 103.10, Fulton County, Georgia,381,2,379,370,1,365,1,9
-1,131210105201014.000000000000000,Block 1014, Block Group 1, Census Tract 105.20, Fulton County, Georgia,381,7,374,374,5,364,0,0
-1,131210105271008.000000000000000,Block 1008, Block Group 1, Census Tract 105.27, Fulton County, Georgia,381,24,357,354,41,313,0,3
-1,131210014001003.000000000000000,Block 1003, Block Group 1, Census Tract 14, Fulton County, Georgia,380,34,346,346,298,18,0,0
-1,131210114373000.000000000000000,Block 3000, Block Group 3, Census Tract 114.37, Fulton County, Georgia,380,34,346,337,287,37,0,9
-1,131210050002001.000000000000000,Block 2001, Block Group 2, Census Tract 50, Fulton County, Georgia,379,27,352,339,197,119,5,13
-1,131210091052002.000000000000000,Block 2002, Block Group 2, Census Tract 91.05, Fulton County, Georgia,379,3,376,369,317,32,1,7
-1,131210077082014.000000000000000,Block 2014, Block Group 2, Census Tract 77.08, Fulton County, Georgia,378,19,359,354,0,345,9,5
-1,131210076021004.000000000000000,Block 1004, Block Group 1, Census Tract 76.02, Fulton County, Georgia,377,5,372,363,7,355,1,9
-1,131210105322014.000000000000000,Block 2014, Block Group 2, Census Tract 105.32, Fulton County, Georgia,377,2,375,373,0,373,0,2
-1,131210116521023.000000000000000,Block 1023, Block Group 1, Census Tract 116.52, Fulton County, Georgia,376,20,356,346,103,20,0,10
-1,131210081041007.000000000000000,Block 1007, Block Group 1, Census Tract 81.04, Fulton County, Georgia,375,11,364,364,7,357,0,0
-1,131210101323002.000000000000000,Block 3002, Block Group 3, Census Tract 101.32, Fulton County, Georgia,375,29,346,340,269,39,2,6
-1,131210114401004.000000000000000,Block 1004, Block Group 1, Census Tract 114.40, Fulton County, Georgia,375,9,366,353,321,14,0,13
-1,131210113104004.000000000000000,Block 4004, Block Group 4, Census Tract 113.10, Fulton County, Georgia,374,113,261,259,12,246,0,2
-1,131210115141003.000000000000000,Block 1003, Block Group 1, Census Tract 115.14, Fulton County, Georgia,373,16,357,348,336,5,0,9
-1,131210005014004.000000000000000,Block 4004, Block Group 4, Census Tract 5.01, Fulton County, Georgia,372,31,341,321,116,120,0,20
-1,131210105172001.000000000000000,Block 2001, Block Group 2, Census Tract 105.17, Fulton County, Georgia,372,8,364,355,14,341,0,9
-1,131210098032001.000000000000000,Block 2001, Block Group 2, Census Tract 98.03, Fulton County, Georgia,371,8,363,355,281,12,0,8
-1,131210102044000.000000000000000,Block 4000, Block Group 4, Census Tract 102.04, Fulton County, Georgia,371,11,360,358,346,11,1,2
-1,131210103083008.000000000000000,Block 3008, Block Group 3, Census Tract 103.08, Fulton County, Georgia,371,6,365,356,10,344,0,9
-1,131210010021002.000000000000000,Block 1002, Block Group 1, Census Tract 10.02, Fulton County, Georgia,368,15,353,344,109,79,2,9
-1,131210101213000.000000000000000,Block 3000, Block Group 3, Census Tract 101.21, Fulton County, Georgia,368,20,348,342,194,64,0,6
-1,131210102201018.000000000000000,Block 1018, Block Group 1, Census Tract 102.20, Fulton County, Georgia,368,27,341,327,251,44,0,14
-1,131210108011018.000000000000000,Block 1018, Block Group 1, Census Tract 108.01, Fulton County, Georgia,368,23,345,344,70,230,7,1
-1,131210116402022.000000000000000,Block 2022, Block Group 2, Census Tract 116.40, Fulton County, Georgia,368,11,357,346,270,30,0,11
-1,131210018022003.000000000000000,Block 2003, Block Group 2, Census Tract 18.02, Fulton County, Georgia,367,35,332,315,195,85,2,17
-1,131210096072002.000000000000000,Block 2002, Block Group 2, Census Tract 96.07, Fulton County, Georgia,367,35,332,322,174,108,1,10
-1,131210096073006.000000000000000,Block 3006, Block Group 3, Census Tract 96.07, Fulton County, Georgia,367,12,355,342,211,101,5,13
-1,131210102151000.000000000000000,Block 1000, Block Group 1, Census Tract 102.15, Fulton County, Georgia,367,55,312,288,98,152,19,24
-1,131210105261026.000000000000000,Block 1026, Block Group 1, Census Tract 105.26, Fulton County, Georgia,367,14,353,345,7,338,0,8
-1,131210101362010.000000000000000,Block 2010, Block Group 2, Census Tract 101.36, Fulton County, Georgia,366,15,351,348,337,10,0,3
-1,131210049001015.000000000000000,Block 1015, Block Group 1, Census Tract 49, Fulton County, Georgia,365,1,364,356,29,326,0,8
-1,131210060004000.000000000000000,Block 4000, Block Group 4, Census Tract 60, Fulton County, Georgia,365,0,365,365,13,339,1,0
-1,131210078094008.000000000000000,Block 4008, Block Group 4, Census Tract 78.09, Fulton County, Georgia,365,3,362,362,0,362,0,0
-1,131210079001009.000000000000000,Block 1009, Block Group 1, Census Tract 79, Fulton County, Georgia,365,0,365,355,10,345,0,10
-1,131210114301008.000000000000000,Block 1008, Block Group 1, Census Tract 114.30, Fulton County, Georgia,365,313,52,48,19,29,0,4
-1,131210012052005.000000000000000,Block 2005, Block Group 2, Census Tract 12.05, Fulton County, Georgia,364,38,326,309,186,60,4,17
-1,131210089053011.000000000000000,Block 3011, Block Group 3, Census Tract 89.05, Fulton County, Georgia,364,23,341,332,189,126,2,9
-1,131210101083004.000000000000000,Block 3004, Block Group 3, Census Tract 101.08, Fulton County, Georgia,363,35,328,324,170,133,0,4
-1,131210094111001.000000000000000,Block 1001, Block Group 1, Census Tract 94.11, Fulton County, Georgia,362,18,344,327,273,30,4,17
-1,131210114194011.000000000000000,Block 4011, Block Group 4, Census Tract 114.19, Fulton County, Georgia,362,11,351,342,307,24,0,9
-1,131210097002008.000000000000000,Block 2008, Block Group 2, Census Tract 97, Fulton County, Georgia,361,18,343,343,303,19,0,0
-1,131210114231003.000000000000000,Block 1003, Block Group 1, Census Tract 114.23, Fulton County, Georgia,361,60,301,280,234,36,2,21
-1,131210114461010.000000000000000,Block 1010, Block Group 1, Census Tract 114.46, Fulton County, Georgia,361,6,355,340,307,14,3,15
-1,131210116473003.000000000000000,Block 3003, Block Group 3, Census Tract 116.47, Fulton County, Georgia,360,11,349,340,280,35,0,9
-1,131210010012009.000000000000000,Block 2009, Block Group 2, Census Tract 10.01, Fulton County, Georgia,359,29,330,322,195,63,0,8
-1,131210038001012.000000000000000,Block 1012, Block Group 1, Census Tract 38, Fulton County, Georgia,359,0,359,358,0,358,0,1
-1,131210089073003.000000000000000,Block 3003, Block Group 3, Census Tract 89.07, Fulton County, Georgia,359,32,327,316,237,62,0,11
-1,131210012041013.000000000000000,Block 1013, Block Group 1, Census Tract 12.04, Fulton County, Georgia,357,42,315,306,239,43,2,9
-1,131210089071007.000000000000000,Block 1007, Block Group 1, Census Tract 89.07, Fulton County, Georgia,357,23,334,320,174,142,2,14
-1,131210094112004.000000000000000,Block 2004, Block Group 2, Census Tract 94.11, Fulton County, Georgia,357,9,348,336,229,78,2,12
-1,131210097001002.000000000000000,Block 1002, Block Group 1, Census Tract 97, Fulton County, Georgia,357,18,339,329,224,80,1,10
-1,131210101082000.000000000000000,Block 2000, Block Group 2, Census Tract 101.08, Fulton County, Georgia,357,11,346,339,293,21,0,7
-1,131210101211000.000000000000000,Block 1000, Block Group 1, Census Tract 101.21, Fulton County, Georgia,357,6,351,338,280,18,0,13
-1,131210103083013.000000000000000,Block 3013, Block Group 3, Census Tract 103.08, Fulton County, Georgia,357,3,354,349,24,325,0,5
-1,131210106043015.000000000000000,Block 3015, Block Group 3, Census Tract 106.04, Fulton County, Georgia,357,15,342,334,11,319,0,8
-1,131210114192010.000000000000000,Block 2010, Block Group 2, Census Tract 114.19, Fulton County, Georgia,357,16,341,330,309,17,0,11
-1,131210001005005.000000000000000,Block 5005, Block Group 5, Census Tract 1, Fulton County, Georgia,356,27,329,307,276,20,2,22
-1,131210052002007.000000000000000,Block 2007, Block Group 2, Census Tract 52, Fulton County, Georgia,356,4,352,347,39,306,0,5
-1,131210076041000.000000000000000,Block 1000, Block Group 1, Census Tract 76.04, Fulton County, Georgia,356,6,350,342,1,338,2,8
-1,131210092011000.000000000000000,Block 1000, Block Group 1, Census Tract 92.01, Fulton County, Georgia,356,151,205,199,104,88,0,6
-1,131210017021001.000000000000000,Block 1001, Block Group 1, Census Tract 17.02, Fulton County, Georgia,355,6,349,330,246,45,0,19
-1,131210028022000.000000000000000,Block 2000, Block Group 2, Census Tract 28.02, Fulton County, Georgia,355,7,348,329,121,176,0,19
-1,131210105311008.000000000000000,Block 1008, Block Group 1, Census Tract 105.31, Fulton County, Georgia,355,34,321,315,5,310,0,6
-1,131210112042005.000000000000000,Block 2005, Block Group 2, Census Tract 112.04, Fulton County, Georgia,355,7,348,346,7,339,0,2
-1,131210113103002.000000000000000,Block 3002, Block Group 3, Census Tract 113.10, Fulton County, Georgia,355,28,327,313,18,287,5,14
-1,131210116562006.000000000000000,Block 2006, Block Group 2, Census Tract 116.56, Fulton County, Georgia,355,18,337,325,232,44,0,12
-1,131210075002002.000000000000000,Block 2002, Block Group 2, Census Tract 75, Fulton County, Georgia,354,0,354,354,0,354,0,0
-1,131210103101010.000000000000000,Block 1010, Block Group 1, Census Tract 103.10, Fulton County, Georgia,354,3,351,345,3,340,2,6
-1,131210105372001.000000000000000,Block 2001, Block Group 2, Census Tract 105.37, Fulton County, Georgia,354,13,341,333,3,328,1,8
-1,131210079001000.000000000000000,Block 1000, Block Group 1, Census Tract 79, Fulton County, Georgia,353,4,349,341,19,315,5,8
-1,131210115152002.000000000000000,Block 2002, Block Group 2, Census Tract 115.15, Fulton County, Georgia,353,14,339,332,291,6,1,7
-1,131210116352005.000000000000000,Block 2005, Block Group 2, Census Tract 116.35, Fulton County, Georgia,353,5,348,342,114,33,0,6
-1,131210113101002.000000000000000,Block 1002, Block Group 1, Census Tract 113.10, Fulton County, Georgia,351,34,317,316,2,312,0,1
-1,131210116332004.000000000000000,Block 2004, Block Group 2, Census Tract 116.33, Fulton County, Georgia,351,12,339,333,289,22,0,6
-1,131210105251006.000000000000000,Block 1006, Block Group 1, Census Tract 105.25, Fulton County, Georgia,350,4,346,340,3,335,0,6
-1,131210116312000.000000000000000,Block 2000, Block Group 2, Census Tract 116.31, Fulton County, Georgia,350,24,326,300,196,14,0,26
-1,131210116413002.000000000000000,Block 3002, Block Group 3, Census Tract 116.41, Fulton County, Georgia,350,13,337,328,264,20,0,9
-1,131210002012009.000000000000000,Block 2009, Block Group 2, Census Tract 2.01, Fulton County, Georgia,349,25,324,307,252,22,2,17
-1,131210043003012.000000000000000,Block 3012, Block Group 3, Census Tract 43, Fulton County, Georgia,349,5,344,342,5,337,0,2
-1,131210012052007.000000000000000,Block 2007, Block Group 2, Census Tract 12.05, Fulton County, Georgia,348,13,335,314,207,78,1,21
-1,131210114192001.000000000000000,Block 2001, Block Group 2, Census Tract 114.19, Fulton County, Georgia,348,23,325,316,258,29,0,9
-1,131210006011007.000000000000000,Block 1007, Block Group 1, Census Tract 6.01, Fulton County, Georgia,347,20,327,321,186,89,2,6
-1,131210116391013.000000000000000,Block 1013, Block Group 1, Census Tract 116.39, Fulton County, Georgia,347,27,320,308,214,47,3,12
-1,131210068011000.000000000000000,Block 1000, Block Group 1, Census Tract 68.01, Fulton County, Georgia,346,20,326,323,83,239,0,3
-1,131210089053014.000000000000000,Block 3014, Block Group 3, Census Tract 89.05, Fulton County, Georgia,346,26,320,305,249,31,0,15
-1,131210091031004.000000000000000,Block 1004, Block Group 1, Census Tract 91.03, Fulton County, Georgia,346,17,329,325,277,24,0,4
-1,131210094062011.000000000000000,Block 2011, Block Group 2, Census Tract 94.06, Fulton County, Georgia,346,30,316,299,130,106,0,17
-1,131210105191013.000000000000000,Block 1013, Block Group 1, Census Tract 105.19, Fulton County, Georgia,346,49,297,296,49,233,9,1
-1,131210115053005.000000000000000,Block 3005, Block Group 3, Census Tract 115.05, Fulton County, Georgia,346,14,332,326,286,14,2,6
-1,131210105371008.000000000000000,Block 1008, Block Group 1, Census Tract 105.37, Fulton County, Georgia,345,6,339,333,1,327,2,6
-1,131210114391006.000000000000000,Block 1006, Block Group 1, Census Tract 114.39, Fulton County, Georgia,345,16,329,311,224,57,6,18
-1,131210105283003.000000000000000,Block 3003, Block Group 3, Census Tract 105.28, Fulton County, Georgia,344,85,259,256,41,215,0,3
-1,131210114462000.000000000000000,Block 2000, Block Group 2, Census Tract 114.46, Fulton County, Georgia,344,15,329,322,275,41,0,7
-1,131210116471005.000000000000000,Block 1005, Block Group 1, Census Tract 116.47, Fulton County, Georgia,344,25,319,316,234,16,0,3
-1,131210116592005.000000000000000,Block 2005, Block Group 2, Census Tract 116.59, Fulton County, Georgia,344,15,329,304,275,5,0,25
-1,131210102043005.000000000000000,Block 3005, Block Group 3, Census Tract 102.04, Fulton County, Georgia,343,4,339,335,310,18,0,4
-1,131210006023001.000000000000000,Block 3001, Block Group 3, Census Tract 6.02, Fulton County, Georgia,342,24,318,292,131,112,4,26
-1,131210024001011.000000000000000,Block 1011, Block Group 1, Census Tract 24, Fulton County, Georgia,342,11,331,321,12,308,0,10
-1,131210026001019.000000000000000,Block 1019, Block Group 1, Census Tract 26, Fulton County, Georgia,342,3,339,336,21,305,1,3
-1,131210076022005.000000000000000,Block 2005, Block Group 2, Census Tract 76.02, Fulton County, Georgia,342,3,339,339,3,336,0,0
-1,131210088011033.000000000000000,Block 1033, Block Group 1, Census Tract 88.01, Fulton County, Georgia,342,13,329,318,28,287,1,11
-1,131210115141007.000000000000000,Block 1007, Block Group 1, Census Tract 115.14, Fulton County, Georgia,342,9,333,332,312,19,0,1
-1,131210118022013.000000000000000,Block 2013, Block Group 2, Census Tract 118.02, Fulton County, Georgia,342,15,327,318,43,269,0,9
-1,131210015022003.000000000000000,Block 2003, Block Group 2, Census Tract 15.02, Fulton County, Georgia,341,23,318,299,268,14,2,19
-1,131210016002000.000000000000000,Block 2000, Block Group 2, Census Tract 16, Fulton County, Georgia,341,20,321,315,269,11,1,6
-1,131210115122029.000000000000000,Block 2029, Block Group 2, Census Tract 115.12, Fulton County, Georgia,341,25,316,301,276,3,6,15
-1,131210093012004.000000000000000,Block 2004, Block Group 2, Census Tract 93.01, Fulton County, Georgia,340,15,325,320,316,4,0,5
-1,131210055042000.000000000000000,Block 2000, Block Group 2, Census Tract 55.04, Fulton County, Georgia,339,4,335,330,25,303,2,5
-1,131210089061005.000000000000000,Block 1005, Block Group 1, Census Tract 89.06, Fulton County, Georgia,339,6,333,328,310,7,0,5
-1,131210105182002.000000000000000,Block 2002, Block Group 2, Census Tract 105.18, Fulton County, Georgia,339,4,335,332,5,317,10,3
-1,131210115052003.000000000000000,Block 2003, Block Group 2, Census Tract 115.05, Fulton County, Georgia,339,11,328,317,268,39,0,11
-1,131210100052000.000000000000000,Block 2000, Block Group 2, Census Tract 100.05, Fulton County, Georgia,338,21,317,312,292,10,1,5
-1,131210101303001.000000000000000,Block 3001, Block Group 3, Census Tract 101.30, Fulton County, Georgia,338,11,327,319,19,59,0,8
-1,131210103083000.000000000000000,Block 3000, Block Group 3, Census Tract 103.08, Fulton County, Georgia,338,3,335,329,10,319,0,6
-1,131210116533001.000000000000000,Block 3001, Block Group 3, Census Tract 116.53, Fulton County, Georgia,338,14,324,311,238,24,3,13
-1,131210076031002.000000000000000,Block 1002, Block Group 1, Census Tract 76.03, Fulton County, Georgia,337,7,330,325,4,319,2,5
-1,131210116291001.000000000000000,Block 1001, Block Group 1, Census Tract 116.29, Fulton County, Georgia,336,7,329,306,215,11,0,23
-1,131210070021007.000000000000000,Block 1007, Block Group 1, Census Tract 70.02, Fulton County, Georgia,335,5,330,329,6,319,0,1
-1,131210116443007.000000000000000,Block 3007, Block Group 3, Census Tract 116.44, Fulton County, Georgia,335,34,301,298,94,59,0,3
-1,131210010022005.000000000000000,Block 2005, Block Group 2, Census Tract 10.02, Fulton County, Georgia,334,56,278,265,149,107,0,13
-1,131210013021001.000000000000000,Block 1001, Block Group 1, Census Tract 13.02, Fulton County, Georgia,334,18,316,304,216,42,0,12
-1,131210114432001.000000000000000,Block 2001, Block Group 2, Census Tract 114.43, Fulton County, Georgia,334,6,328,320,201,13,0,8
-1,131210116322004.000000000000000,Block 2004, Block Group 2, Census Tract 116.32, Fulton County, Georgia,334,19,315,304,49,60,0,11
-1,131210017011001.000000000000000,Block 1001, Block Group 1, Census Tract 17.01, Fulton County, Georgia,332,13,319,313,222,53,0,6
-1,131210114191010.000000000000000,Block 1010, Block Group 1, Census Tract 114.19, Fulton County, Georgia,332,36,296,292,268,8,2,4
-1,131210012042002.000000000000000,Block 2002, Block Group 2, Census Tract 12.04, Fulton County, Georgia,331,22,309,301,254,19,0,8
-1,131210016002006.000000000000000,Block 2006, Block Group 2, Census Tract 16, Fulton County, Georgia,331,26,305,286,240,21,0,19
-1,131210101351006.000000000000000,Block 1006, Block Group 1, Census Tract 101.35, Fulton County, Georgia,331,42,289,280,205,45,7,9
-1,131210105263013.000000000000000,Block 3013, Block Group 3, Census Tract 105.26, Fulton County, Georgia,331,38,293,288,2,281,0,5
-1,131210055012000.000000000000000,Block 2000, Block Group 2, Census Tract 55.01, Fulton County, Georgia,330,10,320,316,59,255,0,4
-1,131210101243001.000000000000000,Block 3001, Block Group 3, Census Tract 101.24, Fulton County, Georgia,330,67,263,252,108,117,3,11
-1,131210010012021.000000000000000,Block 2021, Block Group 2, Census Tract 10.01, Fulton County, Georgia,329,31,298,286,196,25,7,12
-1,131210082032007.000000000000000,Block 2007, Block Group 2, Census Tract 82.03, Fulton County, Georgia,329,2,327,324,14,309,0,3
-1,131210089051001.000000000000000,Block 1001, Block Group 1, Census Tract 89.05, Fulton County, Georgia,329,34,295,277,122,134,1,18
-1,131210101062002.000000000000000,Block 2002, Block Group 2, Census Tract 101.06, Fulton County, Georgia,329,17,312,305,265,24,0,7
-1,131210106032003.000000000000000,Block 2003, Block Group 2, Census Tract 106.03, Fulton County, Georgia,329,8,321,319,21,298,0,2
-1,131210012051006.000000000000000,Block 1006, Block Group 1, Census Tract 12.05, Fulton County, Georgia,328,21,307,298,175,59,0,9
-1,131210073013001.000000000000000,Block 3001, Block Group 3, Census Tract 73.01, Fulton County, Georgia,328,44,284,284,2,281,0,0
-1,131210094112001.000000000000000,Block 2001, Block Group 2, Census Tract 94.11, Fulton County, Georgia,328,20,308,298,230,44,4,10
-1,131210094081001.000000000000000,Block 1001, Block Group 1, Census Tract 94.08, Fulton County, Georgia,327,50,277,255,108,126,2,22
-1,131210103133021.000000000000000,Block 3021, Block Group 3, Census Tract 103.13, Fulton County, Georgia,327,0,327,327,0,320,1,0
-1,131210115082017.000000000000000,Block 2017, Block Group 2, Census Tract 115.08, Fulton County, Georgia,327,13,314,309,281,4,1,5
-1,131210038002006.000000000000000,Block 2006, Block Group 2, Census Tract 38, Fulton County, Georgia,326,0,326,326,2,324,0,0
-1,131210083013000.000000000000000,Block 3000, Block Group 3, Census Tract 83.01, Fulton County, Georgia,326,6,320,315,17,296,0,5
-1,131210101251005.000000000000000,Block 1005, Block Group 1, Census Tract 101.25, Fulton County, Georgia,326,91,235,219,30,181,7,16
-1,131210114241003.000000000000000,Block 1003, Block Group 1, Census Tract 114.24, Fulton County, Georgia,326,37,289,272,232,27,0,17
-1,131210101081003.000000000000000,Block 1003, Block Group 1, Census Tract 101.08, Fulton County, Georgia,325,15,310,296,260,14,0,14
-1,131210115082024.000000000000000,Block 2024, Block Group 2, Census Tract 115.08, Fulton County, Georgia,325,14,311,302,261,12,2,9
-1,131210029001001.000000000000000,Block 1001, Block Group 1, Census Tract 29, Fulton County, Georgia,324,10,314,304,162,116,0,10
-1,131210083013002.000000000000000,Block 3002, Block Group 3, Census Tract 83.01, Fulton County, Georgia,324,9,315,309,0,309,0,6
-1,131210101251000.000000000000000,Block 1000, Block Group 1, Census Tract 101.25, Fulton County, Georgia,323,76,247,235,92,119,3,12
-1,131210005013004.000000000000000,Block 3004, Block Group 3, Census Tract 5.01, Fulton County, Georgia,322,22,300,290,151,73,4,10
-1,131210115071012.000000000000000,Block 1012, Block Group 1, Census Tract 115.07, Fulton County, Georgia,322,11,311,296,288,8,0,15
-1,131210116392000.000000000000000,Block 2000, Block Group 2, Census Tract 116.39, Fulton County, Georgia,322,10,312,311,193,34,0,1
-1,131210006012013.000000000000000,Block 2013, Block Group 2, Census Tract 6.01, Fulton County, Georgia,321,64,257,235,132,96,0,22
-1,131210052004014.000000000000000,Block 4014, Block Group 4, Census Tract 52, Fulton County, Georgia,321,14,307,301,231,49,0,6
-1,131210078061009.000000000000000,Block 1009, Block Group 1, Census Tract 78.06, Fulton County, Georgia,321,30,291,287,0,287,0,4
-1,131210101152004.000000000000000,Block 2004, Block Group 2, Census Tract 101.15, Fulton County, Georgia,321,14,307,297,198,58,0,10
-1,131210102042011.000000000000000,Block 2011, Block Group 2, Census Tract 102.04, Fulton County, Georgia,321,19,302,294,278,12,0,8
-1,131210103093007.000000000000000,Block 3007, Block Group 3, Census Tract 103.09, Fulton County, Georgia,321,11,310,307,26,277,2,3
-1,131210105261033.000000000000000,Block 1033, Block Group 1, Census Tract 105.26, Fulton County, Georgia,321,1,320,316,14,299,3,4
-1,131210105362014.000000000000000,Block 2014, Block Group 2, Census Tract 105.36, Fulton County, Georgia,321,20,301,285,13,269,1,16
-1,131210114221001.000000000000000,Block 1001, Block Group 1, Census Tract 114.22, Fulton County, Georgia,321,19,302,292,264,22,0,10
-1,131210116401006.000000000000000,Block 1006, Block Group 1, Census Tract 116.40, Fulton County, Georgia,321,41,280,266,182,42,3,14
-1,131210102222005.000000000000000,Block 2005, Block Group 2, Census Tract 102.22, Fulton County, Georgia,320,8,312,298,246,25,0,14
-1,131210105231020.000000000000000,Block 1020, Block Group 1, Census Tract 105.23, Fulton County, Georgia,320,9,311,302,24,275,2,9
-1,131210119012000.000000000000000,Block 2000, Block Group 2, Census Tract 119.01, Fulton County, Georgia,320,3,317,311,22,277,3,6
-1,131210012061000.000000000000000,Block 1000, Block Group 1, Census Tract 12.06, Fulton County, Georgia,319,24,295,281,229,33,2,14
-1,131210017022002.000000000000000,Block 2002, Block Group 2, Census Tract 17.02, Fulton County, Georgia,318,26,292,282,224,34,1,10
-1,131210102182004.000000000000000,Block 2004, Block Group 2, Census Tract 102.18, Fulton County, Georgia,318,23,295,271,222,40,0,24
-1,131210078071004.000000000000000,Block 1004, Block Group 1, Census Tract 78.07, Fulton County, Georgia,317,3,314,310,7,303,0,4
-1,131210103131004.000000000000000,Block 1004, Block Group 1, Census Tract 103.13, Fulton County, Georgia,317,13,304,295,4,289,2,9
-1,131210104021012.000000000000000,Block 1012, Block Group 1, Census Tract 104.02, Fulton County, Georgia,317,2,315,311,298,13,0,4
-1,131210116332002.000000000000000,Block 2002, Block Group 2, Census Tract 116.33, Fulton County, Georgia,317,21,296,291,249,12,2,5
-1,131210116501004.000000000000000,Block 1004, Block Group 1, Census Tract 116.50, Fulton County, Georgia,317,18,299,285,204,4,0,14
-1,131210090012000.000000000000000,Block 2000, Block Group 2, Census Tract 90.01, Fulton County, Georgia,316,17,299,288,132,134,0,11
-1,131210105291008.000000000000000,Block 1008, Block Group 1, Census Tract 105.29, Fulton County, Georgia,316,2,314,308,8,300,0,6
-1,131210115151002.000000000000000,Block 1002, Block Group 1, Census Tract 115.15, Fulton County, Georgia,315,4,311,307,254,35,1,4
-1,131210114371017.000000000000000,Block 1017, Block Group 1, Census Tract 114.37, Fulton County, Georgia,314,27,287,280,76,166,0,7
-1,131210115151000.000000000000000,Block 1000, Block Group 1, Census Tract 115.15, Fulton County, Georgia,314,6,308,304,252,11,0,4
-1,131210012031003.000000000000000,Block 1003, Block Group 1, Census Tract 12.03, Fulton County, Georgia,313,32,281,277,167,57,0,4
-1,131210114282003.000000000000000,Block 2003, Block Group 2, Census Tract 114.28, Fulton County, Georgia,313,12,301,296,266,20,0,5
-1,131210116602010.000000000000000,Block 2010, Block Group 2, Census Tract 116.60, Fulton County, Georgia,313,10,303,282,182,43,0,21
-1,131210010011003.000000000000000,Block 1003, Block Group 1, Census Tract 10.01, Fulton County, Georgia,312,36,276,266,140,106,0,10
-1,131210013021000.000000000000000,Block 1000, Block Group 1, Census Tract 13.02, Fulton County, Georgia,312,13,299,280,222,27,7,19
-1,131210052003000.000000000000000,Block 3000, Block Group 3, Census Tract 52, Fulton County, Georgia,312,9,303,293,117,161,0,10
-1,131210073011000.000000000000000,Block 1000, Block Group 1, Census Tract 73.01, Fulton County, Georgia,312,1,311,306,17,284,2,5
-1,131210087021009.000000000000000,Block 1009, Block Group 1, Census Tract 87.02, Fulton County, Georgia,312,8,304,299,18,278,0,5
-1,131210023003003.000000000000000,Block 3003, Block Group 3, Census Tract 23, Fulton County, Georgia,311,1,310,307,1,305,0,3
-1,131210088021024.000000000000000,Block 1024, Block Group 1, Census Tract 88.02, Fulton County, Georgia,311,13,298,283,237,44,0,15
-1,131210105173000.000000000000000,Block 3000, Block Group 3, Census Tract 105.17, Fulton County, Georgia,311,16,295,294,2,286,6,1
-1,131210006023002.000000000000000,Block 3002, Block Group 3, Census Tract 6.02, Fulton County, Georgia,310,27,283,280,109,106,3,3
-1,131210094051002.000000000000000,Block 1002, Block Group 1, Census Tract 94.05, Fulton County, Georgia,310,29,281,267,98,103,0,14
-1,131210106013003.000000000000000,Block 3003, Block Group 3, Census Tract 106.01, Fulton County, Georgia,310,1,309,305,60,240,0,4
-1,131210114341013.000000000000000,Block 1013, Block Group 1, Census Tract 114.34, Fulton County, Georgia,310,74,236,224,169,34,1,12
-1,131210113105005.000000000000000,Block 5005, Block Group 5, Census Tract 113.10, Fulton County, Georgia,309,53,256,252,7,244,0,4
-1,131210115112002.000000000000000,Block 2002, Block Group 2, Census Tract 115.11, Fulton County, Georgia,309,9,300,294,242,28,0,6
-1,131210030003000.000000000000000,Block 3000, Block Group 3, Census Tract 30, Fulton County, Georgia,308,17,291,280,240,21,2,11
-1,131210105293015.000000000000000,Block 3015, Block Group 3, Census Tract 105.29, Fulton County, Georgia,308,19,289,287,11,273,3,2
-1,131210106041007.000000000000000,Block 1007, Block Group 1, Census Tract 106.04, Fulton County, Georgia,308,18,290,286,2,284,0,4
-1,131210115082001.000000000000000,Block 2001, Block Group 2, Census Tract 115.08, Fulton County, Georgia,308,21,287,279,157,24,3,8
-1,131210116501001.000000000000000,Block 1001, Block Group 1, Census Tract 116.50, Fulton County, Georgia,308,6,302,294,209,29,0,8
-1,131210116511004.000000000000000,Block 1004, Block Group 1, Census Tract 116.51, Fulton County, Georgia,308,15,293,273,193,29,1,20
-1,131210082031000.000000000000000,Block 1000, Block Group 1, Census Tract 82.03, Fulton County, Georgia,307,1,306,304,0,304,0,2
-1,131210078061011.000000000000000,Block 1011, Block Group 1, Census Tract 78.06, Fulton County, Georgia,306,14,292,284,0,284,0,8
-1,131210089061001.000000000000000,Block 1001, Block Group 1, Census Tract 89.06, Fulton County, Georgia,306,15,291,283,245,22,2,8
-1,131210104011039.000000000000000,Block 1039, Block Group 1, Census Tract 104.01, Fulton County, Georgia,306,37,269,266,28,238,0,3
-1,131210116381003.000000000000000,Block 1003, Block Group 1, Census Tract 116.38, Fulton County, Georgia,306,6,300,277,225,21,5,23
-1,131210103111013.000000000000000,Block 1013, Block Group 1, Census Tract 103.11, Fulton County, Georgia,305,1,304,298,0,294,0,6
-1,131210105211013.000000000000000,Block 1013, Block Group 1, Census Tract 105.21, Fulton County, Georgia,305,6,299,299,1,298,0,0
-1,131210116611003.000000000000000,Block 1003, Block Group 1, Census Tract 116.61, Fulton County, Georgia,305,22,283,271,226,7,5,12
-1,131210101251002.000000000000000,Block 1002, Block Group 1, Census Tract 101.25, Fulton County, Georgia,304,64,240,219,79,130,2,21
-1,131210105401016.000000000000000,Block 1016, Block Group 1, Census Tract 105.40, Fulton County, Georgia,304,23,281,281,8,264,0,0
-1,131210116533004.000000000000000,Block 3004, Block Group 3, Census Tract 116.53, Fulton County, Georgia,304,22,282,278,219,11,3,4
-1,131210043001006.000000000000000,Block 1006, Block Group 1, Census Tract 43, Fulton County, Georgia,303,2,301,301,0,299,0,0
-1,131210105272006.000000000000000,Block 2006, Block Group 2, Census Tract 105.27, Fulton County, Georgia,303,7,296,293,1,291,1,3
-1,131210105301007.000000000000000,Block 1007, Block Group 1, Census Tract 105.30, Fulton County, Georgia,303,18,285,280,8,270,0,5
-1,131210114383007.000000000000000,Block 3007, Block Group 3, Census Tract 114.38, Fulton County, Georgia,303,116,187,172,83,67,6,15
-1,131210114442002.000000000000000,Block 2002, Block Group 2, Census Tract 114.44, Fulton County, Georgia,303,19,284,278,246,6,0,6
-1,131210082032004.000000000000000,Block 2004, Block Group 2, Census Tract 82.03, Fulton County, Georgia,302,11,291,288,5,280,0,3
-1,131210066021001.000000000000000,Block 1001, Block Group 1, Census Tract 66.02, Fulton County, Georgia,301,5,296,296,0,296,0,0
-1,131210077091012.000000000000000,Block 1012, Block Group 1, Census Tract 77.09, Fulton County, Georgia,301,3,298,294,23,259,0,4
-1,131210010022014.000000000000000,Block 2014, Block Group 2, Census Tract 10.02, Fulton County, Georgia,300,18,282,269,231,11,0,13
-1,131210116341001.000000000000000,Block 1001, Block Group 1, Census Tract 116.34, Fulton County, Georgia,300,96,204,190,150,15,2,14
-1,131210105312009.000000000000000,Block 2009, Block Group 2, Census Tract 105.31, Fulton County, Georgia,299,17,282,280,3,275,1,2
-1,131210038002012.000000000000000,Block 2012, Block Group 2, Census Tract 38, Fulton County, Georgia,298,4,294,293,4,289,0,1
-1,131210096011000.000000000000000,Block 1000, Block Group 1, Census Tract 96.01, Fulton County, Georgia,298,22,276,261,212,38,0,15
-1,131210112025006.000000000000000,Block 5006, Block Group 5, Census Tract 112.02, Fulton County, Georgia,298,35,263,251,22,226,0,12
-1,131210115111002.000000000000000,Block 1002, Block Group 1, Census Tract 115.11, Fulton County, Georgia,298,7,291,287,242,32,0,4
-1,131210005013013.000000000000000,Block 3013, Block Group 3, Census Tract 5.01, Fulton County, Georgia,297,25,272,259,148,40,0,13
-1,131210101291003.000000000000000,Block 1003, Block Group 1, Census Tract 101.29, Fulton County, Georgia,297,35,262,255,165,70,3,7
-1,131210110003006.000000000000000,Block 3006, Block Group 3, Census Tract 110, Fulton County, Georgia,297,24,273,268,9,257,0,5
-1,131210114292005.000000000000000,Block 2005, Block Group 2, Census Tract 114.29, Fulton County, Georgia,297,80,217,202,142,54,0,15
-1,131210120003004.000000000000000,Block 3004, Block Group 3, Census Tract 120, Fulton County, Georgia,297,10,287,276,28,244,0,11
-1,131210025002003.000000000000000,Block 2003, Block Group 2, Census Tract 25, Fulton County, Georgia,296,1,295,294,19,275,0,1
-1,131210078072000.000000000000000,Block 2000, Block Group 2, Census Tract 78.07, Fulton County, Georgia,296,7,289,284,10,273,1,5
-1,131210100051005.000000000000000,Block 1005, Block Group 1, Census Tract 100.05, Fulton County, Georgia,296,2,294,292,288,3,0,2
-1,131210102231009.000000000000000,Block 1009, Block Group 1, Census Tract 102.23, Fulton County, Georgia,296,11,285,283,254,7,0,2
-1,131210110003023.000000000000000,Block 3023, Block Group 3, Census Tract 110, Fulton County, Georgia,296,17,279,276,11,265,0,3
-1,131210112025004.000000000000000,Block 5004, Block Group 5, Census Tract 112.02, Fulton County, Georgia,296,54,242,242,11,231,0,0
-1,131210116471009.000000000000000,Block 1009, Block Group 1, Census Tract 116.47, Fulton County, Georgia,296,8,288,286,112,44,1,2
-1,131210043002000.000000000000000,Block 2000, Block Group 2, Census Tract 43, Fulton County, Georgia,295,10,285,280,17,262,0,5
-1,131210114371000.000000000000000,Block 1000, Block Group 1, Census Tract 114.37, Fulton County, Georgia,295,52,243,239,203,35,0,4
-1,131210116442000.000000000000000,Block 2000, Block Group 2, Census Tract 116.44, Fulton County, Georgia,295,39,256,240,111,58,4,16
-1,131210101342000.000000000000000,Block 2000, Block Group 2, Census Tract 101.34, Fulton County, Georgia,294,37,257,244,89,107,0,13
-1,131210103053000.000000000000000,Block 3000, Block Group 3, Census Tract 103.05, Fulton County, Georgia,294,2,292,285,6,279,0,7
-1,131210103061006.000000000000000,Block 1006, Block Group 1, Census Tract 103.06, Fulton County, Georgia,294,7,287,286,7,278,1,1
-1,131210114383006.000000000000000,Block 3006, Block Group 3, Census Tract 114.38, Fulton County, Georgia,294,108,186,164,67,91,3,22
-1,131210011021001.000000000000000,Block 1001, Block Group 1, Census Tract 11.02, Fulton County, Georgia,293,22,271,259,216,20,0,12
-1,131210105201007.000000000000000,Block 1007, Block Group 1, Census Tract 105.20, Fulton County, Georgia,293,7,286,285,9,276,0,1
-1,131210102201007.000000000000000,Block 1007, Block Group 1, Census Tract 102.20, Fulton County, Georgia,292,3,289,272,265,0,0,17
-1,131210067022004.000000000000000,Block 2004, Block Group 2, Census Tract 67.02, Fulton County, Georgia,291,2,289,288,7,276,5,1
-1,131210096051000.000000000000000,Block 1000, Block Group 1, Census Tract 96.05, Fulton County, Georgia,291,29,262,254,178,36,0,8
-1,131210105321000.000000000000000,Block 1000, Block Group 1, Census Tract 105.32, Fulton County, Georgia,291,2,289,289,6,281,0,0
-1,131210096073007.000000000000000,Block 3007, Block Group 3, Census Tract 96.07, Fulton County, Georgia,290,22,268,266,173,48,0,2
-1,131210116281004.000000000000000,Block 1004, Block Group 1, Census Tract 116.28, Fulton County, Georgia,290,13,277,272,161,47,5,5
-1,131210078102000.000000000000000,Block 2000, Block Group 2, Census Tract 78.10, Fulton County, Georgia,289,4,285,284,2,282,0,1
-1,131210087021015.000000000000000,Block 1015, Block Group 1, Census Tract 87.02, Fulton County, Georgia,289,0,289,289,17,271,0,0
-1,131210101061000.000000000000000,Block 1000, Block Group 1, Census Tract 101.06, Fulton County, Georgia,289,27,262,246,98,142,2,16
-1,131210101271001.000000000000000,Block 1001, Block Group 1, Census Tract 101.27, Fulton County, Georgia,289,24,265,261,133,41,0,4
-1,131210114321000.000000000000000,Block 1000, Block Group 1, Census Tract 114.32, Fulton County, Georgia,289,56,233,220,152,42,5,13
-1,131210050002020.000000000000000,Block 2020, Block Group 2, Census Tract 50, Fulton County, Georgia,288,15,273,264,158,103,0,9
-1,131210078061004.000000000000000,Block 1004, Block Group 1, Census Tract 78.06, Fulton County, Georgia,287,15,272,272,0,272,0,0
-1,131210078082001.000000000000000,Block 2001, Block Group 2, Census Tract 78.08, Fulton County, Georgia,287,21,266,261,0,258,0,5
-1,131210089051009.000000000000000,Block 1009, Block Group 1, Census Tract 89.05, Fulton County, Georgia,287,28,259,256,132,79,0,3
-1,131210089082006.000000000000000,Block 2006, Block Group 2, Census Tract 89.08, Fulton County, Georgia,286,23,263,247,83,145,3,16
-1,131210103074002.000000000000000,Block 4002, Block Group 4, Census Tract 103.07, Fulton County, Georgia,286,0,286,282,0,282,0,4
-1,131210105401025.000000000000000,Block 1025, Block Group 1, Census Tract 105.40, Fulton County, Georgia,286,2,284,284,11,265,0,0
-1,131210090011010.000000000000000,Block 1010, Block Group 1, Census Tract 90.01, Fulton County, Georgia,285,25,260,248,181,51,0,12
-1,131210102043000.000000000000000,Block 3000, Block Group 3, Census Tract 102.04, Fulton County, Georgia,285,5,280,276,260,6,0,4
-1,131210105173002.000000000000000,Block 3002, Block Group 3, Census Tract 105.17, Fulton County, Georgia,285,15,270,262,4,258,0,8
-1,131210108012006.000000000000000,Block 2006, Block Group 2, Census Tract 108.01, Fulton County, Georgia,285,30,255,249,27,215,4,6
-1,131210112032000.000000000000000,Block 2000, Block Group 2, Census Tract 112.03, Fulton County, Georgia,285,22,263,263,61,199,3,0
-1,131210114282008.000000000000000,Block 2008, Block Group 2, Census Tract 114.28, Fulton County, Georgia,285,11,274,268,240,7,4,6
-1,131210081041013.000000000000000,Block 1013, Block Group 1, Census Tract 81.04, Fulton County, Georgia,284,4,280,275,4,270,0,5
-1,131210102191000.000000000000000,Block 1000, Block Group 1, Census Tract 102.19, Fulton County, Georgia,284,28,256,215,90,110,0,41
-1,131210114361007.000000000000000,Block 1007, Block Group 1, Census Tract 114.36, Fulton County, Georgia,284,32,252,240,227,8,0,12
-1,131210105342002.000000000000000,Block 2002, Block Group 2, Census Tract 105.34, Fulton County, Georgia,283,9,274,271,10,258,1,3
-1,131210105371000.000000000000000,Block 1000, Block Group 1, Census Tract 105.37, Fulton County, Georgia,283,16,267,257,0,257,0,10
-1,131210106031010.000000000000000,Block 1010, Block Group 1, Census Tract 106.03, Fulton County, Georgia,283,2,281,276,0,271,5,5
-1,131210116372026.000000000000000,Block 2026, Block Group 2, Census Tract 116.37, Fulton County, Georgia,283,21,262,244,123,67,1,18
-1,131210048001004.000000000000000,Block 1004, Block Group 1, Census Tract 48, Fulton County, Georgia,282,2,280,268,43,210,0,12
-1,131210114351003.000000000000000,Block 1003, Block Group 1, Census Tract 114.35, Fulton County, Georgia,282,128,154,144,63,78,1,10
-1,131210116282005.000000000000000,Block 2005, Block Group 2, Census Tract 116.28, Fulton County, Georgia,281,4,277,260,232,0,0,17
-1,131210116471012.000000000000000,Block 1012, Block Group 1, Census Tract 116.47, Fulton County, Georgia,281,19,262,262,150,52,0,0
-1,131210006011005.000000000000000,Block 1005, Block Group 1, Census Tract 6.01, Fulton County, Georgia,280,29,251,245,166,50,0,6
-1,131210096073000.000000000000000,Block 3000, Block Group 3, Census Tract 96.07, Fulton County, Georgia,280,14,266,257,231,11,7,9
-1,131210115053004.000000000000000,Block 3004, Block Group 3, Census Tract 115.05, Fulton County, Georgia,280,31,249,243,225,7,0,6
-1,131210116322001.000000000000000,Block 2001, Block Group 2, Census Tract 116.32, Fulton County, Georgia,280,13,267,255,110,37,0,12
-1,131210116533006.000000000000000,Block 3006, Block Group 3, Census Tract 116.53, Fulton County, Georgia,280,16,264,240,160,16,0,24
-1,131210014003002.000000000000000,Block 3002, Block Group 3, Census Tract 14, Fulton County, Georgia,279,25,254,248,217,16,2,6
-1,131210076031001.000000000000000,Block 1001, Block Group 1, Census Tract 76.03, Fulton County, Georgia,279,5,274,271,2,264,5,3
-1,131210077071004.000000000000000,Block 1004, Block Group 1, Census Tract 77.07, Fulton County, Georgia,279,8,271,270,0,270,0,1
-1,131210102162004.000000000000000,Block 2004, Block Group 2, Census Tract 102.16, Fulton County, Georgia,278,44,234,223,100,89,0,11
-1,131210106043000.000000000000000,Block 3000, Block Group 3, Census Tract 106.04, Fulton County, Georgia,278,2,276,271,0,262,1,5
-1,131210089062010.000000000000000,Block 2010, Block Group 2, Census Tract 89.06, Fulton County, Georgia,277,7,270,270,253,13,0,0
-1,131210095041008.000000000000000,Block 1008, Block Group 1, Census Tract 95.04, Fulton County, Georgia,277,19,258,254,205,31,0,4
-1,131210102202003.000000000000000,Block 2003, Block Group 2, Census Tract 102.20, Fulton County, Georgia,277,7,270,266,113,120,0,4
-1,131210114231007.000000000000000,Block 1007, Block Group 1, Census Tract 114.23, Fulton County, Georgia,277,18,259,245,235,4,0,14
-1,131210116423006.000000000000000,Block 3006, Block Group 3, Census Tract 116.42, Fulton County, Georgia,277,17,260,242,61,85,1,18
-1,131210116542002.000000000000000,Block 2002, Block Group 2, Census Tract 116.54, Fulton County, Georgia,277,13,264,253,190,19,2,11
-1,131210077051000.000000000000000,Block 1000, Block Group 1, Census Tract 77.05, Fulton County, Georgia,276,1,275,271,4,263,1,4
-1,131210086012015.000000000000000,Block 2015, Block Group 2, Census Tract 86.01, Fulton County, Georgia,276,10,266,255,16,237,1,11
-1,131210103112008.000000000000000,Block 2008, Block Group 2, Census Tract 103.11, Fulton County, Georgia,276,10,266,263,2,258,0,3
-1,131210116241001.000000000000000,Block 1001, Block Group 1, Census Tract 116.24, Fulton County, Georgia,276,21,255,245,185,6,2,10
-1,131210013012008.000000000000000,Block 2008, Block Group 2, Census Tract 13.01, Fulton County, Georgia,275,9,266,266,65,200,0,0
-1,131210101242000.000000000000000,Block 2000, Block Group 2, Census Tract 101.24, Fulton County, Georgia,275,41,234,229,55,163,6,5
-1,131210102171005.000000000000000,Block 1005, Block Group 1, Census Tract 102.17, Fulton County, Georgia,275,12,263,255,181,59,0,8
-1,131210105302010.000000000000000,Block 2010, Block Group 2, Census Tract 105.30, Fulton County, Georgia,275,6,269,264,10,249,4,5
-1,131210116353008.000000000000000,Block 3008, Block Group 3, Census Tract 116.35, Fulton County, Georgia,275,9,266,264,35,30,2,2
-1,131210058001048.000000000000000,Block 1048, Block Group 1, Census Tract 58, Fulton County, Georgia,274,8,266,260,45,205,0,6
-1,131210075003001.000000000000000,Block 3001, Block Group 3, Census Tract 75, Fulton County, Georgia,274,4,270,264,19,243,0,6
-1,131210081033009.000000000000000,Block 3009, Block Group 3, Census Tract 81.03, Fulton County, Georgia,274,8,266,262,0,262,0,4
-1,131210102231005.000000000000000,Block 1005, Block Group 1, Census Tract 102.23, Fulton County, Georgia,274,11,263,256,211,17,7,7
-1,131210101202002.000000000000000,Block 2002, Block Group 2, Census Tract 101.20, Fulton County, Georgia,273,26,247,230,141,64,4,17
-1,131210096044005.000000000000000,Block 4005, Block Group 4, Census Tract 96.04, Fulton County, Georgia,272,16,256,248,218,18,0,8
-1,131210101333005.000000000000000,Block 3005, Block Group 3, Census Tract 101.33, Fulton County, Georgia,272,17,255,250,135,52,1,5
-1,131210103101004.000000000000000,Block 1004, Block Group 1, Census Tract 103.10, Fulton County, Georgia,272,5,267,262,8,252,1,5
-1,131210105382010.000000000000000,Block 2010, Block Group 2, Census Tract 105.38, Fulton County, Georgia,272,5,267,267,17,248,0,0
-1,131210116411010.000000000000000,Block 1010, Block Group 1, Census Tract 116.41, Fulton County, Georgia,272,15,257,246,234,2,0,11
-1,131210076033018.000000000000000,Block 3018, Block Group 3, Census Tract 76.03, Fulton County, Georgia,271,15,256,255,3,246,3,1
-1,131210079001008.000000000000000,Block 1008, Block Group 1, Census Tract 79, Fulton County, Georgia,271,0,271,263,12,249,0,8
-1,131210030002005.000000000000000,Block 2005, Block Group 2, Census Tract 30, Fulton County, Georgia,270,13,257,257,222,13,1,0
-1,131210073014004.000000000000000,Block 4004, Block Group 4, Census Tract 73.01, Fulton County, Georgia,270,4,266,262,7,252,0,4
-1,131210101274002.000000000000000,Block 4002, Block Group 4, Census Tract 101.27, Fulton County, Georgia,270,5,265,255,164,33,0,10
-1,131210101372002.000000000000000,Block 2002, Block Group 2, Census Tract 101.37, Fulton County, Georgia,270,8,262,254,236,9,0,8
-1,131210108024021.000000000000000,Block 4021, Block Group 4, Census Tract 108.02, Fulton County, Georgia,270,103,167,163,32,126,0,4
-1,131210116431006.000000000000000,Block 1006, Block Group 1, Census Tract 116.43, Fulton County, Georgia,270,8,262,248,48,39,0,14
-1,131210077033002.000000000000000,Block 3002, Block Group 3, Census Tract 77.03, Fulton County, Georgia,269,3,266,256,4,247,4,10
-1,131210078091005.000000000000000,Block 1005, Block Group 1, Census Tract 78.09, Fulton County, Georgia,269,2,267,263,0,263,0,4
-1,131210105293005.000000000000000,Block 3005, Block Group 3, Census Tract 105.29, Fulton County, Georgia,269,0,269,269,1,268,0,0
-1,131210105371006.000000000000000,Block 1006, Block Group 1, Census Tract 105.37, Fulton County, Georgia,269,9,260,254,2,252,0,6
-1,131210105372003.000000000000000,Block 2003, Block Group 2, Census Tract 105.37, Fulton County, Georgia,269,8,261,250,2,243,2,11
-1,131210115101018.000000000000000,Block 1018, Block Group 1, Census Tract 115.10, Fulton County, Georgia,269,12,257,253,235,3,1,4
-1,131210116372010.000000000000000,Block 2010, Block Group 2, Census Tract 116.37, Fulton County, Georgia,269,16,253,250,164,32,4,3
-1,131210078053003.000000000000000,Block 3003, Block Group 3, Census Tract 78.05, Fulton County, Georgia,268,63,205,203,0,202,0,2
-1,131210096071002.000000000000000,Block 1002, Block Group 1, Census Tract 96.07, Fulton County, Georgia,268,8,260,253,162,36,2,7
-1,131210100051000.000000000000000,Block 1000, Block Group 1, Census Tract 100.05, Fulton County, Georgia,268,25,243,239,224,0,6,4
-1,131210114282010.000000000000000,Block 2010, Block Group 2, Census Tract 114.28, Fulton County, Georgia,268,11,257,253,176,40,0,4
-1,131210119022008.000000000000000,Block 2008, Block Group 2, Census Tract 119.02, Fulton County, Georgia,268,8,260,249,179,49,7,11
-1,131210035002019.000000000000000,Block 2019, Block Group 2, Census Tract 35, Fulton County, Georgia,266,23,243,237,124,99,3,6
-1,131210103142000.000000000000000,Block 2000, Block Group 2, Census Tract 103.14, Fulton County, Georgia,266,4,262,253,47,206,0,9
-1,131210115101029.000000000000000,Block 1029, Block Group 1, Census Tract 115.10, Fulton County, Georgia,266,11,255,239,70,2,0,16
-1,131210116301000.000000000000000,Block 1000, Block Group 1, Census Tract 116.30, Fulton County, Georgia,266,20,246,225,161,41,4,21
-1,131210102222007.000000000000000,Block 2007, Block Group 2, Census Tract 102.22, Fulton County, Georgia,264,10,254,245,215,7,3,9
-1,131210115151001.000000000000000,Block 1001, Block Group 1, Census Tract 115.15, Fulton County, Georgia,264,6,258,250,246,2,0,8
-1,131210116331003.000000000000000,Block 1003, Block Group 1, Census Tract 116.33, Fulton County, Georgia,264,20,244,231,125,30,0,13
-1,131210025002009.000000000000000,Block 2009, Block Group 2, Census Tract 25, Fulton County, Georgia,263,5,258,257,0,252,1,1
-1,131210089032003.000000000000000,Block 2003, Block Group 2, Census Tract 89.03, Fulton County, Georgia,263,31,232,220,66,138,0,12
-1,131210096061009.000000000000000,Block 1009, Block Group 1, Census Tract 96.06, Fulton County, Georgia,263,10,253,242,201,29,0,11
-1,131210116361004.000000000000000,Block 1004, Block Group 1, Census Tract 116.36, Fulton County, Georgia,263,31,232,223,200,2,1,9
-1,131210119012003.000000000000000,Block 2003, Block Group 2, Census Tract 119.01, Fulton County, Georgia,263,3,260,239,160,55,0,21
-1,131210105312012.000000000000000,Block 2012, Block Group 2, Census Tract 105.31, Fulton County, Georgia,262,1,261,250,6,244,0,11
-1,131210105341006.000000000000000,Block 1006, Block Group 1, Census Tract 105.34, Fulton County, Georgia,262,4,258,256,29,224,0,2
-1,131210116293003.000000000000000,Block 3003, Block Group 3, Census Tract 116.29, Fulton County, Georgia,261,9,252,250,135,11,0,2
-1,131210116412002.000000000000000,Block 2002, Block Group 2, Census Tract 116.41, Fulton County, Georgia,261,20,241,236,223,3,0,5
-1,131210070011002.000000000000000,Block 1002, Block Group 1, Census Tract 70.01, Fulton County, Georgia,260,17,243,238,17,217,4,5
-1,131210101293000.000000000000000,Block 3000, Block Group 3, Census Tract 101.29, Fulton County, Georgia,260,18,242,238,126,58,7,4
-1,131210102172002.000000000000000,Block 2002, Block Group 2, Census Tract 102.17, Fulton County, Georgia,260,6,254,244,217,9,0,10
-1,131210114171000.000000000000000,Block 1000, Block Group 1, Census Tract 114.17, Fulton County, Georgia,260,16,244,240,208,5,0,4
-1,131210050001002.000000000000000,Block 1002, Block Group 1, Census Tract 50, Fulton County, Georgia,259,10,249,242,172,53,0,7
-1,131210094112005.000000000000000,Block 2005, Block Group 2, Census Tract 94.11, Fulton County, Georgia,259,25,234,231,157,41,0,3
-1,131210115051006.000000000000000,Block 1006, Block Group 1, Census Tract 115.05, Fulton County, Georgia,259,26,233,224,202,8,2,9
-1,131210114441004.000000000000000,Block 1004, Block Group 1, Census Tract 114.44, Fulton County, Georgia,258,17,241,236,119,11,0,5
-1,131210115142005.000000000000000,Block 2005, Block Group 2, Census Tract 115.14, Fulton County, Georgia,258,6,252,239,206,21,1,13
-1,131210010011001.000000000000000,Block 1001, Block Group 1, Census Tract 10.01, Fulton County, Georgia,257,15,242,229,119,36,0,13
-1,131210028021011.000000000000000,Block 1011, Block Group 1, Census Tract 28.02, Fulton County, Georgia,257,1,256,248,45,157,0,8
-1,131210061003015.000000000000000,Block 3015, Block Group 3, Census Tract 61, Fulton County, Georgia,257,2,255,254,23,226,0,1
-1,131210114302004.000000000000000,Block 2004, Block Group 2, Census Tract 114.30, Fulton County, Georgia,257,140,117,109,41,61,6,8
-1,131210116291000.000000000000000,Block 1000, Block Group 1, Census Tract 116.29, Fulton County, Georgia,257,11,246,235,170,14,2,11
-1,131210116561006.000000000000000,Block 1006, Block Group 1, Census Tract 116.56, Fulton County, Georgia,257,1,256,240,95,79,0,16
-1,131210092031007.000000000000000,Block 1007, Block Group 1, Census Tract 92.03, Fulton County, Georgia,256,21,235,222,42,180,0,13
-1,131210105372005.000000000000000,Block 2005, Block Group 2, Census Tract 105.37, Fulton County, Georgia,256,19,237,234,2,227,5,3
-1,131210017021003.000000000000000,Block 1003, Block Group 1, Census Tract 17.02, Fulton County, Georgia,255,7,248,234,190,17,0,14
-1,131210113102001.000000000000000,Block 2001, Block Group 2, Census Tract 113.10, Fulton County, Georgia,255,39,216,216,30,186,0,0
-1,131210014003000.000000000000000,Block 3000, Block Group 3, Census Tract 14, Fulton County, Georgia,254,10,244,238,211,8,7,6
-1,131210015011001.000000000000000,Block 1001, Block Group 1, Census Tract 15.01, Fulton County, Georgia,254,13,241,230,193,15,3,11
-1,131210052002002.000000000000000,Block 2002, Block Group 2, Census Tract 52, Fulton County, Georgia,254,15,239,230,203,22,0,9
-1,131210078093004.000000000000000,Block 3004, Block Group 3, Census Tract 78.09, Fulton County, Georgia,254,3,251,246,1,244,1,5
-1,131210093021001.000000000000000,Block 1001, Block Group 1, Census Tract 93.02, Fulton County, Georgia,254,10,244,238,209,13,3,6
-1,131210116481003.000000000000000,Block 1003, Block Group 1, Census Tract 116.48, Fulton County, Georgia,254,18,236,228,87,12,0,8
-1,131210116581009.000000000000000,Block 1009, Block Group 1, Census Tract 116.58, Fulton County, Georgia,254,12,242,238,103,59,3,4
-1,131210101333002.000000000000000,Block 3002, Block Group 3, Census Tract 101.33, Fulton County, Georgia,253,23,230,219,118,46,7,11
-1,131210102222000.000000000000000,Block 2000, Block Group 2, Census Tract 102.22, Fulton County, Georgia,253,6,247,246,219,10,1,1
-1,131210115122001.000000000000000,Block 2001, Block Group 2, Census Tract 115.12, Fulton County, Georgia,253,6,247,236,232,1,1,11
-1,131210102203005.000000000000000,Block 3005, Block Group 3, Census Tract 102.20, Fulton County, Georgia,252,16,236,229,215,6,1,7
-1,131210105331004.000000000000000,Block 1004, Block Group 1, Census Tract 105.33, Fulton County, Georgia,252,6,246,245,1,238,2,1
-1,131210112042000.000000000000000,Block 2000, Block Group 2, Census Tract 112.04, Fulton County, Georgia,252,1,251,245,10,233,0,6
-1,131210053001000.000000000000000,Block 1000, Block Group 1, Census Tract 53, Fulton County, Georgia,251,4,247,244,44,196,0,3
-1,131210074001004.000000000000000,Block 1004, Block Group 1, Census Tract 74, Fulton County, Georgia,251,2,249,247,1,246,0,2
-1,131210096052001.000000000000000,Block 2001, Block Group 2, Census Tract 96.05, Fulton County, Georgia,251,10,241,238,139,98,0,3
-1,131210096071001.000000000000000,Block 1001, Block Group 1, Census Tract 96.07, Fulton County, Georgia,251,69,182,177,101,57,0,5
-1,131210114172012.000000000000000,Block 2012, Block Group 2, Census Tract 114.17, Fulton County, Georgia,251,4,247,242,236,6,0,5
-1,131210116293006.000000000000000,Block 3006, Block Group 3, Census Tract 116.29, Fulton County, Georgia,251,11,240,234,123,27,4,6
-1,131210042003006.000000000000000,Block 3006, Block Group 3, Census Tract 42, Fulton County, Georgia,250,4,246,244,13,231,0,2
-1,131210103081014.000000000000000,Block 1014, Block Group 1, Census Tract 103.08, Fulton County, Georgia,250,0,250,243,31,212,0,7
-1,131210114461004.000000000000000,Block 1004, Block Group 1, Census Tract 114.46, Fulton County, Georgia,250,12,238,231,207,21,0,7
-1,131210028011000.000000000000000,Block 1000, Block Group 1, Census Tract 28.01, Fulton County, Georgia,249,16,233,228,96,112,2,5
-1,131210055012004.000000000000000,Block 2004, Block Group 2, Census Tract 55.01, Fulton County, Georgia,249,2,247,245,22,222,1,2
-1,131210078082000.000000000000000,Block 2000, Block Group 2, Census Tract 78.08, Fulton County, Georgia,249,6,243,242,4,238,0,1
-1,131210082023001.000000000000000,Block 3001, Block Group 3, Census Tract 82.02, Fulton County, Georgia,249,4,245,245,0,245,0,0
-1,131210088021012.000000000000000,Block 1012, Block Group 1, Census Tract 88.02, Fulton County, Georgia,249,16,233,228,187,29,0,5
-1,131210089062016.000000000000000,Block 2016, Block Group 2, Census Tract 89.06, Fulton County, Georgia,249,20,229,227,150,51,0,2
-1,131210116511000.000000000000000,Block 1000, Block Group 1, Census Tract 116.51, Fulton County, Georgia,249,23,226,211,168,16,0,15
-1,131210116522003.000000000000000,Block 2003, Block Group 2, Census Tract 116.52, Fulton County, Georgia,249,22,227,220,116,27,5,7
-1,131210105223014.000000000000000,Block 3014, Block Group 3, Census Tract 105.22, Fulton County, Georgia,248,6,242,241,1,234,1,1
-1,131210115081002.000000000000000,Block 1002, Block Group 1, Census Tract 115.08, Fulton County, Georgia,248,23,225,217,172,19,2,8
-1,131210012032008.000000000000000,Block 2008, Block Group 2, Census Tract 12.03, Fulton County, Georgia,247,18,229,216,130,48,0,13
-1,131210077091007.000000000000000,Block 1007, Block Group 1, Census Tract 77.09, Fulton County, Georgia,247,1,246,234,2,226,5,12
-1,131210105231026.000000000000000,Block 1026, Block Group 1, Census Tract 105.23, Fulton County, Georgia,247,8,239,239,0,236,3,0
-1,131210105343008.000000000000000,Block 3008, Block Group 3, Census Tract 105.34, Fulton County, Georgia,247,23,224,223,12,198,0,1
-1,131210078101002.000000000000000,Block 1002, Block Group 1, Census Tract 78.10, Fulton County, Georgia,246,0,246,245,4,241,0,1
-1,131210102041000.000000000000000,Block 1000, Block Group 1, Census Tract 102.04, Fulton County, Georgia,246,12,234,228,201,12,0,6
-1,131210103082000.000000000000000,Block 2000, Block Group 2, Census Tract 103.08, Fulton County, Georgia,246,5,241,237,11,223,3,4
-1,131210106011006.000000000000000,Block 1006, Block Group 1, Census Tract 106.01, Fulton County, Georgia,246,2,244,240,72,165,0,4
-1,131210114461001.000000000000000,Block 1001, Block Group 1, Census Tract 114.46, Fulton County, Georgia,246,13,233,229,219,9,0,4
-1,131210082031005.000000000000000,Block 1005, Block Group 1, Census Tract 82.03, Fulton County, Georgia,245,1,244,243,9,231,1,1
-1,131210101372001.000000000000000,Block 2001, Block Group 2, Census Tract 101.37, Fulton County, Georgia,245,24,221,214,214,0,0,7
-1,131210113062001.000000000000000,Block 2001, Block Group 2, Census Tract 113.06, Fulton County, Georgia,245,3,242,228,2,220,2,14
-1,131210114311000.000000000000000,Block 1000, Block Group 1, Census Tract 114.31, Fulton County, Georgia,245,162,83,72,46,20,4,11
-1,131210115082021.000000000000000,Block 2021, Block Group 2, Census Tract 115.08, Fulton County, Georgia,245,13,232,226,177,19,2,6
-1,131210115082022.000000000000000,Block 2022, Block Group 2, Census Tract 115.08, Fulton County, Georgia,245,6,239,220,204,2,2,19
-1,131210114371001.000000000000000,Block 1001, Block Group 1, Census Tract 114.37, Fulton County, Georgia,244,36,208,204,121,79,0,4
-1,131210114372014.000000000000000,Block 2014, Block Group 2, Census Tract 114.37, Fulton County, Georgia,244,44,200,196,152,24,0,4
-1,131210116571003.000000000000000,Block 1003, Block Group 1, Census Tract 116.57, Fulton County, Georgia,244,20,224,215,158,23,0,9
-1,131210089053010.000000000000000,Block 3010, Block Group 3, Census Tract 89.05, Fulton County, Georgia,243,26,217,195,85,87,0,22
-1,131210105323014.000000000000000,Block 3014, Block Group 3, Census Tract 105.32, Fulton County, Georgia,243,2,241,240,0,238,1,1
-1,131210028022006.000000000000000,Block 2006, Block Group 2, Census Tract 28.02, Fulton County, Georgia,242,3,239,237,8,226,2,2
-1,131210048002000.000000000000000,Block 2000, Block Group 2, Census Tract 48, Fulton County, Georgia,242,9,233,230,6,223,0,3
-1,131210112031003.000000000000000,Block 1003, Block Group 1, Census Tract 112.03, Fulton County, Georgia,242,20,222,222,0,222,0,0
-1,131210114163004.000000000000000,Block 3004, Block Group 3, Census Tract 114.16, Fulton County, Georgia,242,3,239,237,144,12,8,2
-1,131210114323003.000000000000000,Block 3003, Block Group 3, Census Tract 114.32, Fulton County, Georgia,242,17,225,217,181,22,0,8
-1,131210114352010.000000000000000,Block 2010, Block Group 2, Census Tract 114.35, Fulton County, Georgia,242,12,230,226,200,12,0,4
-1,131210115102000.000000000000000,Block 2000, Block Group 2, Census Tract 115.10, Fulton County, Georgia,242,7,235,230,214,1,1,5
-1,131210116562004.000000000000000,Block 2004, Block Group 2, Census Tract 116.56, Fulton County, Georgia,242,13,229,215,192,9,1,14
-1,131210100052005.000000000000000,Block 2005, Block Group 2, Census Tract 100.05, Fulton County, Georgia,241,13,228,225,215,3,2,3
-1,131210105273001.000000000000000,Block 3001, Block Group 3, Census Tract 105.27, Fulton County, Georgia,241,28,213,208,35,173,0,5
-1,131210116473021.000000000000000,Block 3021, Block Group 3, Census Tract 116.47, Fulton County, Georgia,241,21,220,212,131,46,0,8
-1,131210116601008.000000000000000,Block 1008, Block Group 1, Census Tract 116.60, Fulton County, Georgia,241,10,231,225,163,29,0,6
-1,131210120003029.000000000000000,Block 3029, Block Group 3, Census Tract 120, Fulton County, Georgia,241,1,240,238,0,238,0,2
-1,131210078053000.000000000000000,Block 3000, Block Group 3, Census Tract 78.05, Fulton County, Georgia,240,54,186,166,7,156,1,20
-1,131210103111015.000000000000000,Block 1015, Block Group 1, Census Tract 103.11, Fulton County, Georgia,240,12,228,215,0,215,0,13
-1,131210112023000.000000000000000,Block 3000, Block Group 3, Census Tract 112.02, Fulton County, Georgia,240,14,226,216,9,207,0,10
-1,131210114173007.000000000000000,Block 3007, Block Group 3, Census Tract 114.17, Fulton County, Georgia,240,15,225,219,161,41,0,6
-1,131210114232006.000000000000000,Block 2006, Block Group 2, Census Tract 114.23, Fulton County, Georgia,240,1,239,223,208,8,4,16
-1,131210114362002.000000000000000,Block 2002, Block Group 2, Census Tract 114.36, Fulton County, Georgia,240,15,225,217,180,18,0,8
-1,131210115131007.000000000000000,Block 1007, Block Group 1, Census Tract 115.13, Fulton County, Georgia,240,8,232,229,214,10,0,3
-1,131210115142013.000000000000000,Block 2013, Block Group 2, Census Tract 115.14, Fulton County, Georgia,240,16,224,210,177,10,2,14
-1,131210116471007.000000000000000,Block 1007, Block Group 1, Census Tract 116.47, Fulton County, Georgia,240,20,220,210,146,23,2,10
-1,131210074001001.000000000000000,Block 1001, Block Group 1, Census Tract 74, Fulton County, Georgia,239,2,237,232,15,215,0,5
-1,131210101201000.000000000000000,Block 1000, Block Group 1, Census Tract 101.20, Fulton County, Georgia,239,20,219,214,89,120,4,5
-1,131210108021004.000000000000000,Block 1004, Block Group 1, Census Tract 108.02, Fulton County, Georgia,239,116,123,123,10,108,0,0
-1,131210116352004.000000000000000,Block 2004, Block Group 2, Census Tract 116.35, Fulton County, Georgia,239,13,226,222,56,15,0,4
-1,131210078064011.000000000000000,Block 4011, Block Group 4, Census Tract 78.06, Fulton County, Georgia,238,4,234,229,0,229,0,5
-1,131210089053003.000000000000000,Block 3003, Block Group 3, Census Tract 89.05, Fulton County, Georgia,238,41,197,193,110,68,1,4
-1,131210102152001.000000000000000,Block 2001, Block Group 2, Census Tract 102.15, Fulton County, Georgia,238,13,225,209,197,9,1,16
-1,131210103061002.000000000000000,Block 1002, Block Group 1, Census Tract 103.06, Fulton County, Georgia,238,1,237,228,0,227,1,9
-1,131210105253003.000000000000000,Block 3003, Block Group 3, Census Tract 105.25, Fulton County, Georgia,238,6,232,227,3,222,0,5
-1,131210087011000.000000000000000,Block 1000, Block Group 1, Census Tract 87.01, Fulton County, Georgia,237,10,227,218,9,208,0,9
-1,131210099002012.000000000000000,Block 2012, Block Group 2, Census Tract 99, Fulton County, Georgia,237,5,232,232,230,0,0,0
-1,131210105181009.000000000000000,Block 1009, Block Group 1, Census Tract 105.18, Fulton County, Georgia,237,4,233,230,5,223,0,3
-1,131210114321004.000000000000000,Block 1004, Block Group 1, Census Tract 114.32, Fulton County, Georgia,237,91,146,134,54,66,3,12
-1,131210115071011.000000000000000,Block 1011, Block Group 1, Census Tract 115.07, Fulton County, Georgia,237,7,230,217,198,12,0,13
-1,131210010022009.000000000000000,Block 2009, Block Group 2, Census Tract 10.02, Fulton County, Georgia,236,6,230,215,173,8,0,15
-1,131210094101007.000000000000000,Block 1007, Block Group 1, Census Tract 94.10, Fulton County, Georgia,236,15,221,208,138,37,1,13
-1,131210102044002.000000000000000,Block 4002, Block Group 4, Census Tract 102.04, Fulton County, Georgia,236,5,231,226,212,9,0,5
-1,131210012031000.000000000000000,Block 1000, Block Group 1, Census Tract 12.03, Fulton County, Georgia,235,21,214,203,139,39,0,11
-1,131210024002001.000000000000000,Block 2001, Block Group 2, Census Tract 24, Fulton County, Georgia,235,11,224,223,20,201,0,1
-1,131210105392021.000000000000000,Block 2021, Block Group 2, Census Tract 105.39, Fulton County, Georgia,235,0,235,229,0,228,0,6
-1,131210114191013.000000000000000,Block 1013, Block Group 1, Census Tract 114.19, Fulton County, Georgia,235,15,220,212,197,10,3,8
-1,131210052001001.000000000000000,Block 1001, Block Group 1, Census Tract 52, Fulton County, Georgia,234,10,224,217,202,13,0,7
-1,131210070024000.000000000000000,Block 4000, Block Group 4, Census Tract 70.02, Fulton County, Georgia,234,6,228,227,0,227,0,1
-1,131210078101003.000000000000000,Block 1003, Block Group 1, Census Tract 78.10, Fulton County, Georgia,234,3,231,228,1,227,0,3
-1,131210080005000.000000000000000,Block 5000, Block Group 5, Census Tract 80, Fulton County, Georgia,234,7,227,227,9,218,0,0
-1,131210099001013.000000000000000,Block 1013, Block Group 1, Census Tract 99, Fulton County, Georgia,234,2,232,227,206,0,0,5
-1,131210049002003.000000000000000,Block 2003, Block Group 2, Census Tract 49, Fulton County, Georgia,233,24,209,196,84,82,0,13
-1,131210089032004.000000000000000,Block 2004, Block Group 2, Census Tract 89.03, Fulton County, Georgia,233,223,10,6,3,3,0,4
-1,131210102152006.000000000000000,Block 2006, Block Group 2, Census Tract 102.15, Fulton County, Georgia,233,20,213,207,188,2,4,6
-1,131210112031012.000000000000000,Block 1012, Block Group 1, Census Tract 112.03, Fulton County, Georgia,233,7,226,222,27,195,0,4
-1,131210114363007.000000000000000,Block 3007, Block Group 3, Census Tract 114.36, Fulton County, Georgia,233,3,230,222,206,12,0,8
-1,131210114422001.000000000000000,Block 2001, Block Group 2, Census Tract 114.42, Fulton County, Georgia,233,11,222,211,168,27,0,11
-1,131210116333005.000000000000000,Block 3005, Block Group 3, Census Tract 116.33, Fulton County, Georgia,233,2,231,213,93,42,4,18
-1,131210116341000.000000000000000,Block 1000, Block Group 1, Census Tract 116.34, Fulton County, Georgia,233,45,188,173,129,23,0,15
-1,131210013021003.000000000000000,Block 1003, Block Group 1, Census Tract 13.02, Fulton County, Georgia,232,0,232,225,11,211,3,7
-1,131210079003002.000000000000000,Block 3002, Block Group 3, Census Tract 79, Fulton County, Georgia,232,0,232,230,4,226,0,2
-1,131210088011001.000000000000000,Block 1001, Block Group 1, Census Tract 88.01, Fulton County, Georgia,232,21,211,209,121,82,0,2
-1,131210101242001.000000000000000,Block 2001, Block Group 2, Census Tract 101.24, Fulton County, Georgia,232,27,205,200,36,161,0,5
-1,131210108011019.000000000000000,Block 1019, Block Group 1, Census Tract 108.01, Fulton County, Georgia,232,207,25,21,3,13,4,4
-1,131210114214008.000000000000000,Block 4008, Block Group 4, Census Tract 114.21, Fulton County, Georgia,232,54,178,174,96,69,2,4
-1,131210114362000.000000000000000,Block 2000, Block Group 2, Census Tract 114.36, Fulton County, Georgia,232,9,223,216,164,36,1,7
-1,131210114451005.000000000000000,Block 1005, Block Group 1, Census Tract 114.45, Fulton County, Georgia,232,19,213,194,123,65,1,19
-1,131210012041004.000000000000000,Block 1004, Block Group 1, Census Tract 12.04, Fulton County, Georgia,231,14,217,208,191,1,1,9
-1,131210077051005.000000000000000,Block 1005, Block Group 1, Census Tract 77.05, Fulton County, Georgia,231,4,227,227,2,225,0,0
-1,131210103151001.000000000000000,Block 1001, Block Group 1, Census Tract 103.15, Fulton County, Georgia,231,4,227,225,22,200,2,2
-1,131210105351007.000000000000000,Block 1007, Block Group 1, Census Tract 105.35, Fulton County, Georgia,231,7,224,223,25,197,0,1
-1,131210105381000.000000000000000,Block 1000, Block Group 1, Census Tract 105.38, Fulton County, Georgia,231,8,223,218,119,97,1,5
-1,131210114292002.000000000000000,Block 2002, Block Group 2, Census Tract 114.29, Fulton County, Georgia,231,28,203,199,175,19,0,4
-1,131210039001004.000000000000000,Block 1004, Block Group 1, Census Tract 39, Fulton County, Georgia,230,0,230,221,11,210,0,9
-1,131210101333000.000000000000000,Block 3000, Block Group 3, Census Tract 101.33, Fulton County, Georgia,230,8,222,217,70,13,1,5
-1,131210105262011.000000000000000,Block 2011, Block Group 2, Census Tract 105.26, Fulton County, Georgia,230,15,215,215,4,211,0,0
-1,131210006011001.000000000000000,Block 1001, Block Group 1, Census Tract 6.01, Fulton County, Georgia,229,22,207,200,117,71,0,7
-1,131210012032004.000000000000000,Block 2004, Block Group 2, Census Tract 12.03, Fulton County, Georgia,229,19,210,205,71,127,0,5
-1,131210040002010.000000000000000,Block 2010, Block Group 2, Census Tract 40, Fulton County, Georgia,229,0,229,226,20,206,0,3
-1,131210113081003.000000000000000,Block 1003, Block Group 1, Census Tract 113.08, Fulton County, Georgia,229,2,227,224,0,224,0,3
-1,131210114292000.000000000000000,Block 2000, Block Group 2, Census Tract 114.29, Fulton County, Georgia,229,14,215,204,169,9,0,11
-1,131210097003016.000000000000000,Block 3016, Block Group 3, Census Tract 97, Fulton County, Georgia,228,11,217,212,197,7,3,5
-1,131210098041011.000000000000000,Block 1011, Block Group 1, Census Tract 98.04, Fulton County, Georgia,228,11,217,210,200,0,0,7
-1,131210114234001.000000000000000,Block 4001, Block Group 4, Census Tract 114.23, Fulton County, Georgia,228,26,202,188,156,13,0,14
-1,131210114413000.000000000000000,Block 3000, Block Group 3, Census Tract 114.41, Fulton County, Georgia,228,23,205,197,179,11,2,8
-1,131210116571001.000000000000000,Block 1001, Block Group 1, Census Tract 116.57, Fulton County, Georgia,228,43,185,165,100,31,4,20
-1,131210038002005.000000000000000,Block 2005, Block Group 2, Census Tract 38, Fulton County, Georgia,227,0,227,227,0,227,0,0
-1,131210055041000.000000000000000,Block 1000, Block Group 1, Census Tract 55.04, Fulton County, Georgia,227,4,223,222,47,174,0,1
-1,131210088011002.000000000000000,Block 1002, Block Group 1, Census Tract 88.01, Fulton County, Georgia,227,22,205,202,139,62,0,3
-1,131210105242001.000000000000000,Block 2001, Block Group 2, Census Tract 105.24, Fulton County, Georgia,227,5,222,219,3,212,3,3
-1,131210098042001.000000000000000,Block 2001, Block Group 2, Census Tract 98.04, Fulton County, Georgia,226,5,221,217,215,1,0,4
-1,131210101212000.000000000000000,Block 2000, Block Group 2, Census Tract 101.21, Fulton County, Georgia,226,12,214,197,117,40,0,17
-1,131210103072006.000000000000000,Block 2006, Block Group 2, Census Tract 103.07, Fulton County, Georgia,226,3,223,219,3,211,0,4
-1,131210103122017.000000000000000,Block 2017, Block Group 2, Census Tract 103.12, Fulton County, Georgia,226,8,218,214,6,208,0,4
-1,131210113014005.000000000000000,Block 4005, Block Group 4, Census Tract 113.01, Fulton County, Georgia,226,6,220,220,18,197,0,0
-1,131210114193003.000000000000000,Block 3003, Block Group 3, Census Tract 114.19, Fulton County, Georgia,226,0,226,222,210,9,0,4
-1,131210114442011.000000000000000,Block 2011, Block Group 2, Census Tract 114.44, Fulton County, Georgia,226,6,220,208,174,1,1,12
-1,131210116372002.000000000000000,Block 2002, Block Group 2, Census Tract 116.37, Fulton County, Georgia,226,5,221,215,155,9,6,6
-1,131210116561003.000000000000000,Block 1003, Block Group 1, Census Tract 116.56, Fulton County, Georgia,226,20,206,193,82,13,1,13
-1,131210116601006.000000000000000,Block 1006, Block Group 1, Census Tract 116.60, Fulton County, Georgia,226,25,201,195,90,28,0,6
-1,131210093022002.000000000000000,Block 2002, Block Group 2, Census Tract 93.02, Fulton County, Georgia,225,3,222,217,207,6,4,5
-1,131210102201003.000000000000000,Block 1003, Block Group 1, Census Tract 102.20, Fulton County, Georgia,225,4,221,210,197,4,0,11
-1,131210103081013.000000000000000,Block 1013, Block Group 1, Census Tract 103.08, Fulton County, Georgia,225,7,218,218,1,217,0,0
-1,131210116321002.000000000000000,Block 1002, Block Group 1, Census Tract 116.32, Fulton County, Georgia,225,13,212,211,43,35,3,1
-1,131210101082004.000000000000000,Block 2004, Block Group 2, Census Tract 101.08, Fulton County, Georgia,224,2,222,216,185,14,0,6
-1,131210101272002.000000000000000,Block 2002, Block Group 2, Census Tract 101.27, Fulton County, Georgia,224,28,196,193,163,21,0,3
-1,131210114234003.000000000000000,Block 4003, Block Group 4, Census Tract 114.23, Fulton County, Georgia,224,8,216,207,192,10,0,9
-1,131210015012005.000000000000000,Block 2005, Block Group 2, Census Tract 15.01, Fulton County, Georgia,223,13,210,208,173,27,0,2
-1,131210042003016.000000000000000,Block 3016, Block Group 3, Census Tract 42, Fulton County, Georgia,223,4,219,216,1,215,0,3
-1,131210083022009.000000000000000,Block 2009, Block Group 2, Census Tract 83.02, Fulton County, Georgia,223,2,221,212,10,200,1,9
-1,131210088011013.000000000000000,Block 1013, Block Group 1, Census Tract 88.01, Fulton County, Georgia,223,2,221,205,145,55,0,16
-1,131210101151005.000000000000000,Block 1005, Block Group 1, Census Tract 101.15, Fulton County, Georgia,223,4,219,218,210,0,6,1
-1,131210080004006.000000000000000,Block 4006, Block Group 4, Census Tract 80, Fulton County, Georgia,222,3,219,219,7,212,0,0
-1,131210105372004.000000000000000,Block 2004, Block Group 2, Census Tract 105.37, Fulton County, Georgia,222,14,208,206,5,199,2,2
-1,131210114311002.000000000000000,Block 1002, Block Group 1, Census Tract 114.31, Fulton County, Georgia,222,139,83,70,49,14,2,13
-1,131210114391005.000000000000000,Block 1005, Block Group 1, Census Tract 114.39, Fulton County, Georgia,222,15,207,197,187,3,0,10
-1,131210116291003.000000000000000,Block 1003, Block Group 1, Census Tract 116.29, Fulton County, Georgia,222,6,216,206,102,7,3,10
-1,131210016001009.000000000000000,Block 1009, Block Group 1, Census Tract 16, Fulton County, Georgia,221,18,203,202,184,9,0,1
-1,131210053001019.000000000000000,Block 1019, Block Group 1, Census Tract 53, Fulton County, Georgia,221,16,205,193,125,60,0,12
-1,131210078094004.000000000000000,Block 4004, Block Group 4, Census Tract 78.09, Fulton County, Georgia,221,3,218,212,1,211,0,6
-1,131210103082021.000000000000000,Block 2021, Block Group 2, Census Tract 103.08, Fulton County, Georgia,221,0,221,221,12,208,1,0
-1,131210114162000.000000000000000,Block 2000, Block Group 2, Census Tract 114.16, Fulton County, Georgia,221,22,199,184,114,23,9,15
-1,131210116321006.000000000000000,Block 1006, Block Group 1, Census Tract 116.32, Fulton County, Georgia,221,9,212,202,41,51,1,10
-1,131210078052000.000000000000000,Block 2000, Block Group 2, Census Tract 78.05, Fulton County, Georgia,220,7,213,205,1,204,0,8
-1,131210080002000.000000000000000,Block 2000, Block Group 2, Census Tract 80, Fulton County, Georgia,220,3,217,215,18,189,0,2
-1,131210084002002.000000000000000,Block 2002, Block Group 2, Census Tract 84, Fulton County, Georgia,220,5,215,210,12,198,0,5
-1,131210101072003.000000000000000,Block 2003, Block Group 2, Census Tract 101.07, Fulton County, Georgia,220,4,216,210,206,0,0,6
-1,131210115073002.000000000000000,Block 3002, Block Group 3, Census Tract 115.07, Fulton County, Georgia,220,14,206,192,175,14,0,14
-1,131210115141002.000000000000000,Block 1002, Block Group 1, Census Tract 115.14, Fulton County, Georgia,220,3,217,202,185,8,0,15
-1,131210038001018.000000000000000,Block 1018, Block Group 1, Census Tract 38, Fulton County, Georgia,219,0,219,219,1,218,0,0
-1,131210100042002.000000000000000,Block 2002, Block Group 2, Census Tract 100.04, Fulton County, Georgia,219,4,215,211,174,27,0,4
-1,131210101172003.000000000000000,Block 2003, Block Group 2, Census Tract 101.17, Fulton County, Georgia,219,57,162,146,43,82,10,16
-1,131210105202014.000000000000000,Block 2014, Block Group 2, Census Tract 105.20, Fulton County, Georgia,219,7,212,209,2,204,2,3
-1,131210113091003.000000000000000,Block 1003, Block Group 1, Census Tract 113.09, Fulton County, Georgia,219,6,213,207,10,197,0,6
-1,131210021002002.000000000000000,Block 2002, Block Group 2, Census Tract 21, Fulton County, Georgia,218,0,218,217,8,200,0,1
-1,131210104021045.000000000000000,Block 1045, Block Group 1, Census Tract 104.02, Fulton County, Georgia,218,36,182,175,65,109,0,7
-1,131210105201015.000000000000000,Block 1015, Block Group 1, Census Tract 105.20, Fulton County, Georgia,218,8,210,206,6,200,0,4
-1,131210113061027.000000000000000,Block 1027, Block Group 1, Census Tract 113.06, Fulton County, Georgia,218,13,205,200,10,190,0,5
-1,131210100033002.000000000000000,Block 3002, Block Group 3, Census Tract 100.03, Fulton County, Georgia,217,17,200,192,136,26,0,8
-1,131210101251004.000000000000000,Block 1004, Block Group 1, Census Tract 101.25, Fulton County, Georgia,217,55,162,146,32,107,3,16
-1,131210116271008.000000000000000,Block 1008, Block Group 1, Census Tract 116.27, Fulton County, Georgia,217,3,214,205,143,11,0,9
-1,131210079001005.000000000000000,Block 1005, Block Group 1, Census Tract 79, Fulton County, Georgia,216,2,214,213,3,210,0,1
-1,131210101331001.000000000000000,Block 1001, Block Group 1, Census Tract 101.33, Fulton County, Georgia,216,4,212,211,149,24,2,1
-1,131210077092000.000000000000000,Block 2000, Block Group 2, Census Tract 77.09, Fulton County, Georgia,215,14,201,192,0,191,1,9
-1,131210101081002.000000000000000,Block 1002, Block Group 1, Census Tract 101.08, Fulton County, Georgia,215,6,209,199,187,11,1,10
-1,131210102123003.000000000000000,Block 3003, Block Group 3, Census Tract 102.12, Fulton County, Georgia,215,14,201,199,178,11,2,2
-1,131210102221005.000000000000000,Block 1005, Block Group 1, Census Tract 102.22, Fulton County, Georgia,215,1,214,213,195,6,0,1
-1,131210103133018.000000000000000,Block 3018, Block Group 3, Census Tract 103.13, Fulton County, Georgia,215,1,214,209,0,209,0,5
-1,131210105173008.000000000000000,Block 3008, Block Group 3, Census Tract 105.17, Fulton County, Georgia,215,9,206,200,5,195,0,6
-1,131210105231022.000000000000000,Block 1022, Block Group 1, Census Tract 105.23, Fulton County, Georgia,215,11,204,199,3,194,0,5
-1,131210042001008.000000000000000,Block 1008, Block Group 1, Census Tract 42, Fulton County, Georgia,214,0,214,214,7,207,0,0
-1,131210094101001.000000000000000,Block 1001, Block Group 1, Census Tract 94.10, Fulton County, Georgia,214,8,206,191,146,24,5,15
-1,131210105083019.000000000000000,Block 3019, Block Group 3, Census Tract 105.08, Fulton County, Georgia,214,3,211,204,2,201,0,7
-1,131210116314002.000000000000000,Block 4002, Block Group 4, Census Tract 116.31, Fulton County, Georgia,214,11,203,190,63,29,4,13
-1,131210078062005.000000000000000,Block 2005, Block Group 2, Census Tract 78.06, Fulton County, Georgia,213,0,213,209,1,208,0,4
-1,131210081042002.000000000000000,Block 2002, Block Group 2, Census Tract 81.04, Fulton County, Georgia,213,8,205,198,1,197,0,7
-1,131210089032005.000000000000000,Block 2005, Block Group 2, Census Tract 89.03, Fulton County, Georgia,213,192,21,9,0,6,1,12
-1,131210105201006.000000000000000,Block 1006, Block Group 1, Census Tract 105.20, Fulton County, Georgia,213,1,212,204,0,203,1,8
-1,131210116582013.000000000000000,Block 2013, Block Group 2, Census Tract 116.58, Fulton County, Georgia,213,22,191,185,106,59,0,6
-1,131210017012003.000000000000000,Block 2003, Block Group 2, Census Tract 17.01, Fulton County, Georgia,212,7,205,202,86,108,2,3
-1,131210069003003.000000000000000,Block 3003, Block Group 3, Census Tract 69, Fulton County, Georgia,212,1,211,209,63,145,0,2
-1,131210101351005.000000000000000,Block 1005, Block Group 1, Census Tract 101.35, Fulton County, Georgia,212,40,172,155,75,58,5,17
-1,131210113093000.000000000000000,Block 3000, Block Group 3, Census Tract 113.09, Fulton County, Georgia,212,6,206,197,13,179,2,9
-1,131210088011018.000000000000000,Block 1018, Block Group 1, Census Tract 88.01, Fulton County, Georgia,211,15,196,189,123,54,0,7
-1,131210105263016.000000000000000,Block 3016, Block Group 3, Census Tract 105.26, Fulton County, Georgia,211,10,201,194,9,183,0,7
-1,131210116503000.000000000000000,Block 3000, Block Group 3, Census Tract 116.50, Fulton County, Georgia,211,8,203,183,81,57,0,20
-1,131210001005004.000000000000000,Block 5004, Block Group 5, Census Tract 1, Fulton County, Georgia,210,0,210,199,119,63,0,11
-1,131210084004003.000000000000000,Block 4003, Block Group 4, Census Tract 84, Fulton County, Georgia,210,5,205,193,16,177,0,12
-1,131210105283005.000000000000000,Block 3005, Block Group 3, Census Tract 105.28, Fulton County, Georgia,210,6,204,200,0,200,0,4
-1,131210115141010.000000000000000,Block 1010, Block Group 1, Census Tract 115.14, Fulton County, Georgia,210,9,201,198,179,4,0,3
-1,131210116402033.000000000000000,Block 2033, Block Group 2, Census Tract 116.40, Fulton County, Georgia,210,5,205,205,174,19,0,0
-1,131210116531007.000000000000000,Block 1007, Block Group 1, Census Tract 116.53, Fulton County, Georgia,210,16,194,184,127,29,0,10
-1,131210012041003.000000000000000,Block 1003, Block Group 1, Census Tract 12.04, Fulton County, Georgia,209,16,193,191,170,10,0,2
-1,131210019022006.000000000000000,Block 2006, Block Group 2, Census Tract 19.02, Fulton County, Georgia,209,15,194,176,36,119,0,18
-1,131210042002009.000000000000000,Block 2009, Block Group 2, Census Tract 42, Fulton County, Georgia,209,6,203,195,17,177,1,8
-1,131210042003017.000000000000000,Block 3017, Block Group 3, Census Tract 42, Fulton County, Georgia,209,2,207,197,0,194,0,10
-1,131210114342009.000000000000000,Block 2009, Block Group 2, Census Tract 114.34, Fulton County, Georgia,209,24,185,174,142,24,2,11
-1,131210114452008.000000000000000,Block 2008, Block Group 2, Census Tract 114.45, Fulton County, Georgia,209,13,196,191,181,0,0,5
-1,131210116183018.000000000000000,Block 3018, Block Group 3, Census Tract 116.18, Fulton County, Georgia,209,8,201,199,144,11,0,2
-1,131210015012001.000000000000000,Block 2001, Block Group 2, Census Tract 15.01, Fulton County, Georgia,208,23,185,185,156,10,6,0
-1,131210024001017.000000000000000,Block 1017, Block Group 1, Census Tract 24, Fulton County, Georgia,208,2,206,202,25,174,0,4
-1,131210055031001.000000000000000,Block 1001, Block Group 1, Census Tract 55.03, Fulton County, Georgia,208,3,205,193,0,186,0,12
-1,131210076023003.000000000000000,Block 3003, Block Group 3, Census Tract 76.02, Fulton County, Georgia,208,0,208,205,15,188,0,3
-1,131210078051027.000000000000000,Block 1027, Block Group 1, Census Tract 78.05, Fulton County, Georgia,208,11,197,194,0,194,0,3
-1,131210101062000.000000000000000,Block 2000, Block Group 2, Census Tract 101.06, Fulton County, Georgia,208,10,198,197,179,8,0,1
-1,131210101293007.000000000000000,Block 3007, Block Group 3, Census Tract 101.29, Fulton County, Georgia,208,7,201,197,166,23,0,4
-1,131210071001016.000000000000000,Block 1016, Block Group 1, Census Tract 71, Fulton County, Georgia,207,5,202,193,0,189,4,9
-1,131210101252003.000000000000000,Block 2003, Block Group 2, Census Tract 101.25, Fulton County, Georgia,207,28,179,179,55,113,3,0
-1,131210105182000.000000000000000,Block 2000, Block Group 2, Census Tract 105.18, Fulton County, Georgia,207,1,206,206,0,203,3,0
-1,131210021001005.000000000000000,Block 1005, Block Group 1, Census Tract 21, Fulton County, Georgia,206,6,200,195,30,159,1,5
-1,131210043001001.000000000000000,Block 1001, Block Group 1, Census Tract 43, Fulton County, Georgia,206,10,196,192,1,190,1,4
-1,131210082041000.000000000000000,Block 1000, Block Group 1, Census Tract 82.04, Fulton County, Georgia,206,0,206,201,3,198,0,5
-1,131210101271002.000000000000000,Block 1002, Block Group 1, Census Tract 101.27, Fulton County, Georgia,206,12,194,191,99,47,0,3
-1,131210105203016.000000000000000,Block 3016, Block Group 3, Census Tract 105.20, Fulton County, Georgia,206,0,206,202,4,191,0,4
-1,131210105271004.000000000000000,Block 1004, Block Group 1, Census Tract 105.27, Fulton County, Georgia,206,72,134,134,21,112,0,0
-1,131210105323005.000000000000000,Block 3005, Block Group 3, Census Tract 105.32, Fulton County, Georgia,206,2,204,203,0,202,1,1
-1,131210120001007.000000000000000,Block 1007, Block Group 1, Census Tract 120, Fulton County, Georgia,206,5,201,197,1,196,0,4
-1,131210010022011.000000000000000,Block 2011, Block Group 2, Census Tract 10.02, Fulton County, Georgia,205,7,198,188,153,7,0,10
-1,131210015022002.000000000000000,Block 2002, Block Group 2, Census Tract 15.02, Fulton County, Georgia,205,14,191,184,169,14,0,7
-1,131210076033019.000000000000000,Block 3019, Block Group 3, Census Tract 76.03, Fulton County, Georgia,205,0,205,201,9,192,0,4
-1,131210082041008.000000000000000,Block 1008, Block Group 1, Census Tract 82.04, Fulton County, Georgia,205,5,200,190,6,184,0,10
-1,131210105231032.000000000000000,Block 1032, Block Group 1, Census Tract 105.23, Fulton County, Georgia,205,7,198,193,1,192,0,5
-1,131210115142016.000000000000000,Block 2016, Block Group 2, Census Tract 115.14, Fulton County, Georgia,205,8,197,193,181,6,0,4
-1,131210116531004.000000000000000,Block 1004, Block Group 1, Census Tract 116.53, Fulton County, Georgia,205,21,184,175,146,17,1,9
-1,131210065002003.000000000000000,Block 2003, Block Group 2, Census Tract 65, Fulton County, Georgia,204,5,199,192,36,155,0,7
-1,131210069003004.000000000000000,Block 3004, Block Group 3, Census Tract 69, Fulton County, Georgia,204,30,174,164,126,34,1,10
-1,131210070014005.000000000000000,Block 4005, Block Group 4, Census Tract 70.01, Fulton County, Georgia,204,9,195,194,18,173,0,1
-1,131210073013000.000000000000000,Block 3000, Block Group 3, Census Tract 73.01, Fulton County, Georgia,204,28,176,171,4,167,0,5
-1,131210075003003.000000000000000,Block 3003, Block Group 3, Census Tract 75, Fulton County, Georgia,204,10,194,183,8,174,0,11
-1,131210102111007.000000000000000,Block 1007, Block Group 1, Census Tract 102.11, Fulton County, Georgia,204,1,203,199,175,6,0,4
-1,131210103051018.000000000000000,Block 1018, Block Group 1, Census Tract 103.05, Fulton County, Georgia,204,0,204,201,0,200,1,3
-1,131210103152000.000000000000000,Block 2000, Block Group 2, Census Tract 103.15, Fulton County, Georgia,204,3,201,200,28,172,0,1
-1,131210114282007.000000000000000,Block 2007, Block Group 2, Census Tract 114.28, Fulton County, Georgia,204,4,200,190,178,2,3,10
-1,131210015021012.000000000000000,Block 1012, Block Group 1, Census Tract 15.02, Fulton County, Georgia,203,13,190,188,178,1,2,2
-1,131210077112003.000000000000000,Block 2003, Block Group 2, Census Tract 77.11, Fulton County, Georgia,203,8,195,191,2,189,0,4
-1,131210095012012.000000000000000,Block 2012, Block Group 2, Census Tract 95.01, Fulton County, Georgia,203,1,202,198,189,7,1,4
-1,131210021001015.000000000000000,Block 1015, Block Group 1, Census Tract 21, Fulton County, Georgia,202,9,193,183,85,83,0,10
-1,131210077072000.000000000000000,Block 2000, Block Group 2, Census Tract 77.07, Fulton County, Georgia,202,2,200,197,0,197,0,3
-1,131210077091003.000000000000000,Block 1003, Block Group 1, Census Tract 77.09, Fulton County, Georgia,202,2,200,186,2,183,0,14
-1,131210086012019.000000000000000,Block 2019, Block Group 2, Census Tract 86.01, Fulton County, Georgia,202,8,194,192,3,189,0,2
-1,131210101274000.000000000000000,Block 4000, Block Group 4, Census Tract 101.27, Fulton County, Georgia,202,13,189,187,179,5,0,2
-1,131210114161008.000000000000000,Block 1008, Block Group 1, Census Tract 114.16, Fulton County, Georgia,202,3,199,198,180,9,3,1
-1,131210114341019.000000000000000,Block 1019, Block Group 1, Census Tract 114.34, Fulton County, Georgia,202,21,181,160,131,23,0,21
-1,131210115082011.000000000000000,Block 2011, Block Group 2, Census Tract 115.08, Fulton County, Georgia,202,14,188,183,151,17,0,5
-1,131210018012004.000000000000000,Block 2004, Block Group 2, Census Tract 18.01, Fulton County, Georgia,201,9,192,180,108,60,0,12
-1,131210028021006.000000000000000,Block 1006, Block Group 1, Census Tract 28.02, Fulton County, Georgia,201,3,198,184,4,180,0,14
-1,131210036002003.000000000000000,Block 2003, Block Group 2, Census Tract 36, Fulton County, Georgia,201,5,196,194,1,191,0,2
-1,131210077103002.000000000000000,Block 3002, Block Group 3, Census Tract 77.10, Fulton County, Georgia,201,4,197,197,4,191,0,0
-1,131210098042005.000000000000000,Block 2005, Block Group 2, Census Tract 98.04, Fulton County, Georgia,201,0,201,189,173,10,1,12
-1,131210104012005.000000000000000,Block 2005, Block Group 2, Census Tract 104.01, Fulton County, Georgia,201,14,187,185,16,165,0,2
-1,131210105382026.000000000000000,Block 2026, Block Group 2, Census Tract 105.38, Fulton County, Georgia,201,5,196,194,2,192,0,2
-1,131210114292010.000000000000000,Block 2010, Block Group 2, Census Tract 114.29, Fulton County, Georgia,201,10,191,160,135,14,1,31
-1,131210115051002.000000000000000,Block 1002, Block Group 1, Census Tract 115.05, Fulton County, Georgia,201,10,191,188,171,10,7,3
-1,131210116183021.000000000000000,Block 3021, Block Group 3, Census Tract 116.18, Fulton County, Georgia,201,7,194,177,90,8,3,17
-1,131210116471013.000000000000000,Block 1013, Block Group 1, Census Tract 116.47, Fulton County, Georgia,201,6,195,182,135,30,0,13
-1,131210116482005.000000000000000,Block 2005, Block Group 2, Census Tract 116.48, Fulton County, Georgia,201,14,187,179,5,7,0,8
-1,131210012031001.000000000000000,Block 1001, Block Group 1, Census Tract 12.03, Fulton County, Georgia,200,6,194,187,129,26,3,7
-1,131210017012006.000000000000000,Block 2006, Block Group 2, Census Tract 17.01, Fulton County, Georgia,200,3,197,193,10,178,0,4
-1,131210077051006.000000000000000,Block 1006, Block Group 1, Census Tract 77.05, Fulton County, Georgia,200,2,198,196,1,192,3,2
-1,131210092022004.000000000000000,Block 2004, Block Group 2, Census Tract 92.02, Fulton County, Georgia,200,16,184,172,76,69,1,12
-1,131210099001009.000000000000000,Block 1009, Block Group 1, Census Tract 99, Fulton County, Georgia,200,3,197,194,163,21,1,3
-1,131210105223011.000000000000000,Block 3011, Block Group 3, Census Tract 105.22, Fulton County, Georgia,200,2,198,198,0,197,0,0
-1,131210116602018.000000000000000,Block 2018, Block Group 2, Census Tract 116.60, Fulton County, Georgia,200,3,197,196,117,26,1,1
-1,131210102203012.000000000000000,Block 3012, Block Group 3, Census Tract 102.20, Fulton County, Georgia,199,8,191,168,126,20,0,23
-1,131210105391024.000000000000000,Block 1024, Block Group 1, Census Tract 105.39, Fulton County, Georgia,199,13,186,186,6,180,0,0
-1,131210116481000.000000000000000,Block 1000, Block Group 1, Census Tract 116.48, Fulton County, Georgia,199,12,187,176,87,16,0,11
-1,131210002021006.000000000000000,Block 1006, Block Group 1, Census Tract 2.02, Fulton County, Georgia,198,0,198,194,190,0,0,4
-1,131210030002000.000000000000000,Block 2000, Block Group 2, Census Tract 30, Fulton County, Georgia,198,6,192,187,167,14,2,5
-1,131210094053005.000000000000000,Block 3005, Block Group 3, Census Tract 94.05, Fulton County, Georgia,198,0,198,198,6,192,0,0
-1,131210114161007.000000000000000,Block 1007, Block Group 1, Census Tract 114.16, Fulton County, Georgia,198,19,179,168,146,4,0,11
-1,131210114261011.000000000000000,Block 1011, Block Group 1, Census Tract 114.26, Fulton County, Georgia,198,30,168,156,102,38,0,12
-1,131210011013003.000000000000000,Block 3003, Block Group 3, Census Tract 11.01, Fulton County, Georgia,197,17,180,174,91,70,0,6
-1,131210048001000.000000000000000,Block 1000, Block Group 1, Census Tract 48, Fulton County, Georgia,197,4,193,191,12,167,3,2
-1,131210069002011.000000000000000,Block 2011, Block Group 2, Census Tract 69, Fulton County, Georgia,197,58,139,135,19,113,0,4
-1,131210089031007.000000000000000,Block 1007, Block Group 1, Census Tract 89.03, Fulton County, Georgia,197,93,104,100,5,90,2,4
-1,131210098021025.000000000000000,Block 1025, Block Group 1, Census Tract 98.02, Fulton County, Georgia,197,1,196,196,161,19,0,0
-1,131210116411000.000000000000000,Block 1000, Block Group 1, Census Tract 116.41, Fulton County, Georgia,197,1,196,181,164,7,3,15
-1,131210013011001.000000000000000,Block 1001, Block Group 1, Census Tract 13.01, Fulton County, Georgia,196,14,182,176,156,10,1,6
-1,131210092021002.000000000000000,Block 1002, Block Group 1, Census Tract 92.02, Fulton County, Georgia,196,21,175,157,139,8,0,18
-1,131210101152007.000000000000000,Block 2007, Block Group 2, Census Tract 101.15, Fulton County, Georgia,196,6,190,186,90,85,0,4
-1,131210102213001.000000000000000,Block 3001, Block Group 3, Census Tract 102.21, Fulton County, Georgia,196,21,175,166,156,3,0,9
-1,131210105371007.000000000000000,Block 1007, Block Group 1, Census Tract 105.37, Fulton County, Georgia,196,3,193,190,4,186,0,3
-1,131210116182003.000000000000000,Block 2003, Block Group 2, Census Tract 116.18, Fulton County, Georgia,196,0,196,194,104,17,4,2
-1,131210029001006.000000000000000,Block 1006, Block Group 1, Census Tract 29, Fulton County, Georgia,195,7,188,180,117,51,2,8
-1,131210086013007.000000000000000,Block 3007, Block Group 3, Census Tract 86.01, Fulton County, Georgia,195,3,192,192,9,183,0,0
-1,131210102213003.000000000000000,Block 3003, Block Group 3, Census Tract 102.21, Fulton County, Georgia,195,11,184,172,145,6,2,12
-1,131210103151009.000000000000000,Block 1009, Block Group 1, Census Tract 103.15, Fulton County, Georgia,195,0,195,195,0,192,3,0
-1,131210114322003.000000000000000,Block 2003, Block Group 2, Census Tract 114.32, Fulton County, Georgia,195,68,127,121,73,39,4,6
-1,131210066011007.000000000000000,Block 1007, Block Group 1, Census Tract 66.01, Fulton County, Georgia,194,3,191,185,3,181,0,6
-1,131210089091005.000000000000000,Block 1005, Block Group 1, Census Tract 89.09, Fulton County, Georgia,194,5,189,171,158,4,2,18
-1,131210095012009.000000000000000,Block 2009, Block Group 2, Census Tract 95.01, Fulton County, Georgia,194,0,194,190,187,0,0,4
-1,131210105272003.000000000000000,Block 2003, Block Group 2, Census Tract 105.27, Fulton County, Georgia,194,7,187,180,6,170,0,7
-1,131210106034009.000000000000000,Block 4009, Block Group 4, Census Tract 106.03, Fulton County, Georgia,194,0,194,194,21,155,1,0
-1,131210006011011.000000000000000,Block 1011, Block Group 1, Census Tract 6.01, Fulton County, Georgia,193,4,189,186,9,177,0,3
-1,131210012061003.000000000000000,Block 1003, Block Group 1, Census Tract 12.06, Fulton County, Georgia,193,6,187,170,123,15,0,17
-1,131210019011003.000000000000000,Block 1003, Block Group 1, Census Tract 19.01, Fulton County, Georgia,193,2,191,190,17,169,0,1
-1,131210082021003.000000000000000,Block 1003, Block Group 1, Census Tract 82.02, Fulton County, Georgia,193,4,189,188,3,185,0,1
-1,131210089062001.000000000000000,Block 2001, Block Group 2, Census Tract 89.06, Fulton County, Georgia,193,7,186,184,169,8,6,2
-1,131210098023012.000000000000000,Block 3012, Block Group 3, Census Tract 98.02, Fulton County, Georgia,193,5,188,186,149,12,3,2
-1,131210100072006.000000000000000,Block 2006, Block Group 2, Census Tract 100.07, Fulton County, Georgia,193,8,185,181,154,11,2,4
-1,131210114261010.000000000000000,Block 1010, Block Group 1, Census Tract 114.26, Fulton County, Georgia,193,91,102,95,76,19,0,7
-1,131210114362003.000000000000000,Block 2003, Block Group 2, Census Tract 114.36, Fulton County, Georgia,193,4,189,184,166,6,0,5
-1,131210101321015.000000000000000,Block 1015, Block Group 1, Census Tract 101.32, Fulton County, Georgia,192,13,179,175,152,20,0,4
-1,131210113072001.000000000000000,Block 2001, Block Group 2, Census Tract 113.07, Fulton County, Georgia,192,9,183,181,1,180,0,2
-1,131210114341015.000000000000000,Block 1015, Block Group 1, Census Tract 114.34, Fulton County, Georgia,192,41,151,139,104,26,0,12
-1,131210116182002.000000000000000,Block 2002, Block Group 2, Census Tract 116.18, Fulton County, Georgia,192,14,178,178,118,19,0,0
-1,131210070012001.000000000000000,Block 2001, Block Group 2, Census Tract 70.01, Fulton County, Georgia,191,4,187,187,20,167,0,0
-1,131210093022001.000000000000000,Block 2001, Block Group 2, Census Tract 93.02, Fulton County, Georgia,190,15,175,166,157,6,3,9
-1,131210106014003.000000000000000,Block 4003, Block Group 4, Census Tract 106.01, Fulton County, Georgia,190,8,182,180,40,140,0,2
-1,131210115092002.000000000000000,Block 2002, Block Group 2, Census Tract 115.09, Fulton County, Georgia,190,1,189,185,159,25,0,4
-1,131210116313001.000000000000000,Block 3001, Block Group 3, Census Tract 116.31, Fulton County, Georgia,190,25,165,145,74,30,2,20
-1,131210012051000.000000000000000,Block 1000, Block Group 1, Census Tract 12.05, Fulton County, Georgia,189,8,181,168,154,10,0,13
-1,131210086012021.000000000000000,Block 2021, Block Group 2, Census Tract 86.01, Fulton County, Georgia,189,2,187,185,5,180,0,2
-1,131210101372003.000000000000000,Block 2003, Block Group 2, Census Tract 101.37, Fulton County, Georgia,189,17,172,162,125,34,0,10
-1,131210103122026.000000000000000,Block 2026, Block Group 2, Census Tract 103.12, Fulton County, Georgia,189,3,186,185,0,183,0,1
-1,131210114372005.000000000000000,Block 2005, Block Group 2, Census Tract 114.37, Fulton County, Georgia,189,55,134,132,114,17,1,2
-1,131210024002009.000000000000000,Block 2009, Block Group 2, Census Tract 24, Fulton County, Georgia,188,5,183,180,9,165,0,3
-1,131210087012004.000000000000000,Block 2004, Block Group 2, Census Tract 87.01, Fulton County, Georgia,188,8,180,177,20,157,0,3
-1,131210089091001.000000000000000,Block 1001, Block Group 1, Census Tract 89.09, Fulton County, Georgia,188,20,168,161,106,53,0,7
-1,131210102152000.000000000000000,Block 2000, Block Group 2, Census Tract 102.15, Fulton County, Georgia,188,7,181,162,112,40,2,19
-1,131210105322006.000000000000000,Block 2006, Block Group 2, Census Tract 105.32, Fulton County, Georgia,188,0,188,183,7,175,0,5
-1,131210106033006.000000000000000,Block 3006, Block Group 3, Census Tract 106.03, Fulton County, Georgia,188,6,182,176,0,173,3,6
-1,131210113072011.000000000000000,Block 2011, Block Group 2, Census Tract 113.07, Fulton County, Georgia,188,6,182,182,1,180,1,0
-1,131210116462013.000000000000000,Block 2013, Block Group 2, Census Tract 116.46, Fulton County, Georgia,188,2,186,185,147,37,0,1
-1,131210116491003.000000000000000,Block 1003, Block Group 1, Census Tract 116.49, Fulton County, Georgia,188,5,183,176,91,15,0,7
-1,131210064001002.000000000000000,Block 1002, Block Group 1, Census Tract 64, Fulton County, Georgia,187,10,177,174,81,93,0,3
-1,131210070012014.000000000000000,Block 2014, Block Group 2, Census Tract 70.01, Fulton County, Georgia,187,8,179,172,3,169,0,7
-1,131210089073001.000000000000000,Block 3001, Block Group 3, Census Tract 89.07, Fulton County, Georgia,187,22,165,159,151,7,0,6
-1,131210097003019.000000000000000,Block 3019, Block Group 3, Census Tract 97, Fulton County, Georgia,187,5,182,179,145,7,0,3
-1,131210100041001.000000000000000,Block 1001, Block Group 1, Census Tract 100.04, Fulton County, Georgia,187,6,181,174,158,9,0,7
-1,131210113015003.000000000000000,Block 5003, Block Group 5, Census Tract 113.01, Fulton County, Georgia,187,23,164,164,17,144,1,0
-1,131210077091006.000000000000000,Block 1006, Block Group 1, Census Tract 77.09, Fulton County, Georgia,186,15,171,161,6,151,0,10
-1,131210082022006.000000000000000,Block 2006, Block Group 2, Census Tract 82.02, Fulton County, Georgia,186,3,183,183,0,183,0,0
-1,131210101201002.000000000000000,Block 1002, Block Group 1, Census Tract 101.20, Fulton County, Georgia,186,13,173,166,119,39,0,7
-1,131210102203010.000000000000000,Block 3010, Block Group 3, Census Tract 102.20, Fulton County, Georgia,186,4,182,180,154,18,4,2
-1,131210105283002.000000000000000,Block 3002, Block Group 3, Census Tract 105.28, Fulton County, Georgia,186,3,183,182,4,177,1,1
-1,131210114172001.000000000000000,Block 2001, Block Group 2, Census Tract 114.17, Fulton County, Georgia,186,2,184,181,167,0,0,3
-1,131210114222004.000000000000000,Block 2004, Block Group 2, Census Tract 114.22, Fulton County, Georgia,186,24,162,156,71,74,0,6
-1,131210115072003.000000000000000,Block 2003, Block Group 2, Census Tract 115.07, Fulton County, Georgia,186,14,172,168,160,6,0,4
-1,131210101273002.000000000000000,Block 3002, Block Group 3, Census Tract 101.27, Fulton County, Georgia,185,30,155,147,49,68,0,8
-1,131210105293008.000000000000000,Block 3008, Block Group 3, Census Tract 105.29, Fulton County, Georgia,185,7,178,178,3,172,0,0
-1,131210114311004.000000000000000,Block 1004, Block Group 1, Census Tract 114.31, Fulton County, Georgia,185,123,62,60,19,30,0,2
-1,131210115102003.000000000000000,Block 2003, Block Group 2, Census Tract 115.10, Fulton County, Georgia,185,3,182,178,50,22,0,4
-1,131210116312001.000000000000000,Block 2001, Block Group 2, Census Tract 116.31, Fulton County, Georgia,185,20,165,160,74,10,1,5
-1,131210116433003.000000000000000,Block 3003, Block Group 3, Census Tract 116.43, Fulton County, Georgia,185,12,173,164,87,55,0,9
-1,131210116462025.000000000000000,Block 2025, Block Group 2, Census Tract 116.46, Fulton County, Georgia,185,10,175,167,124,31,2,8
-1,131210073021000.000000000000000,Block 1000, Block Group 1, Census Tract 73.02, Fulton County, Georgia,184,1,183,181,7,174,0,2
-1,131210100051011.000000000000000,Block 1011, Block Group 1, Census Tract 100.05, Fulton County, Georgia,184,7,177,175,170,3,0,2
-1,131210101332008.000000000000000,Block 2008, Block Group 2, Census Tract 101.33, Fulton County, Georgia,184,3,181,177,141,18,0,4
-1,131210102043006.000000000000000,Block 3006, Block Group 3, Census Tract 102.04, Fulton County, Georgia,184,5,179,174,168,3,0,5
-1,131210105323013.000000000000000,Block 3013, Block Group 3, Census Tract 105.32, Fulton County, Georgia,184,4,180,169,2,167,0,11
-1,131210105401012.000000000000000,Block 1012, Block Group 1, Census Tract 105.40, Fulton County, Georgia,184,32,152,151,20,126,0,1
-1,131210108021000.000000000000000,Block 1000, Block Group 1, Census Tract 108.02, Fulton County, Georgia,184,37,147,145,37,47,0,2
-1,131210077093008.000000000000000,Block 3008, Block Group 3, Census Tract 77.09, Fulton County, Georgia,183,4,179,176,8,167,1,3
-1,131210082042000.000000000000000,Block 2000, Block Group 2, Census Tract 82.04, Fulton County, Georgia,183,0,183,183,8,175,0,0
-1,131210090011003.000000000000000,Block 1003, Block Group 1, Census Tract 90.01, Fulton County, Georgia,183,6,177,168,156,7,0,9
-1,131210100072000.000000000000000,Block 2000, Block Group 2, Census Tract 100.07, Fulton County, Georgia,183,6,177,170,128,30,0,7
-1,131210113061012.000000000000000,Block 1012, Block Group 1, Census Tract 113.06, Fulton County, Georgia,183,11,172,162,1,161,0,10
-1,131210115102005.000000000000000,Block 2005, Block Group 2, Census Tract 115.10, Fulton County, Georgia,183,8,175,160,78,11,1,15
-1,131210002011006.000000000000000,Block 1006, Block Group 1, Census Tract 2.01, Fulton County, Georgia,182,6,176,158,141,0,1,18
-1,131210014003003.000000000000000,Block 3003, Block Group 3, Census Tract 14, Fulton County, Georgia,182,9,173,160,139,7,0,13
-1,131210016001010.000000000000000,Block 1010, Block Group 1, Census Tract 16, Fulton County, Georgia,182,14,168,163,149,4,0,5
-1,131210044001006.000000000000000,Block 1006, Block Group 1, Census Tract 44, Fulton County, Georgia,182,5,177,165,0,162,3,12
-1,131210049002007.000000000000000,Block 2007, Block Group 2, Census Tract 49, Fulton County, Georgia,182,6,176,173,160,7,0,3
-1,131210086014006.000000000000000,Block 4006, Block Group 4, Census Tract 86.01, Fulton County, Georgia,182,0,182,178,0,178,0,4
-1,131210088021005.000000000000000,Block 1005, Block Group 1, Census Tract 88.02, Fulton County, Georgia,182,49,133,131,34,92,1,2
-1,131210098022003.000000000000000,Block 2003, Block Group 2, Census Tract 98.02, Fulton County, Georgia,182,0,182,180,155,12,0,2
-1,131210102222009.000000000000000,Block 2009, Block Group 2, Census Tract 102.22, Fulton County, Georgia,182,11,171,166,166,0,0,5
-1,131210105391032.000000000000000,Block 1032, Block Group 1, Census Tract 105.39, Fulton County, Georgia,182,5,177,173,3,167,3,4
-1,131210114462002.000000000000000,Block 2002, Block Group 2, Census Tract 114.46, Fulton County, Georgia,182,4,178,171,161,4,5,7
-1,131210116502002.000000000000000,Block 2002, Block Group 2, Census Tract 116.50, Fulton County, Georgia,182,17,165,162,21,6,0,3
-1,131210116521019.000000000000000,Block 1019, Block Group 1, Census Tract 116.52, Fulton County, Georgia,182,11,171,166,49,16,3,5
-1,131210116562001.000000000000000,Block 2001, Block Group 2, Census Tract 116.56, Fulton County, Georgia,182,15,167,155,123,11,2,12
-1,131210061001006.000000000000000,Block 1006, Block Group 1, Census Tract 61, Fulton County, Georgia,181,1,180,178,6,171,0,2
-1,131210098031000.000000000000000,Block 1000, Block Group 1, Census Tract 98.03, Fulton County, Georgia,181,4,177,175,174,1,0,2
-1,131210116291002.000000000000000,Block 1002, Block Group 1, Census Tract 116.29, Fulton County, Georgia,181,13,168,149,110,4,3,19
-1,131210015011006.000000000000000,Block 1006, Block Group 1, Census Tract 15.01, Fulton County, Georgia,180,6,174,166,152,3,3,8
-1,131210017021000.000000000000000,Block 1000, Block Group 1, Census Tract 17.02, Fulton County, Georgia,180,15,165,159,121,16,0,6
-1,131210032001004.000000000000000,Block 1004, Block Group 1, Census Tract 32, Fulton County, Georgia,180,3,177,174,87,81,5,3
-1,131210073022013.000000000000000,Block 2013, Block Group 2, Census Tract 73.02, Fulton County, Georgia,180,1,179,174,0,172,0,5
-1,131210096061013.000000000000000,Block 1013, Block Group 1, Census Tract 96.06, Fulton County, Georgia,180,9,171,168,147,3,5,3
-1,131210101071002.000000000000000,Block 1002, Block Group 1, Census Tract 101.07, Fulton County, Georgia,180,5,175,171,153,5,1,4
-1,131210102041006.000000000000000,Block 1006, Block Group 1, Census Tract 102.04, Fulton County, Georgia,180,7,173,156,136,6,0,17
-1,131210102121005.000000000000000,Block 1005, Block Group 1, Census Tract 102.12, Fulton County, Georgia,180,8,172,167,135,10,0,5
-1,131210114193001.000000000000000,Block 3001, Block Group 3, Census Tract 114.19, Fulton County, Georgia,180,3,177,175,172,3,0,2
-1,131210114194025.000000000000000,Block 4025, Block Group 4, Census Tract 114.19, Fulton County, Georgia,180,2,178,178,174,0,0,0
-1,131210115102001.000000000000000,Block 2001, Block Group 2, Census Tract 115.10, Fulton County, Georgia,180,12,168,161,153,3,3,7
-1,131210078091004.000000000000000,Block 1004, Block Group 1, Census Tract 78.09, Fulton County, Georgia,179,0,179,176,0,176,0,3
-1,131210096072003.000000000000000,Block 2003, Block Group 2, Census Tract 96.07, Fulton County, Georgia,179,18,161,151,81,40,0,10
-1,131210101252002.000000000000000,Block 2002, Block Group 2, Census Tract 101.25, Fulton County, Georgia,179,33,146,143,44,92,0,3
-1,131210103101009.000000000000000,Block 1009, Block Group 1, Census Tract 103.10, Fulton County, Georgia,179,4,175,172,2,164,5,3
-1,131210103112014.000000000000000,Block 2014, Block Group 2, Census Tract 103.11, Fulton County, Georgia,179,4,175,172,0,164,3,3
-1,131210105302036.000000000000000,Block 2036, Block Group 2, Census Tract 105.30, Fulton County, Georgia,179,0,179,177,0,175,0,2
-1,131210105322004.000000000000000,Block 2004, Block Group 2, Census Tract 105.32, Fulton County, Georgia,179,25,154,153,0,153,0,1
-1,131210114172000.000000000000000,Block 2000, Block Group 2, Census Tract 114.17, Fulton County, Georgia,179,10,169,159,145,12,0,10
-1,131210114353011.000000000000000,Block 3011, Block Group 3, Census Tract 114.35, Fulton County, Georgia,179,9,170,163,157,6,0,7
-1,131210115131003.000000000000000,Block 1003, Block Group 1, Census Tract 115.13, Fulton County, Georgia,179,13,166,157,152,2,0,9
-1,131210116443001.000000000000000,Block 3001, Block Group 3, Census Tract 116.44, Fulton County, Georgia,179,28,151,144,93,32,0,7
-1,131210001003008.000000000000000,Block 3008, Block Group 3, Census Tract 1, Fulton County, Georgia,178,5,173,170,161,7,0,3
-1,131210002012003.000000000000000,Block 2003, Block Group 2, Census Tract 2.01, Fulton County, Georgia,178,10,168,163,150,7,0,5
-1,131210070023009.000000000000000,Block 3009, Block Group 3, Census Tract 70.02, Fulton County, Georgia,178,2,176,176,13,163,0,0
-1,131210077032000.000000000000000,Block 2000, Block Group 2, Census Tract 77.03, Fulton County, Georgia,178,5,173,171,0,171,0,2
-1,131210082043011.000000000000000,Block 3011, Block Group 3, Census Tract 82.04, Fulton County, Georgia,178,0,178,177,0,177,0,1
-1,131210105264006.000000000000000,Block 4006, Block Group 4, Census Tract 105.26, Fulton County, Georgia,178,4,174,170,5,162,0,4
-1,131210105293023.000000000000000,Block 3023, Block Group 3, Census Tract 105.29, Fulton County, Georgia,178,1,177,174,2,172,0,3
-1,131210111001020.000000000000000,Block 1020, Block Group 1, Census Tract 111, Fulton County, Georgia,178,8,170,170,89,76,0,0
-1,131210114234000.000000000000000,Block 4000, Block Group 4, Census Tract 114.23, Fulton County, Georgia,178,14,164,156,120,19,5,8
-1,131210116582012.000000000000000,Block 2012, Block Group 2, Census Tract 116.58, Fulton County, Georgia,178,21,157,146,66,12,4,11
-1,131210078081003.000000000000000,Block 1003, Block Group 1, Census Tract 78.08, Fulton County, Georgia,177,9,168,167,0,165,0,1
-1,131210102172006.000000000000000,Block 2006, Block Group 2, Census Tract 102.17, Fulton County, Georgia,177,14,163,158,132,11,0,5
-1,131210103083012.000000000000000,Block 3012, Block Group 3, Census Tract 103.08, Fulton County, Georgia,177,2,175,173,1,170,0,2
-1,131210105291016.000000000000000,Block 1016, Block Group 1, Census Tract 105.29, Fulton County, Georgia,177,8,169,166,3,159,4,3
-1,131210105392023.000000000000000,Block 2023, Block Group 2, Census Tract 105.39, Fulton County, Georgia,177,7,170,166,2,164,0,4
-1,131210114241008.000000000000000,Block 1008, Block Group 1, Census Tract 114.24, Fulton County, Georgia,177,6,171,148,110,22,3,23
-1,131210114281002.000000000000000,Block 1002, Block Group 1, Census Tract 114.28, Fulton County, Georgia,177,18,159,153,131,11,0,6
-1,131210066021003.000000000000000,Block 1003, Block Group 1, Census Tract 66.02, Fulton County, Georgia,176,2,174,173,14,159,0,1
-1,131210083022003.000000000000000,Block 2003, Block Group 2, Census Tract 83.02, Fulton County, Georgia,176,4,172,171,3,167,1,1
-1,131210114212002.000000000000000,Block 2002, Block Group 2, Census Tract 114.21, Fulton County, Georgia,176,21,155,147,73,50,5,8
-1,131210114421002.000000000000000,Block 1002, Block Group 1, Census Tract 114.42, Fulton County, Georgia,176,4,172,168,102,53,0,4
-1,131210116413004.000000000000000,Block 3004, Block Group 3, Census Tract 116.41, Fulton County, Georgia,176,8,168,160,154,1,0,8
-1,131210101241000.000000000000000,Block 1000, Block Group 1, Census Tract 101.24, Fulton County, Georgia,175,45,130,121,46,69,1,9
-1,131210103071006.000000000000000,Block 1006, Block Group 1, Census Tract 103.07, Fulton County, Georgia,175,0,175,171,5,165,0,4
-1,131210113073007.000000000000000,Block 3007, Block Group 3, Census Tract 113.07, Fulton County, Georgia,175,2,173,170,5,162,2,3
-1,131210115073000.000000000000000,Block 3000, Block Group 3, Census Tract 115.07, Fulton County, Georgia,175,8,167,159,151,3,0,8
-1,131210116293005.000000000000000,Block 3005, Block Group 3, Census Tract 116.29, Fulton County, Georgia,175,5,170,164,60,4,0,6
-1,131210116411005.000000000000000,Block 1005, Block Group 1, Census Tract 116.41, Fulton County, Georgia,175,6,169,157,135,0,0,12
-1,131210116462019.000000000000000,Block 2019, Block Group 2, Census Tract 116.46, Fulton County, Georgia,175,5,170,158,101,33,3,12
-1,131210116493020.000000000000000,Block 3020, Block Group 3, Census Tract 116.49, Fulton County, Georgia,175,8,167,160,27,15,0,7
-1,131210076031005.000000000000000,Block 1005, Block Group 1, Census Tract 76.03, Fulton County, Georgia,174,5,169,168,0,167,0,1
-1,131210093011007.000000000000000,Block 1007, Block Group 1, Census Tract 93.01, Fulton County, Georgia,174,6,168,167,154,12,0,1
-1,131210103072009.000000000000000,Block 2009, Block Group 2, Census Tract 103.07, Fulton County, Georgia,174,6,168,148,5,136,6,20
-1,131210103152005.000000000000000,Block 2005, Block Group 2, Census Tract 103.15, Fulton County, Georgia,174,11,163,162,8,154,0,1
-1,131210105173003.000000000000000,Block 3003, Block Group 3, Census Tract 105.17, Fulton County, Georgia,174,3,171,170,2,168,0,1
-1,131210114363003.000000000000000,Block 3003, Block Group 3, Census Tract 114.36, Fulton County, Georgia,174,7,167,166,155,7,0,1
-1,131210114411000.000000000000000,Block 1000, Block Group 1, Census Tract 114.41, Fulton County, Georgia,174,6,168,155,148,3,2,13
-1,131210001001007.000000000000000,Block 1007, Block Group 1, Census Tract 1, Fulton County, Georgia,173,2,171,168,166,0,0,3
-1,131210098031008.000000000000000,Block 1008, Block Group 1, Census Tract 98.03, Fulton County, Georgia,173,10,163,158,150,5,3,5
-1,131210101202006.000000000000000,Block 2006, Block Group 2, Census Tract 101.20, Fulton County, Georgia,173,12,161,156,126,27,0,5
-1,131210102042008.000000000000000,Block 2008, Block Group 2, Census Tract 102.04, Fulton County, Georgia,173,1,172,169,151,12,0,3
-1,131210102113001.000000000000000,Block 3001, Block Group 3, Census Tract 102.11, Fulton County, Georgia,173,8,165,164,159,1,0,1
-1,131210106031005.000000000000000,Block 1005, Block Group 1, Census Tract 106.03, Fulton County, Georgia,173,6,167,163,4,159,0,4
-1,131210108024022.000000000000000,Block 4022, Block Group 4, Census Tract 108.02, Fulton County, Georgia,173,128,45,43,17,23,0,2
-1,131210114172003.000000000000000,Block 2003, Block Group 2, Census Tract 114.17, Fulton County, Georgia,173,27,146,146,137,3,0,0
-1,131210114172010.000000000000000,Block 2010, Block Group 2, Census Tract 114.17, Fulton County, Georgia,173,11,162,150,137,11,2,12
-1,131210038002016.000000000000000,Block 2016, Block Group 2, Census Tract 38, Fulton County, Georgia,172,2,170,169,5,164,0,1
-1,131210048002001.000000000000000,Block 2001, Block Group 2, Census Tract 48, Fulton County, Georgia,172,19,153,150,8,128,2,3
-1,131210097003021.000000000000000,Block 3021, Block Group 3, Census Tract 97, Fulton County, Georgia,172,2,170,162,149,5,0,8
-1,131210098031003.000000000000000,Block 1003, Block Group 1, Census Tract 98.03, Fulton County, Georgia,172,10,162,156,144,0,2,6
-1,131210100051016.000000000000000,Block 1016, Block Group 1, Census Tract 100.05, Fulton County, Georgia,172,3,169,161,156,4,0,8
-1,131210105323003.000000000000000,Block 3003, Block Group 3, Census Tract 105.32, Fulton County, Georgia,172,2,170,165,8,144,9,5
-1,131210114361003.000000000000000,Block 1003, Block Group 1, Census Tract 114.36, Fulton County, Georgia,172,15,157,153,147,4,0,4
-1,131210115092009.000000000000000,Block 2009, Block Group 2, Census Tract 115.09, Fulton County, Georgia,172,16,156,154,151,0,1,2
-1,131210115112009.000000000000000,Block 2009, Block Group 2, Census Tract 115.11, Fulton County, Georgia,172,4,168,155,128,19,0,13
-1,131210116292003.000000000000000,Block 2003, Block Group 2, Census Tract 116.29, Fulton County, Georgia,172,7,165,158,54,10,0,7
-1,131210042001004.000000000000000,Block 1004, Block Group 1, Census Tract 42, Fulton County, Georgia,171,2,169,165,5,160,0,4
-1,131210075001018.000000000000000,Block 1018, Block Group 1, Census Tract 75, Fulton County, Georgia,171,10,161,157,13,135,0,4
-1,131210089052006.000000000000000,Block 2006, Block Group 2, Census Tract 89.05, Fulton County, Georgia,171,8,163,153,114,20,2,10
-1,131210098031010.000000000000000,Block 1010, Block Group 1, Census Tract 98.03, Fulton County, Georgia,171,4,167,161,144,5,2,6
-1,131210105251002.000000000000000,Block 1002, Block Group 1, Census Tract 105.25, Fulton County, Georgia,171,0,171,166,6,159,0,5
-1,131210105323008.000000000000000,Block 3008, Block Group 3, Census Tract 105.32, Fulton County, Georgia,171,1,170,169,8,158,3,1
-1,131210114174007.000000000000000,Block 4007, Block Group 4, Census Tract 114.17, Fulton County, Georgia,171,1,170,163,157,3,2,7
-1,131210115112008.000000000000000,Block 2008, Block Group 2, Census Tract 115.11, Fulton County, Georgia,171,7,164,157,110,0,0,7
-1,131210115152000.000000000000000,Block 2000, Block Group 2, Census Tract 115.15, Fulton County, Georgia,171,3,168,167,138,17,0,1
-1,131210116402013.000000000000000,Block 2013, Block Group 2, Census Tract 116.40, Fulton County, Georgia,171,9,162,161,133,17,1,1
-1,131210015011008.000000000000000,Block 1008, Block Group 1, Census Tract 15.01, Fulton County, Georgia,170,11,159,154,137,14,0,5
-1,131210032001003.000000000000000,Block 1003, Block Group 1, Census Tract 32, Fulton County, Georgia,170,17,153,147,133,13,0,6
-1,131210060002002.000000000000000,Block 2002, Block Group 2, Census Tract 60, Fulton County, Georgia,170,3,167,163,37,126,0,4
-1,131210088021003.000000000000000,Block 1003, Block Group 1, Census Tract 88.02, Fulton County, Georgia,170,8,162,155,107,30,0,7
-1,131210089091008.000000000000000,Block 1008, Block Group 1, Census Tract 89.09, Fulton County, Georgia,170,12,158,149,122,25,0,9
-1,131210091033003.000000000000000,Block 3003, Block Group 3, Census Tract 91.03, Fulton County, Georgia,170,8,162,156,116,27,0,6
-1,131210095013001.000000000000000,Block 3001, Block Group 3, Census Tract 95.01, Fulton County, Georgia,170,2,168,168,166,1,0,0
-1,131210100052022.000000000000000,Block 2022, Block Group 2, Census Tract 100.05, Fulton County, Georgia,170,6,164,153,141,0,0,11
-1,131210101373002.000000000000000,Block 3002, Block Group 3, Census Tract 101.37, Fulton County, Georgia,170,95,75,73,24,39,0,2
-1,131210105192012.000000000000000,Block 2012, Block Group 2, Census Tract 105.19, Fulton County, Georgia,170,3,167,159,8,151,0,8
-1,131210115072006.000000000000000,Block 2006, Block Group 2, Census Tract 115.07, Fulton County, Georgia,170,14,156,153,149,0,0,3
-1,131210115152005.000000000000000,Block 2005, Block Group 2, Census Tract 115.15, Fulton County, Georgia,170,4,166,153,141,4,0,13
-1,131210116401016.000000000000000,Block 1016, Block Group 1, Census Tract 116.40, Fulton County, Georgia,170,17,153,150,136,2,2,3
-1,131210116402036.000000000000000,Block 2036, Block Group 2, Census Tract 116.40, Fulton County, Georgia,170,8,162,157,132,17,2,5
-1,131210015021007.000000000000000,Block 1007, Block Group 1, Census Tract 15.02, Fulton County, Georgia,169,110,59,55,48,0,0,4
-1,131210015022001.000000000000000,Block 2001, Block Group 2, Census Tract 15.02, Fulton County, Georgia,169,13,156,154,146,3,0,2
-1,131210019022002.000000000000000,Block 2002, Block Group 2, Census Tract 19.02, Fulton County, Georgia,169,7,162,161,117,29,0,1
-1,131210078102003.000000000000000,Block 2003, Block Group 2, Census Tract 78.10, Fulton County, Georgia,169,2,167,167,0,166,0,0
-1,131210086013001.000000000000000,Block 3001, Block Group 3, Census Tract 86.01, Fulton County, Georgia,169,4,165,160,9,150,1,5
-1,131210087022007.000000000000000,Block 2007, Block Group 2, Census Tract 87.02, Fulton County, Georgia,169,10,159,158,20,135,3,1
-1,131210105343001.000000000000000,Block 3001, Block Group 3, Census Tract 105.34, Fulton County, Georgia,169,8,161,161,6,149,1,0
-1,131210106042002.000000000000000,Block 2002, Block Group 2, Census Tract 106.04, Fulton County, Georgia,169,2,167,162,0,162,0,5
-1,131210114164008.000000000000000,Block 4008, Block Group 4, Census Tract 114.16, Fulton County, Georgia,169,13,156,149,127,7,7,7
-1,131210114222001.000000000000000,Block 2001, Block Group 2, Census Tract 114.22, Fulton County, Georgia,169,9,160,156,121,26,1,4
-1,131210114362007.000000000000000,Block 2007, Block Group 2, Census Tract 114.36, Fulton County, Georgia,169,20,149,145,116,18,0,4
-1,131210115142010.000000000000000,Block 2010, Block Group 2, Census Tract 115.14, Fulton County, Georgia,169,12,157,150,145,4,0,7
-1,131210002022005.000000000000000,Block 2005, Block Group 2, Census Tract 2.02, Fulton County, Georgia,168,12,156,156,152,0,0,0
-1,131210010012020.000000000000000,Block 2020, Block Group 2, Census Tract 10.01, Fulton County, Georgia,168,4,164,159,134,7,1,5
-1,131210017012001.000000000000000,Block 2001, Block Group 2, Census Tract 17.01, Fulton County, Georgia,168,10,158,152,39,102,1,6
-1,131210043003003.000000000000000,Block 3003, Block Group 3, Census Tract 43, Fulton County, Georgia,168,0,168,164,63,101,0,4
-1,131210063001002.000000000000000,Block 1002, Block Group 1, Census Tract 63, Fulton County, Georgia,168,4,164,162,0,162,0,2
-1,131210067011006.000000000000000,Block 1006, Block Group 1, Census Tract 67.01, Fulton County, Georgia,168,1,167,164,0,156,8,3
-1,131210070022001.000000000000000,Block 2001, Block Group 2, Census Tract 70.02, Fulton County, Georgia,168,11,157,157,8,149,0,0
-1,131210072003001.000000000000000,Block 3001, Block Group 3, Census Tract 72, Fulton County, Georgia,168,2,166,166,2,164,0,0
-1,131210100041012.000000000000000,Block 1012, Block Group 1, Census Tract 100.04, Fulton County, Georgia,168,4,164,155,129,4,0,9
-1,131210100071012.000000000000000,Block 1012, Block Group 1, Census Tract 100.07, Fulton County, Georgia,168,0,168,166,144,10,1,2
-1,131210102231006.000000000000000,Block 1006, Block Group 1, Census Tract 102.23, Fulton County, Georgia,168,6,162,160,147,0,0,2
-1,131210114311005.000000000000000,Block 1005, Block Group 1, Census Tract 114.31, Fulton County, Georgia,168,127,41,40,21,18,1,1
-1,131210116301002.000000000000000,Block 1002, Block Group 1, Census Tract 116.30, Fulton County, Georgia,168,16,152,141,52,4,0,11
-1,131210116602025.000000000000000,Block 2025, Block Group 2, Census Tract 116.60, Fulton County, Georgia,168,1,167,157,139,13,0,10
-1,131210120001013.000000000000000,Block 1013, Block Group 1, Census Tract 120, Fulton County, Georgia,168,4,164,160,13,147,0,4
-1,131210013022008.000000000000000,Block 2008, Block Group 2, Census Tract 13.02, Fulton County, Georgia,167,11,156,139,121,7,0,17
-1,131210055012012.000000000000000,Block 2012, Block Group 2, Census Tract 55.01, Fulton County, Georgia,167,7,160,158,80,76,0,2
-1,131210089082005.000000000000000,Block 2005, Block Group 2, Census Tract 89.08, Fulton County, Georgia,167,19,148,137,55,64,0,11
-1,131210114161011.000000000000000,Block 1011, Block Group 1, Census Tract 114.16, Fulton County, Georgia,167,11,156,150,148,1,0,6
-1,131210115071004.000000000000000,Block 1004, Block Group 1, Census Tract 115.07, Fulton County, Georgia,167,21,146,136,123,7,6,10
-1,131210115102012.000000000000000,Block 2012, Block Group 2, Census Tract 115.10, Fulton County, Georgia,167,3,164,161,126,0,0,3
-1,131210025003007.000000000000000,Block 3007, Block Group 3, Census Tract 25, Fulton County, Georgia,166,1,165,162,3,155,0,3
-1,131210041003013.000000000000000,Block 3013, Block Group 3, Census Tract 41, Fulton County, Georgia,166,3,163,162,39,120,3,1
-1,131210082022000.000000000000000,Block 2000, Block Group 2, Census Tract 82.02, Fulton County, Georgia,166,2,164,160,7,150,3,4
-1,131210099003003.000000000000000,Block 3003, Block Group 3, Census Tract 99, Fulton County, Georgia,166,9,157,155,151,0,0,2
-1,131210115082016.000000000000000,Block 2016, Block Group 2, Census Tract 115.08, Fulton County, Georgia,166,18,148,146,134,2,0,2
-1,131210116411017.000000000000000,Block 1017, Block Group 1, Census Tract 116.41, Fulton County, Georgia,166,9,157,150,60,1,0,7
-1,131210116452002.000000000000000,Block 2002, Block Group 2, Census Tract 116.45, Fulton County, Georgia,166,0,166,153,76,26,1,13
-1,131210002022002.000000000000000,Block 2002, Block Group 2, Census Tract 2.02, Fulton County, Georgia,165,5,160,159,148,9,0,1
-1,131210002023003.000000000000000,Block 3003, Block Group 3, Census Tract 2.02, Fulton County, Georgia,165,0,165,158,139,8,0,7
-1,131210014001004.000000000000000,Block 1004, Block Group 1, Census Tract 14, Fulton County, Georgia,165,15,150,148,137,0,0,2
-1,131210097003000.000000000000000,Block 3000, Block Group 3, Census Tract 97, Fulton County, Georgia,165,3,162,158,146,3,3,4
-1,131210105212002.000000000000000,Block 2002, Block Group 2, Census Tract 105.21, Fulton County, Georgia,165,1,164,156,4,152,0,8
-1,131210105273011.000000000000000,Block 3011, Block Group 3, Census Tract 105.27, Fulton County, Georgia,165,20,145,138,16,113,0,7
-1,131210105322007.000000000000000,Block 2007, Block Group 2, Census Tract 105.32, Fulton County, Georgia,165,5,160,154,0,153,1,6
-1,131210105332013.000000000000000,Block 2013, Block Group 2, Census Tract 105.33, Fulton County, Georgia,165,4,161,159,4,154,0,2
-1,131210116322000.000000000000000,Block 2000, Block Group 2, Census Tract 116.32, Fulton County, Georgia,165,11,154,146,17,16,2,8
-1,131210116341005.000000000000000,Block 1005, Block Group 1, Census Tract 116.34, Fulton County, Georgia,165,21,144,130,44,39,7,14
-1,131210116381002.000000000000000,Block 1002, Block Group 1, Census Tract 116.38, Fulton County, Georgia,165,16,149,138,101,7,0,11
-1,131210019021017.000000000000000,Block 1017, Block Group 1, Census Tract 19.02, Fulton County, Georgia,164,9,155,155,52,87,0,0
-1,131210080001000.000000000000000,Block 1000, Block Group 1, Census Tract 80, Fulton County, Georgia,164,1,163,160,11,148,0,3
-1,131210104022065.000000000000000,Block 2065, Block Group 2, Census Tract 104.02, Fulton County, Georgia,164,10,154,147,12,135,0,7
-1,131210105191002.000000000000000,Block 1002, Block Group 1, Census Tract 105.19, Fulton County, Georgia,164,44,120,110,52,55,2,10
-1,131210114213001.000000000000000,Block 3001, Block Group 3, Census Tract 114.21, Fulton County, Georgia,164,41,123,119,47,57,6,4
-1,131210115091012.000000000000000,Block 1012, Block Group 1, Census Tract 115.09, Fulton County, Georgia,164,3,161,155,143,8,0,6
-1,131210116383002.000000000000000,Block 3002, Block Group 3, Census Tract 116.38, Fulton County, Georgia,164,9,155,151,112,19,0,4
-1,131210065001006.000000000000000,Block 1006, Block Group 1, Census Tract 65, Fulton County, Georgia,163,2,161,158,42,114,0,3
-1,131210082043000.000000000000000,Block 3000, Block Group 3, Census Tract 82.04, Fulton County, Georgia,163,5,158,156,2,154,0,2
-1,131210093021006.000000000000000,Block 1006, Block Group 1, Census Tract 93.02, Fulton County, Georgia,163,9,154,146,132,5,0,8
-1,131210101312003.000000000000000,Block 2003, Block Group 2, Census Tract 101.31, Fulton County, Georgia,163,5,158,154,107,16,1,4
-1,131210114161010.000000000000000,Block 1010, Block Group 1, Census Tract 114.16, Fulton County, Georgia,163,15,148,145,119,5,2,3
-1,131210115111009.000000000000000,Block 1009, Block Group 1, Census Tract 115.11, Fulton County, Georgia,163,5,158,149,111,6,0,9
-1,131210116431000.000000000000000,Block 1000, Block Group 1, Census Tract 116.43, Fulton County, Georgia,163,20,143,121,38,36,0,22
-1,131210015011003.000000000000000,Block 1003, Block Group 1, Census Tract 15.01, Fulton County, Georgia,162,13,149,140,108,18,0,9
-1,131210040003000.000000000000000,Block 3000, Block Group 3, Census Tract 40, Fulton County, Georgia,162,2,160,159,9,147,3,1
-1,131210098022012.000000000000000,Block 2012, Block Group 2, Census Tract 98.02, Fulton County, Georgia,162,9,153,142,79,48,0,11
-1,131210099001004.000000000000000,Block 1004, Block Group 1, Census Tract 99, Fulton County, Georgia,162,5,157,151,148,2,0,6
-1,131210102042009.000000000000000,Block 2009, Block Group 2, Census Tract 102.04, Fulton County, Georgia,162,2,160,157,150,0,2,3
-1,131210104021040.000000000000000,Block 1040, Block Group 1, Census Tract 104.02, Fulton County, Georgia,162,3,159,159,114,45,0,0
-1,131210113091002.000000000000000,Block 1002, Block Group 1, Census Tract 113.09, Fulton County, Georgia,162,6,156,154,10,143,1,2
-1,131210114214007.000000000000000,Block 4007, Block Group 4, Census Tract 114.21, Fulton County, Georgia,162,69,93,86,62,8,0,7
-1,131210114373005.000000000000000,Block 3005, Block Group 3, Census Tract 114.37, Fulton County, Georgia,162,17,145,143,132,11,0,2
-1,131210114412005.000000000000000,Block 2005, Block Group 2, Census Tract 114.41, Fulton County, Georgia,162,27,135,115,94,10,1,20
-1,131210115101019.000000000000000,Block 1019, Block Group 1, Census Tract 115.10, Fulton County, Georgia,162,12,150,148,142,5,0,2
-1,131210116372021.000000000000000,Block 2021, Block Group 2, Census Tract 116.37, Fulton County, Georgia,162,12,150,144,120,8,3,6
-1,131210013022012.000000000000000,Block 2012, Block Group 2, Census Tract 13.02, Fulton County, Georgia,161,9,152,141,123,11,0,11
-1,131210076041003.000000000000000,Block 1003, Block Group 1, Census Tract 76.04, Fulton County, Georgia,161,1,160,160,0,159,0,0
-1,131210098023010.000000000000000,Block 3010, Block Group 3, Census Tract 98.02, Fulton County, Georgia,161,8,153,144,124,10,0,9
-1,131210101081000.000000000000000,Block 1000, Block Group 1, Census Tract 101.08, Fulton County, Georgia,161,10,151,146,121,5,4,5
-1,131210103081002.000000000000000,Block 1002, Block Group 1, Census Tract 103.08, Fulton County, Georgia,161,2,159,155,8,145,2,4
-1,131210105182009.000000000000000,Block 2009, Block Group 2, Census Tract 105.18, Fulton County, Georgia,161,2,159,159,0,158,1,0
-1,131210116441003.000000000000000,Block 1003, Block Group 1, Census Tract 116.44, Fulton County, Georgia,161,13,148,139,54,31,2,9
-1,131210024001000.000000000000000,Block 1000, Block Group 1, Census Tract 24, Fulton County, Georgia,160,2,158,156,3,150,2,2
-1,131210071002017.000000000000000,Block 2017, Block Group 2, Census Tract 71, Fulton County, Georgia,160,5,155,152,8,144,0,3
-1,131210086014011.000000000000000,Block 4011, Block Group 4, Census Tract 86.01, Fulton County, Georgia,160,1,159,156,1,155,0,3
-1,131210098042006.000000000000000,Block 2006, Block Group 2, Census Tract 98.04, Fulton County, Georgia,160,0,160,158,130,2,1,2
-1,131210101341004.000000000000000,Block 1004, Block Group 1, Census Tract 101.34, Fulton County, Georgia,160,19,141,136,53,77,1,5
-1,131210102121007.000000000000000,Block 1007, Block Group 1, Census Tract 102.12, Fulton County, Georgia,160,7,153,152,124,12,0,1
-1,131210103112007.000000000000000,Block 2007, Block Group 2, Census Tract 103.11, Fulton County, Georgia,160,0,160,155,2,152,0,5
-1,131210105173011.000000000000000,Block 3011, Block Group 3, Census Tract 105.17, Fulton County, Georgia,160,1,159,147,0,147,0,12
-1,131210105191050.000000000000000,Block 1050, Block Group 1, Census Tract 105.19, Fulton County, Georgia,160,17,143,136,10,126,0,7
-1,131210105222024.000000000000000,Block 2024, Block Group 2, Census Tract 105.22, Fulton County, Georgia,160,2,158,157,3,153,1,1
-1,131210105343022.000000000000000,Block 3022, Block Group 3, Census Tract 105.34, Fulton County, Georgia,160,37,123,118,5,113,0,5
-1,131210114162003.000000000000000,Block 2003, Block Group 2, Census Tract 114.16, Fulton County, Georgia,160,15,145,138,99,23,1,7
-1,131210116431001.000000000000000,Block 1001, Block Group 1, Census Tract 116.43, Fulton County, Georgia,160,7,153,152,21,26,0,1
-1,131210116462012.000000000000000,Block 2012, Block Group 2, Census Tract 116.46, Fulton County, Georgia,160,12,148,138,51,28,0,10
-1,131210001001001.000000000000000,Block 1001, Block Group 1, Census Tract 1, Fulton County, Georgia,159,0,159,157,147,0,1,2
-1,131210029002010.000000000000000,Block 2010, Block Group 2, Census Tract 29, Fulton County, Georgia,159,12,147,144,108,32,0,3
-1,131210089061003.000000000000000,Block 1003, Block Group 1, Census Tract 89.06, Fulton County, Georgia,159,1,158,148,145,0,0,10
-1,131210097003005.000000000000000,Block 3005, Block Group 3, Census Tract 97, Fulton County, Georgia,159,3,156,151,144,7,0,5
-1,131210105221004.000000000000000,Block 1004, Block Group 1, Census Tract 105.22, Fulton County, Georgia,159,2,157,151,0,147,1,6
-1,131210106042000.000000000000000,Block 2000, Block Group 2, Census Tract 106.04, Fulton County, Georgia,159,10,149,145,10,134,1,4
-1,131210114383005.000000000000000,Block 3005, Block Group 3, Census Tract 114.38, Fulton County, Georgia,159,34,125,110,47,52,0,15
-1,131210116332001.000000000000000,Block 2001, Block Group 2, Census Tract 116.33, Fulton County, Georgia,159,12,147,142,86,18,3,5
-1,131210123003006.000000000000000,Block 3006, Block Group 3, Census Tract 123, Fulton County, Georgia,159,5,154,153,1,152,0,1
-1,131210021002001.000000000000000,Block 2001, Block Group 2, Census Tract 21, Fulton County, Georgia,158,11,147,145,9,129,1,2
-1,131210055031003.000000000000000,Block 1003, Block Group 1, Census Tract 55.03, Fulton County, Georgia,158,5,153,149,0,149,0,4
-1,131210102201004.000000000000000,Block 1004, Block Group 1, Census Tract 102.20, Fulton County, Georgia,158,6,152,133,124,0,0,19
-1,131210103151006.000000000000000,Block 1006, Block Group 1, Census Tract 103.15, Fulton County, Georgia,158,0,158,156,3,153,0,2
-1,131210105293021.000000000000000,Block 3021, Block Group 3, Census Tract 105.29, Fulton County, Georgia,158,4,154,151,2,149,0,3
-1,131210113014001.000000000000000,Block 4001, Block Group 4, Census Tract 113.01, Fulton County, Georgia,158,31,127,121,11,106,1,6
-1,131210116322003.000000000000000,Block 2003, Block Group 2, Census Tract 116.32, Fulton County, Georgia,158,4,154,148,30,7,0,6
-1,131210116381000.000000000000000,Block 1000, Block Group 1, Census Tract 116.38, Fulton County, Georgia,158,12,146,145,111,5,0,1
-1,131210116501014.000000000000000,Block 1014, Block Group 1, Census Tract 116.50, Fulton County, Georgia,158,0,158,141,118,9,0,17
-1,131210116592000.000000000000000,Block 2000, Block Group 2, Census Tract 116.59, Fulton County, Georgia,158,23,135,132,55,33,3,3
-1,131210005021001.000000000000000,Block 1001, Block Group 1, Census Tract 5.02, Fulton County, Georgia,157,8,149,146,75,65,0,3
-1,131210028011002.000000000000000,Block 1002, Block Group 1, Census Tract 28.01, Fulton County, Georgia,157,10,147,139,62,59,8,8
-1,131210031002007.000000000000000,Block 2007, Block Group 2, Census Tract 31, Fulton County, Georgia,157,15,142,131,104,20,0,11
-1,131210036002013.000000000000000,Block 2013, Block Group 2, Census Tract 36, Fulton County, Georgia,157,9,148,133,12,121,0,15
-1,131210090022003.000000000000000,Block 2003, Block Group 2, Census Tract 90.02, Fulton County, Georgia,157,1,156,148,148,0,0,8
-1,131210100052008.000000000000000,Block 2008, Block Group 2, Census Tract 100.05, Fulton County, Georgia,157,5,152,151,141,1,1,1
-1,131210101302002.000000000000000,Block 2002, Block Group 2, Census Tract 101.30, Fulton County, Georgia,157,9,148,147,128,3,1,1
-1,131210105171012.000000000000000,Block 1012, Block Group 1, Census Tract 105.17, Fulton County, Georgia,157,13,144,144,3,141,0,0
-1,131210105331002.000000000000000,Block 1002, Block Group 1, Census Tract 105.33, Fulton County, Georgia,157,5,152,147,0,146,0,5
-1,131210001003004.000000000000000,Block 3004, Block Group 3, Census Tract 1, Fulton County, Georgia,156,6,150,143,140,3,0,7
-1,131210080005002.000000000000000,Block 5002, Block Group 5, Census Tract 80, Fulton County, Georgia,156,3,153,152,4,148,0,1
-1,131210082041006.000000000000000,Block 1006, Block Group 1, Census Tract 82.04, Fulton County, Georgia,156,0,156,156,0,153,2,0
-1,131210101273001.000000000000000,Block 3001, Block Group 3, Census Tract 101.27, Fulton County, Georgia,156,17,139,129,31,76,0,10
-1,131210105253006.000000000000000,Block 3006, Block Group 3, Census Tract 105.25, Fulton County, Georgia,156,4,152,140,0,135,0,12
-1,131210114293003.000000000000000,Block 3003, Block Group 3, Census Tract 114.29, Fulton County, Georgia,156,18,138,127,116,9,0,11
-1,131210114321002.000000000000000,Block 1002, Block Group 1, Census Tract 114.32, Fulton County, Georgia,156,32,124,121,28,80,0,3
-1,131210114363006.000000000000000,Block 3006, Block Group 3, Census Tract 114.36, Fulton County, Georgia,156,4,152,142,130,3,0,10
-1,131210005011009.000000000000000,Block 1009, Block Group 1, Census Tract 5.01, Fulton County, Georgia,155,7,148,134,76,37,0,14
-1,131210012032007.000000000000000,Block 2007, Block Group 2, Census Tract 12.03, Fulton County, Georgia,155,20,135,129,100,14,0,6
-1,131210014001007.000000000000000,Block 1007, Block Group 1, Census Tract 14, Fulton County, Georgia,155,4,151,140,135,1,0,11
-1,131210015022000.000000000000000,Block 2000, Block Group 2, Census Tract 15.02, Fulton County, Georgia,155,12,143,141,127,10,0,2
-1,131210017022010.000000000000000,Block 2010, Block Group 2, Census Tract 17.02, Fulton County, Georgia,155,15,140,139,101,22,0,1
-1,131210077111002.000000000000000,Block 1002, Block Group 1, Census Tract 77.11, Fulton County, Georgia,155,2,153,151,1,150,0,2
-1,131210079002006.000000000000000,Block 2006, Block Group 2, Census Tract 79, Fulton County, Georgia,155,1,154,152,0,150,0,2
-1,131210080005008.000000000000000,Block 5008, Block Group 5, Census Tract 80, Fulton County, Georgia,155,0,155,154,6,148,0,1
-1,131210097003009.000000000000000,Block 3009, Block Group 3, Census Tract 97, Fulton County, Georgia,155,1,154,154,152,2,0,0
-1,131210099003008.000000000000000,Block 3008, Block Group 3, Census Tract 99, Fulton County, Georgia,155,8,147,146,146,0,0,1
-1,131210103062005.000000000000000,Block 2005, Block Group 2, Census Tract 103.06, Fulton County, Georgia,155,0,155,148,0,146,2,7
-1,131210105401031.000000000000000,Block 1031, Block Group 1, Census Tract 105.40, Fulton County, Georgia,155,51,104,100,13,86,0,4
-1,131210113105006.000000000000000,Block 5006, Block Group 5, Census Tract 113.10, Fulton County, Georgia,155,12,143,143,0,143,0,0
-1,131210115103005.000000000000000,Block 3005, Block Group 3, Census Tract 115.10, Fulton County, Georgia,155,6,149,146,103,12,0,3
-1,131210116411004.000000000000000,Block 1004, Block Group 1, Census Tract 116.41, Fulton County, Georgia,155,18,137,126,117,5,0,11
-1,131210080001001.000000000000000,Block 1001, Block Group 1, Census Tract 80, Fulton County, Georgia,154,4,150,149,0,149,0,1
-1,131210103052004.000000000000000,Block 2004, Block Group 2, Census Tract 103.05, Fulton County, Georgia,154,0,154,149,0,146,1,5
-1,131210116602007.000000000000000,Block 2007, Block Group 2, Census Tract 116.60, Fulton County, Georgia,154,3,151,141,89,18,3,10
-1,131210002021003.000000000000000,Block 1003, Block Group 1, Census Tract 2.02, Fulton County, Georgia,153,17,136,130,108,9,0,6
-1,131210006012009.000000000000000,Block 2009, Block Group 2, Census Tract 6.01, Fulton County, Georgia,153,3,150,147,75,0,0,3
-1,131210026002018.000000000000000,Block 2018, Block Group 2, Census Tract 26, Fulton County, Georgia,153,7,146,143,2,140,0,3
-1,131210038002007.000000000000000,Block 2007, Block Group 2, Census Tract 38, Fulton County, Georgia,153,0,153,147,0,147,0,6
-1,131210086022008.000000000000000,Block 2008, Block Group 2, Census Tract 86.02, Fulton County, Georgia,153,14,139,137,0,137,0,2
-1,131210101342001.000000000000000,Block 2001, Block Group 2, Census Tract 101.34, Fulton County, Georgia,153,27,126,126,24,70,0,0
-1,131210102123002.000000000000000,Block 3002, Block Group 3, Census Tract 102.12, Fulton County, Georgia,153,14,139,134,120,2,0,5
-1,131210102201006.000000000000000,Block 1006, Block Group 1, Census Tract 102.20, Fulton County, Georgia,153,12,141,132,126,3,0,9
-1,131210113071002.000000000000000,Block 1002, Block Group 1, Census Tract 113.07, Fulton County, Georgia,153,1,152,149,0,147,0,3
-1,131210116472013.000000000000000,Block 2013, Block Group 2, Census Tract 116.47, Fulton County, Georgia,153,21,132,129,111,16,0,3
-1,131210030002003.000000000000000,Block 2003, Block Group 2, Census Tract 30, Fulton County, Georgia,152,4,148,141,131,10,0,7
-1,131210076023008.000000000000000,Block 3008, Block Group 3, Census Tract 76.02, Fulton County, Georgia,152,5,147,139,6,131,0,8
-1,131210090022009.000000000000000,Block 2009, Block Group 2, Census Tract 90.02, Fulton County, Georgia,152,1,151,151,149,1,0,0
-1,131210094061003.000000000000000,Block 1003, Block Group 1, Census Tract 94.06, Fulton County, Georgia,152,7,145,142,59,75,2,3
-1,131210102162014.000000000000000,Block 2014, Block Group 2, Census Tract 102.16, Fulton County, Georgia,152,7,145,137,133,2,1,8
-1,131210103051023.000000000000000,Block 1023, Block Group 1, Census Tract 103.05, Fulton County, Georgia,152,2,150,148,0,146,0,2
-1,131210105201011.000000000000000,Block 1011, Block Group 1, Census Tract 105.20, Fulton County, Georgia,152,5,147,146,6,136,0,1
-1,131210116462007.000000000000000,Block 2007, Block Group 2, Census Tract 116.46, Fulton County, Georgia,152,19,133,133,56,50,0,0
-1,131210116503001.000000000000000,Block 3001, Block Group 3, Census Tract 116.50, Fulton County, Georgia,152,15,137,123,76,5,0,14
-1,131210116602020.000000000000000,Block 2020, Block Group 2, Census Tract 116.60, Fulton County, Georgia,152,13,139,138,96,3,0,1
-1,131210093011011.000000000000000,Block 1011, Block Group 1, Census Tract 93.01, Fulton County, Georgia,151,11,140,138,125,8,0,2
-1,131210101062005.000000000000000,Block 2005, Block Group 2, Census Tract 101.06, Fulton County, Georgia,151,19,132,127,122,3,1,5
-1,131210101081005.000000000000000,Block 1005, Block Group 1, Census Tract 101.08, Fulton County, Georgia,151,5,146,138,135,0,0,8
-1,131210102203011.000000000000000,Block 3011, Block Group 3, Census Tract 102.20, Fulton County, Georgia,151,10,141,132,112,5,2,9
-1,131210105263007.000000000000000,Block 3007, Block Group 3, Census Tract 105.26, Fulton County, Georgia,151,3,148,147,1,146,0,1
-1,131210114174001.000000000000000,Block 4001, Block Group 4, Census Tract 114.17, Fulton County, Georgia,151,10,141,130,114,12,0,11
-1,131210114192006.000000000000000,Block 2006, Block Group 2, Census Tract 114.19, Fulton County, Georgia,151,5,146,140,122,5,0,6
-1,131210114234004.000000000000000,Block 4004, Block Group 4, Census Tract 114.23, Fulton County, Georgia,151,4,147,137,121,7,0,10
-1,131210114451000.000000000000000,Block 1000, Block Group 1, Census Tract 114.45, Fulton County, Georgia,151,10,141,140,137,2,1,1
-1,131210115121006.000000000000000,Block 1006, Block Group 1, Census Tract 115.12, Fulton County, Georgia,151,4,147,140,135,0,0,7
-1,131210116331001.000000000000000,Block 1001, Block Group 1, Census Tract 116.33, Fulton County, Georgia,151,7,144,140,29,4,0,4
-1,131210116384005.000000000000000,Block 4005, Block Group 4, Census Tract 116.38, Fulton County, Georgia,151,18,133,122,56,40,9,11
-1,131210001002001.000000000000000,Block 2001, Block Group 2, Census Tract 1, Fulton County, Georgia,150,3,147,144,135,0,0,3
-1,131210052004008.000000000000000,Block 4008, Block Group 4, Census Tract 52, Fulton County, Georgia,150,1,149,146,95,39,0,3
-1,131210072001000.000000000000000,Block 1000, Block Group 1, Census Tract 72, Fulton County, Georgia,150,6,144,143,0,141,2,1
-1,131210090022006.000000000000000,Block 2006, Block Group 2, Census Tract 90.02, Fulton County, Georgia,150,0,150,149,144,4,0,1
-1,131210102162005.000000000000000,Block 2005, Block Group 2, Census Tract 102.16, Fulton County, Georgia,150,4,146,141,133,1,1,5
-1,131210102221001.000000000000000,Block 1001, Block Group 1, Census Tract 102.22, Fulton County, Georgia,150,12,138,131,111,5,3,7
-1,131210105202015.000000000000000,Block 2015, Block Group 2, Census Tract 105.20, Fulton County, Georgia,150,4,146,138,3,132,3,8
-1,131210116352003.000000000000000,Block 2003, Block Group 2, Census Tract 116.35, Fulton County, Georgia,150,2,148,138,32,5,2,10
-1,131210014002006.000000000000000,Block 2006, Block Group 2, Census Tract 14, Fulton County, Georgia,149,10,139,137,100,31,0,2
-1,131210015011004.000000000000000,Block 1004, Block Group 1, Census Tract 15.01, Fulton County, Georgia,149,6,143,137,108,14,6,6
-1,131210029001011.000000000000000,Block 1011, Block Group 1, Census Tract 29, Fulton County, Georgia,149,0,149,145,24,121,0,4
-1,131210069002010.000000000000000,Block 2010, Block Group 2, Census Tract 69, Fulton County, Georgia,149,28,121,117,59,56,0,4
-1,131210077053014.000000000000000,Block 3014, Block Group 3, Census Tract 77.05, Fulton County, Georgia,149,3,146,144,2,141,0,2
-1,131210079003015.000000000000000,Block 3015, Block Group 3, Census Tract 79, Fulton County, Georgia,149,3,146,144,2,142,0,2
-1,131210093011012.000000000000000,Block 1012, Block Group 1, Census Tract 93.01, Fulton County, Georgia,149,8,141,137,136,0,0,4
-1,131210094112006.000000000000000,Block 2006, Block Group 2, Census Tract 94.11, Fulton County, Georgia,149,5,144,130,85,23,1,14
-1,131210101171005.000000000000000,Block 1005, Block Group 1, Census Tract 101.17, Fulton County, Georgia,149,18,131,116,51,55,1,15
-1,131210105352003.000000000000000,Block 2003, Block Group 2, Census Tract 105.35, Fulton County, Georgia,149,35,114,112,9,99,0,2
-1,131210113091000.000000000000000,Block 1000, Block Group 1, Census Tract 113.09, Fulton County, Georgia,149,15,134,133,0,130,1,1
-1,131210116341003.000000000000000,Block 1003, Block Group 1, Census Tract 116.34, Fulton County, Georgia,149,48,101,81,36,28,10,20
-1,131210025003002.000000000000000,Block 3002, Block Group 3, Census Tract 25, Fulton County, Georgia,148,5,143,143,6,135,0,0
-1,131210078073006.000000000000000,Block 3006, Block Group 3, Census Tract 78.07, Fulton County, Georgia,148,8,140,139,1,136,1,1
-1,131210088011027.000000000000000,Block 1027, Block Group 1, Census Tract 88.01, Fulton County, Georgia,148,31,117,113,78,29,0,4
-1,131210101321007.000000000000000,Block 1007, Block Group 1, Census Tract 101.32, Fulton County, Georgia,148,5,143,134,84,38,0,9
-1,131210103072008.000000000000000,Block 2008, Block Group 2, Census Tract 103.07, Fulton County, Georgia,148,9,139,132,0,131,0,7
-1,131210103111027.000000000000000,Block 1027, Block Group 1, Census Tract 103.11, Fulton County, Georgia,148,2,146,144,4,138,2,2
-1,131210105331005.000000000000000,Block 1005, Block Group 1, Census Tract 105.33, Fulton County, Georgia,148,5,143,141,3,133,4,2
-1,131210115112013.000000000000000,Block 2013, Block Group 2, Census Tract 115.11, Fulton County, Georgia,148,26,122,121,100,2,0,1
-1,131210115141012.000000000000000,Block 1012, Block Group 1, Census Tract 115.14, Fulton County, Georgia,148,7,141,136,130,0,0,5
-1,131210116353005.000000000000000,Block 3005, Block Group 3, Census Tract 116.35, Fulton County, Georgia,148,11,137,125,6,0,0,12
-1,131210007001016.000000000000000,Block 1016, Block Group 1, Census Tract 7, Fulton County, Georgia,147,3,144,136,41,89,1,8
-1,131210067011012.000000000000000,Block 1012, Block Group 1, Census Tract 67.01, Fulton County, Georgia,147,6,141,137,4,133,0,4
-1,131210102233008.000000000000000,Block 3008, Block Group 3, Census Tract 102.23, Fulton County, Georgia,147,1,146,146,137,5,0,0
-1,131210103051000.000000000000000,Block 1000, Block Group 1, Census Tract 103.05, Fulton County, Georgia,147,1,146,143,2,140,1,3
-1,131210105203009.000000000000000,Block 3009, Block Group 3, Census Tract 105.20, Fulton County, Georgia,147,3,144,142,0,142,0,2
-1,131210105221006.000000000000000,Block 1006, Block Group 1, Census Tract 105.22, Fulton County, Georgia,147,5,142,138,0,138,0,4
-1,131210114261002.000000000000000,Block 1002, Block Group 1, Census Tract 114.26, Fulton County, Georgia,147,15,132,122,49,15,0,10
-1,131210115132005.000000000000000,Block 2005, Block Group 2, Census Tract 115.13, Fulton County, Georgia,147,9,138,135,119,4,3,3
-1,131210116342005.000000000000000,Block 2005, Block Group 2, Census Tract 116.34, Fulton County, Georgia,147,16,131,123,78,20,0,8
-1,131210116552001.000000000000000,Block 2001, Block Group 2, Census Tract 116.55, Fulton County, Georgia,147,10,137,130,128,1,0,7
-1,131210013012000.000000000000000,Block 2000, Block Group 2, Census Tract 13.01, Fulton County, Georgia,146,7,139,129,112,6,1,10
-1,131210013022007.000000000000000,Block 2007, Block Group 2, Census Tract 13.02, Fulton County, Georgia,146,3,143,137,122,6,0,6
-1,131210084003003.000000000000000,Block 3003, Block Group 3, Census Tract 84, Fulton County, Georgia,146,8,138,138,0,138,0,0
-1,131210101251006.000000000000000,Block 1006, Block Group 1, Census Tract 101.25, Fulton County, Georgia,146,41,105,98,25,68,3,7
-1,131210102203006.000000000000000,Block 3006, Block Group 3, Census Tract 102.20, Fulton County, Georgia,146,6,140,133,103,7,3,7
-1,131210103101000.000000000000000,Block 1000, Block Group 1, Census Tract 103.10, Fulton County, Georgia,146,0,146,142,7,135,0,4
-1,131210114332002.000000000000000,Block 2002, Block Group 2, Census Tract 114.33, Fulton County, Georgia,146,12,134,121,97,4,3,13
-1,131210114341017.000000000000000,Block 1017, Block Group 1, Census Tract 114.34, Fulton County, Georgia,146,18,128,117,88,13,3,11
-1,131210116492001.000000000000000,Block 2001, Block Group 2, Census Tract 116.49, Fulton County, Georgia,146,11,135,130,43,13,1,5
-1,131210001004007.000000000000000,Block 4007, Block Group 4, Census Tract 1, Fulton County, Georgia,145,5,140,135,123,5,1,5
-1,131210002021005.000000000000000,Block 1005, Block Group 1, Census Tract 2.02, Fulton County, Georgia,145,7,138,127,115,3,0,11
-1,131210060003000.000000000000000,Block 3000, Block Group 3, Census Tract 60, Fulton County, Georgia,145,10,135,133,19,114,0,2
-1,131210067021023.000000000000000,Block 1023, Block Group 1, Census Tract 67.02, Fulton County, Georgia,145,2,143,139,19,120,0,4
-1,131210079004015.000000000000000,Block 4015, Block Group 4, Census Tract 79, Fulton County, Georgia,145,4,141,141,2,137,2,0
-1,131210088022006.000000000000000,Block 2006, Block Group 2, Census Tract 88.02, Fulton County, Georgia,145,10,135,122,85,36,0,13
-1,131210089061002.000000000000000,Block 1002, Block Group 1, Census Tract 89.06, Fulton County, Georgia,145,11,134,128,115,6,0,6
-1,131210100052011.000000000000000,Block 2011, Block Group 2, Census Tract 100.05, Fulton County, Georgia,145,3,142,136,120,2,0,6
-1,131210114223010.000000000000000,Block 3010, Block Group 3, Census Tract 114.22, Fulton County, Georgia,145,5,140,137,127,5,0,3
-1,131210115071002.000000000000000,Block 1002, Block Group 1, Census Tract 115.07, Fulton County, Georgia,145,14,131,124,109,0,0,7
-1,131210115131012.000000000000000,Block 1012, Block Group 1, Census Tract 115.13, Fulton County, Georgia,145,6,139,139,135,4,0,0
-1,131210116602006.000000000000000,Block 2006, Block Group 2, Census Tract 116.60, Fulton County, Georgia,145,1,144,140,80,16,2,4
-1,131210002022000.000000000000000,Block 2000, Block Group 2, Census Tract 2.02, Fulton County, Georgia,144,10,134,130,125,5,0,4
-1,131210061001004.000000000000000,Block 1004, Block Group 1, Census Tract 61, Fulton County, Georgia,144,7,137,137,10,127,0,0
-1,131210070012010.000000000000000,Block 2010, Block Group 2, Census Tract 70.01, Fulton County, Georgia,144,4,140,140,0,134,6,0
-1,131210077103008.000000000000000,Block 3008, Block Group 3, Census Tract 77.10, Fulton County, Georgia,144,0,144,139,2,137,0,5
-1,131210088021007.000000000000000,Block 1007, Block Group 1, Census Tract 88.02, Fulton County, Georgia,144,8,136,136,5,127,0,0
-1,131210102113000.000000000000000,Block 3000, Block Group 3, Census Tract 102.11, Fulton County, Georgia,144,4,140,134,109,21,0,6
-1,131210102151001.000000000000000,Block 1001, Block Group 1, Census Tract 102.15, Fulton County, Georgia,144,40,104,94,43,45,0,10
-1,131210102211004.000000000000000,Block 1004, Block Group 1, Census Tract 102.21, Fulton County, Georgia,144,8,136,125,115,2,1,11
-1,131210114382010.000000000000000,Block 2010, Block Group 2, Census Tract 114.38, Fulton County, Georgia,144,18,126,124,122,2,0,2
-1,131210114432000.000000000000000,Block 2000, Block Group 2, Census Tract 114.43, Fulton County, Georgia,144,12,132,126,72,18,0,6
-1,131210114442010.000000000000000,Block 2010, Block Group 2, Census Tract 114.44, Fulton County, Georgia,144,1,143,140,99,11,0,3
-1,131210115101025.000000000000000,Block 1025, Block Group 1, Census Tract 115.10, Fulton County, Georgia,144,8,136,133,121,4,0,3
-1,131210019023001.000000000000000,Block 3001, Block Group 3, Census Tract 19.02, Fulton County, Georgia,143,2,141,139,11,128,0,2
-1,131210030001011.000000000000000,Block 1011, Block Group 1, Census Tract 30, Fulton County, Georgia,143,13,130,126,114,10,2,4
-1,131210067011008.000000000000000,Block 1008, Block Group 1, Census Tract 67.01, Fulton County, Georgia,143,1,142,140,1,138,0,2
-1,131210087022005.000000000000000,Block 2005, Block Group 2, Census Tract 87.02, Fulton County, Georgia,143,4,139,135,38,84,0,4
-1,131210102162015.000000000000000,Block 2015, Block Group 2, Census Tract 102.16, Fulton County, Georgia,143,8,135,126,114,3,0,9
-1,131210105192013.000000000000000,Block 2013, Block Group 2, Census Tract 105.19, Fulton County, Georgia,143,5,138,129,6,122,0,9
-1,131210105291007.000000000000000,Block 1007, Block Group 1, Census Tract 105.29, Fulton County, Georgia,143,5,138,133,0,132,1,5
-1,131210108024020.000000000000000,Block 4020, Block Group 4, Census Tract 108.02, Fulton County, Georgia,143,15,128,127,30,93,0,1
-1,131210113011003.000000000000000,Block 1003, Block Group 1, Census Tract 113.01, Fulton County, Georgia,143,2,141,136,16,120,0,5
-1,131210114312001.000000000000000,Block 2001, Block Group 2, Census Tract 114.31, Fulton County, Georgia,143,114,29,23,11,11,0,6
-1,131210115141001.000000000000000,Block 1001, Block Group 1, Census Tract 115.14, Fulton County, Georgia,143,7,136,128,123,2,3,8
-1,131210116453000.000000000000000,Block 3000, Block Group 3, Census Tract 116.45, Fulton County, Georgia,143,15,128,123,38,15,1,5
-1,131210116562007.000000000000000,Block 2007, Block Group 2, Census Tract 116.56, Fulton County, Georgia,143,12,131,122,99,7,0,9
-1,131210001003014.000000000000000,Block 3014, Block Group 3, Census Tract 1, Fulton County, Georgia,142,3,139,134,127,0,0,5
-1,131210017012010.000000000000000,Block 2010, Block Group 2, Census Tract 17.01, Fulton County, Georgia,142,4,138,137,27,110,0,1
-1,131210021002003.000000000000000,Block 2003, Block Group 2, Census Tract 21, Fulton County, Georgia,142,0,142,140,23,115,0,2
-1,131210030001012.000000000000000,Block 1012, Block Group 1, Census Tract 30, Fulton County, Georgia,142,0,142,138,127,7,4,4
-1,131210041002008.000000000000000,Block 2008, Block Group 2, Census Tract 41, Fulton County, Georgia,142,1,141,129,11,118,0,12
-1,131210100071001.000000000000000,Block 1001, Block Group 1, Census Tract 100.07, Fulton County, Georgia,142,7,135,135,116,7,8,0
-1,131210102122001.000000000000000,Block 2001, Block Group 2, Census Tract 102.12, Fulton County, Georgia,142,126,16,13,3,6,4,3
-1,131210102171008.000000000000000,Block 1008, Block Group 1, Census Tract 102.17, Fulton County, Georgia,142,13,129,123,108,14,0,6
-1,131210114223002.000000000000000,Block 3002, Block Group 3, Census Tract 114.22, Fulton County, Georgia,142,11,131,128,113,9,0,3
-1,131210114232002.000000000000000,Block 2002, Block Group 2, Census Tract 114.23, Fulton County, Georgia,142,5,137,132,120,8,0,5
-1,131210114302003.000000000000000,Block 2003, Block Group 2, Census Tract 114.30, Fulton County, Georgia,142,68,74,69,28,35,0,5
-1,131210114353002.000000000000000,Block 3002, Block Group 3, Census Tract 114.35, Fulton County, Georgia,142,7,135,127,110,17,0,8
-1,131210116321009.000000000000000,Block 1009, Block Group 1, Census Tract 116.32, Fulton County, Georgia,142,5,137,130,22,20,2,7
-1,131210001004003.000000000000000,Block 4003, Block Group 4, Census Tract 1, Fulton County, Georgia,141,9,132,121,114,0,0,11
-1,131210015021005.000000000000000,Block 1005, Block Group 1, Census Tract 15.02, Fulton County, Georgia,141,15,126,126,118,8,0,0
-1,131210036002007.000000000000000,Block 2007, Block Group 2, Census Tract 36, Fulton County, Georgia,141,6,135,134,43,84,0,1
-1,131210077071003.000000000000000,Block 1003, Block Group 1, Census Tract 77.07, Fulton County, Georgia,141,2,139,138,5,129,0,1
-1,131210077072017.000000000000000,Block 2017, Block Group 2, Census Tract 77.07, Fulton County, Georgia,141,1,140,130,1,129,0,10
-1,131210080004001.000000000000000,Block 4001, Block Group 4, Census Tract 80, Fulton County, Georgia,141,0,141,137,13,121,0,4
-1,131210094053001.000000000000000,Block 3001, Block Group 3, Census Tract 94.05, Fulton County, Georgia,141,14,127,116,31,21,1,11
-1,131210102233000.000000000000000,Block 3000, Block Group 3, Census Tract 102.23, Fulton County, Georgia,141,2,139,131,121,1,0,8
-1,131210103083015.000000000000000,Block 3015, Block Group 3, Census Tract 103.08, Fulton County, Georgia,141,3,138,131,2,128,0,7
-1,131210105351003.000000000000000,Block 1003, Block Group 1, Census Tract 105.35, Fulton County, Georgia,141,18,123,118,15,103,0,5
-1,131210113071012.000000000000000,Block 1012, Block Group 1, Census Tract 113.07, Fulton County, Georgia,141,5,136,136,4,126,6,0
-1,131210114292007.000000000000000,Block 2007, Block Group 2, Census Tract 114.29, Fulton County, Georgia,141,67,74,68,45,22,0,6
-1,131210114382003.000000000000000,Block 2003, Block Group 2, Census Tract 114.38, Fulton County, Georgia,141,20,121,118,110,8,0,3
-1,131210115131005.000000000000000,Block 1005, Block Group 1, Census Tract 115.13, Fulton County, Georgia,141,1,140,140,134,5,0,0
-1,131210123003026.000000000000000,Block 3026, Block Group 3, Census Tract 123, Fulton County, Georgia,141,6,135,132,11,121,0,3
-1,131210005022035.000000000000000,Block 2035, Block Group 2, Census Tract 5.02, Fulton County, Georgia,140,6,134,133,129,1,0,1
-1,131210016001008.000000000000000,Block 1008, Block Group 1, Census Tract 16, Fulton County, Georgia,140,6,134,119,111,8,0,15
-1,131210069002002.000000000000000,Block 2002, Block Group 2, Census Tract 69, Fulton County, Georgia,140,14,126,121,63,52,0,5
-1,131210083012011.000000000000000,Block 2011, Block Group 2, Census Tract 83.01, Fulton County, Georgia,140,2,138,133,7,125,1,5
-1,131210089073002.000000000000000,Block 3002, Block Group 3, Census Tract 89.07, Fulton County, Georgia,140,2,138,138,106,18,0,0
-1,131210090022000.000000000000000,Block 2000, Block Group 2, Census Tract 90.02, Fulton County, Georgia,140,3,137,133,132,0,0,4
-1,131210102231001.000000000000000,Block 1001, Block Group 1, Census Tract 102.23, Fulton County, Georgia,140,4,136,132,102,21,0,4
-1,131210102231002.000000000000000,Block 1002, Block Group 1, Census Tract 102.23, Fulton County, Georgia,140,12,128,126,115,3,4,2
-1,131210105211005.000000000000000,Block 1005, Block Group 1, Census Tract 105.21, Fulton County, Georgia,140,4,136,135,0,133,2,1
-1,131210105311005.000000000000000,Block 1005, Block Group 1, Census Tract 105.31, Fulton County, Georgia,140,8,132,129,0,127,2,3
-1,131210115142018.000000000000000,Block 2018, Block Group 2, Census Tract 115.14, Fulton County, Georgia,140,11,129,125,96,23,0,4
-1,131210116291008.000000000000000,Block 1008, Block Group 1, Census Tract 116.29, Fulton County, Georgia,140,8,132,131,97,15,2,1
-1,131210116313002.000000000000000,Block 3002, Block Group 3, Census Tract 116.31, Fulton County, Georgia,140,7,133,125,41,5,0,8
-1,131210013012001.000000000000000,Block 2001, Block Group 2, Census Tract 13.01, Fulton County, Georgia,139,16,123,103,82,19,1,20
-1,131210015021013.000000000000000,Block 1013, Block Group 1, Census Tract 15.02, Fulton County, Georgia,139,7,132,131,115,10,2,1
-1,131210074003001.000000000000000,Block 3001, Block Group 3, Census Tract 74, Fulton County, Georgia,139,100,39,37,5,32,0,2
-1,131210077032009.000000000000000,Block 2009, Block Group 2, Census Tract 77.03, Fulton County, Georgia,139,3,136,128,0,128,0,8
-1,131210080002008.000000000000000,Block 2008, Block Group 2, Census Tract 80, Fulton County, Georgia,139,3,136,136,4,130,0,0
-1,131210083012001.000000000000000,Block 2001, Block Group 2, Census Tract 83.01, Fulton County, Georgia,139,1,138,137,5,132,0,1
-1,131210096061015.000000000000000,Block 1015, Block Group 1, Census Tract 96.06, Fulton County, Georgia,139,3,136,136,132,4,0,0
-1,131210102111002.000000000000000,Block 1002, Block Group 1, Census Tract 102.11, Fulton County, Georgia,139,2,137,130,123,0,0,7
-1,131210112025000.000000000000000,Block 5000, Block Group 5, Census Tract 112.02, Fulton County, Georgia,139,38,101,96,25,71,0,5
-1,131210114174002.000000000000000,Block 4002, Block Group 4, Census Tract 114.17, Fulton County, Georgia,139,21,118,112,100,9,0,6
-1,131210115132006.000000000000000,Block 2006, Block Group 2, Census Tract 115.13, Fulton County, Georgia,139,10,129,111,91,11,1,18
-1,131210120003022.000000000000000,Block 3022, Block Group 3, Census Tract 120, Fulton County, Georgia,139,1,138,138,11,127,0,0
-1,131210012051008.000000000000000,Block 1008, Block Group 1, Census Tract 12.05, Fulton County, Georgia,138,2,136,136,8,127,0,0
-1,131210078051022.000000000000000,Block 1022, Block Group 1, Census Tract 78.05, Fulton County, Georgia,138,11,127,125,2,120,1,2
-1,131210080002003.000000000000000,Block 2003, Block Group 2, Census Tract 80, Fulton County, Georgia,138,4,134,120,12,108,0,14
-1,131210083011006.000000000000000,Block 1006, Block Group 1, Census Tract 83.01, Fulton County, Georgia,138,2,136,136,3,133,0,0
-1,131210086013004.000000000000000,Block 3004, Block Group 3, Census Tract 86.01, Fulton County, Georgia,138,3,135,129,6,123,0,6
-1,131210102203009.000000000000000,Block 3009, Block Group 3, Census Tract 102.20, Fulton County, Georgia,138,3,135,129,103,9,0,6
-1,131210105173009.000000000000000,Block 3009, Block Group 3, Census Tract 105.17, Fulton County, Georgia,138,7,131,129,10,119,0,2
-1,131210105252001.000000000000000,Block 2001, Block Group 2, Census Tract 105.25, Fulton County, Georgia,138,7,131,129,8,120,1,2
-1,131210114361005.000000000000000,Block 1005, Block Group 1, Census Tract 114.36, Fulton County, Georgia,138,5,133,127,108,9,0,6
-1,131210116241003.000000000000000,Block 1003, Block Group 1, Census Tract 116.24, Fulton County, Georgia,138,18,120,116,65,9,0,4
-1,131210116381001.000000000000000,Block 1001, Block Group 1, Census Tract 116.38, Fulton County, Georgia,138,7,131,121,104,1,0,10
-1,131210116423009.000000000000000,Block 3009, Block Group 3, Census Tract 116.42, Fulton County, Georgia,138,16,122,118,63,28,0,4
-1,131210006012010.000000000000000,Block 2010, Block Group 2, Census Tract 6.01, Fulton County, Georgia,137,12,125,116,81,10,0,9
-1,131210013011000.000000000000000,Block 1000, Block Group 1, Census Tract 13.01, Fulton County, Georgia,137,8,129,123,101,15,0,6
-1,131210013012002.000000000000000,Block 2002, Block Group 2, Census Tract 13.01, Fulton County, Georgia,137,5,132,120,93,13,3,12
-1,131210013021002.000000000000000,Block 1002, Block Group 1, Census Tract 13.02, Fulton County, Georgia,137,12,125,121,41,66,4,4
-1,131210078081004.000000000000000,Block 1004, Block Group 1, Census Tract 78.08, Fulton County, Georgia,137,5,132,130,5,125,0,2
-1,131210082042011.000000000000000,Block 2011, Block Group 2, Census Tract 82.04, Fulton County, Georgia,137,0,137,132,1,128,2,5
-1,131210095012002.000000000000000,Block 2002, Block Group 2, Census Tract 95.01, Fulton County, Georgia,137,10,127,125,121,0,1,2
-1,131210095041001.000000000000000,Block 1001, Block Group 1, Census Tract 95.04, Fulton County, Georgia,137,2,135,134,111,11,3,1
-1,131210098042002.000000000000000,Block 2002, Block Group 2, Census Tract 98.04, Fulton County, Georgia,137,0,137,135,129,3,1,2
-1,131210100072002.000000000000000,Block 2002, Block Group 2, Census Tract 100.07, Fulton County, Georgia,137,4,133,131,127,1,0,2
-1,131210101372000.000000000000000,Block 2000, Block Group 2, Census Tract 101.37, Fulton County, Georgia,137,10,127,118,115,3,0,9
-1,131210103072015.000000000000000,Block 2015, Block Group 2, Census Tract 103.07, Fulton County, Georgia,137,11,126,116,3,113,0,10
-1,131210105183006.000000000000000,Block 3006, Block Group 3, Census Tract 105.18, Fulton County, Georgia,137,0,137,136,0,136,0,1
-1,131210105271005.000000000000000,Block 1005, Block Group 1, Census Tract 105.27, Fulton County, Georgia,137,38,99,99,8,91,0,0
-1,131210105291009.000000000000000,Block 1009, Block Group 1, Census Tract 105.29, Fulton County, Georgia,137,9,128,125,3,116,6,3
-1,131210105291015.000000000000000,Block 1015, Block Group 1, Census Tract 105.29, Fulton County, Georgia,137,3,134,133,1,132,0,1
-1,131210114164000.000000000000000,Block 4000, Block Group 4, Census Tract 114.16, Fulton County, Georgia,137,6,131,125,98,5,0,6
-1,131210114222005.000000000000000,Block 2005, Block Group 2, Census Tract 114.22, Fulton County, Georgia,137,33,104,84,34,46,4,20
-1,131210116361002.000000000000000,Block 1002, Block Group 1, Census Tract 116.36, Fulton County, Georgia,137,10,127,119,9,0,10,8
-1,131210116391022.000000000000000,Block 1022, Block Group 1, Census Tract 116.39, Fulton County, Georgia,137,12,125,125,90,6,0,0
-1,131210014002003.000000000000000,Block 2003, Block Group 2, Census Tract 14, Fulton County, Georgia,136,15,121,117,98,10,2,4
-1,131210036002005.000000000000000,Block 2005, Block Group 2, Census Tract 36, Fulton County, Georgia,136,0,136,124,16,105,0,12
-1,131210077072013.000000000000000,Block 2013, Block Group 2, Census Tract 77.07, Fulton County, Georgia,136,0,136,136,1,135,0,0
-1,131210084002004.000000000000000,Block 2004, Block Group 2, Census Tract 84, Fulton County, Georgia,136,4,132,126,7,118,0,6
-1,131210100042005.000000000000000,Block 2005, Block Group 2, Census Tract 100.04, Fulton County, Georgia,136,10,126,123,118,5,0,3
-1,131210101273000.000000000000000,Block 3000, Block Group 3, Census Tract 101.27, Fulton County, Georgia,136,31,105,99,37,52,0,6
-1,131210101332016.000000000000000,Block 2016, Block Group 2, Census Tract 101.33, Fulton County, Georgia,136,23,113,113,78,28,3,0
-1,131210106031003.000000000000000,Block 1003, Block Group 1, Census Tract 106.03, Fulton County, Georgia,136,14,122,120,3,117,0,2
-1,131210113071010.000000000000000,Block 1010, Block Group 1, Census Tract 113.07, Fulton County, Georgia,136,0,136,131,3,128,0,5
-1,131210114282009.000000000000000,Block 2009, Block Group 2, Census Tract 114.28, Fulton County, Georgia,136,15,121,114,112,2,0,7
-1,131210114292004.000000000000000,Block 2004, Block Group 2, Census Tract 114.29, Fulton County, Georgia,136,7,129,123,68,22,1,6
-1,131210116372003.000000000000000,Block 2003, Block Group 2, Census Tract 116.37, Fulton County, Georgia,136,4,132,126,84,7,2,6
-1,131210116384001.000000000000000,Block 4001, Block Group 4, Census Tract 116.38, Fulton County, Georgia,136,6,130,127,91,2,2,3
-1,131210120003030.000000000000000,Block 3030, Block Group 3, Census Tract 120, Fulton County, Georgia,136,0,136,135,4,130,0,1
-1,131210012042001.000000000000000,Block 2001, Block Group 2, Census Tract 12.04, Fulton County, Georgia,135,14,121,116,97,4,0,5
-1,131210021003004.000000000000000,Block 3004, Block Group 3, Census Tract 21, Fulton County, Georgia,135,9,126,118,90,24,0,8
-1,131210074002003.000000000000000,Block 2003, Block Group 2, Census Tract 74, Fulton County, Georgia,135,16,119,119,8,110,0,0
-1,131210088011023.000000000000000,Block 1023, Block Group 1, Census Tract 88.01, Fulton County, Georgia,135,8,127,123,45,70,1,4
-1,131210096072001.000000000000000,Block 2001, Block Group 2, Census Tract 96.07, Fulton County, Georgia,135,12,123,119,89,25,0,4
-1,131210102042003.000000000000000,Block 2003, Block Group 2, Census Tract 102.04, Fulton County, Georgia,135,13,122,113,109,2,0,9
-1,131210102162009.000000000000000,Block 2009, Block Group 2, Census Tract 102.16, Fulton County, Georgia,135,2,133,128,119,0,0,5
-1,131210102221004.000000000000000,Block 1004, Block Group 1, Census Tract 102.22, Fulton County, Georgia,135,4,131,129,100,12,0,2
-1,131210103061005.000000000000000,Block 1005, Block Group 1, Census Tract 103.06, Fulton County, Georgia,135,7,128,125,0,124,0,3
-1,131210106043012.000000000000000,Block 3012, Block Group 3, Census Tract 106.04, Fulton County, Georgia,135,13,122,117,9,108,0,5
-1,131210110003025.000000000000000,Block 3025, Block Group 3, Census Tract 110, Fulton County, Georgia,135,2,133,132,5,127,0,1
-1,131210002022012.000000000000000,Block 2012, Block Group 2, Census Tract 2.02, Fulton County, Georgia,134,6,128,117,100,7,0,11
-1,131210016001007.000000000000000,Block 1007, Block Group 1, Census Tract 16, Fulton County, Georgia,134,8,126,124,101,14,0,2
-1,131210048002002.000000000000000,Block 2002, Block Group 2, Census Tract 48, Fulton County, Georgia,134,2,132,129,14,114,0,3
-1,131210073013002.000000000000000,Block 3002, Block Group 3, Census Tract 73.01, Fulton County, Georgia,134,14,120,116,1,115,0,4
-1,131210096042000.000000000000000,Block 2000, Block Group 2, Census Tract 96.04, Fulton County, Georgia,134,5,129,125,123,1,0,4
-1,131210096061012.000000000000000,Block 1012, Block Group 1, Census Tract 96.06, Fulton County, Georgia,134,6,128,113,112,0,0,15
-1,131210101081004.000000000000000,Block 1004, Block Group 1, Census Tract 101.08, Fulton County, Georgia,134,4,130,127,99,19,0,3
-1,131210101272000.000000000000000,Block 2000, Block Group 2, Census Tract 101.27, Fulton County, Georgia,134,9,125,120,101,11,1,5
-1,131210102211005.000000000000000,Block 1005, Block Group 1, Census Tract 102.21, Fulton County, Georgia,134,9,125,119,105,0,3,6
-1,131210103111029.000000000000000,Block 1029, Block Group 1, Census Tract 103.11, Fulton County, Georgia,134,3,131,130,3,125,0,1
-1,131210104022059.000000000000000,Block 2059, Block Group 2, Census Tract 104.02, Fulton County, Georgia,134,2,132,132,1,131,0,0
-1,131210116462016.000000000000000,Block 2016, Block Group 2, Census Tract 116.46, Fulton County, Georgia,134,18,116,115,66,17,0,1
-1,131210116501007.000000000000000,Block 1007, Block Group 1, Census Tract 116.50, Fulton County, Georgia,134,9,125,125,119,3,0,0
-1,131210001003013.000000000000000,Block 3013, Block Group 3, Census Tract 1, Fulton County, Georgia,133,0,133,129,121,0,0,4
-1,131210021002005.000000000000000,Block 2005, Block Group 2, Census Tract 21, Fulton County, Georgia,133,3,130,121,7,107,0,9
-1,131210030001005.000000000000000,Block 1005, Block Group 1, Census Tract 30, Fulton County, Georgia,133,7,126,125,115,8,0,1
-1,131210053001002.000000000000000,Block 1002, Block Group 1, Census Tract 53, Fulton County, Georgia,133,21,112,106,81,19,0,6
-1,131210073012003.000000000000000,Block 2003, Block Group 2, Census Tract 73.01, Fulton County, Georgia,133,3,130,119,1,118,0,11
-1,131210076031004.000000000000000,Block 1004, Block Group 1, Census Tract 76.03, Fulton County, Georgia,133,2,131,131,0,129,0,0
-1,131210078071007.000000000000000,Block 1007, Block Group 1, Census Tract 78.07, Fulton County, Georgia,133,1,132,126,0,125,0,6
-1,131210084002000.000000000000000,Block 2000, Block Group 2, Census Tract 84, Fulton County, Georgia,133,0,133,133,9,124,0,0
-1,131210088011037.000000000000000,Block 1037, Block Group 1, Census Tract 88.01, Fulton County, Georgia,133,12,121,114,41,62,0,7
-1,131210093011010.000000000000000,Block 1010, Block Group 1, Census Tract 93.01, Fulton County, Georgia,133,8,125,122,122,0,0,3
-1,131210102121001.000000000000000,Block 1001, Block Group 1, Census Tract 102.12, Fulton County, Georgia,133,12,121,111,90,14,1,10
-1,131210105081004.000000000000000,Block 1004, Block Group 1, Census Tract 105.08, Fulton County, Georgia,133,0,133,133,6,127,0,0
-1,131210105082001.000000000000000,Block 2001, Block Group 2, Census Tract 105.08, Fulton County, Georgia,133,1,132,132,0,132,0,0
-1,131210105171000.000000000000000,Block 1000, Block Group 1, Census Tract 105.17, Fulton County, Georgia,133,10,123,123,0,120,3,0
-1,131210105181002.000000000000000,Block 1002, Block Group 1, Census Tract 105.18, Fulton County, Georgia,133,2,131,129,1,127,1,2
-1,131210105372007.000000000000000,Block 2007, Block Group 2, Census Tract 105.37, Fulton County, Georgia,133,15,118,117,0,117,0,1
-1,131210106032006.000000000000000,Block 2006, Block Group 2, Census Tract 106.03, Fulton County, Georgia,133,10,123,122,0,118,0,1
-1,131210110002020.000000000000000,Block 2020, Block Group 2, Census Tract 110, Fulton County, Georgia,133,6,127,125,1,124,0,2
-1,131210114341009.000000000000000,Block 1009, Block Group 1, Census Tract 114.34, Fulton County, Georgia,133,12,121,114,47,32,1,7
-1,131210115071006.000000000000000,Block 1006, Block Group 1, Census Tract 115.07, Fulton County, Georgia,133,14,119,112,108,3,0,7
-1,131210116471003.000000000000000,Block 1003, Block Group 1, Census Tract 116.47, Fulton County, Georgia,133,16,117,115,97,9,3,2
-1,131210116551000.000000000000000,Block 1000, Block Group 1, Census Tract 116.55, Fulton County, Georgia,133,6,127,124,67,5,0,3
-1,131210014002004.000000000000000,Block 2004, Block Group 2, Census Tract 14, Fulton County, Georgia,132,11,121,115,100,14,0,6
-1,131210086013003.000000000000000,Block 3003, Block Group 3, Census Tract 86.01, Fulton County, Georgia,132,1,131,123,3,120,0,8
-1,131210093012005.000000000000000,Block 2005, Block Group 2, Census Tract 93.01, Fulton County, Georgia,132,3,129,126,117,5,1,3
-1,131210093021002.000000000000000,Block 1002, Block Group 1, Census Tract 93.02, Fulton County, Georgia,132,12,120,111,104,1,3,9
-1,131210102171007.000000000000000,Block 1007, Block Group 1, Census Tract 102.17, Fulton County, Georgia,132,2,130,121,112,6,0,9
-1,131210102201020.000000000000000,Block 1020, Block Group 1, Census Tract 102.20, Fulton County, Georgia,132,8,124,120,80,22,0,4
-1,131210114223006.000000000000000,Block 3006, Block Group 3, Census Tract 114.22, Fulton County, Georgia,132,9,123,114,111,0,0,9
-1,131210114231004.000000000000000,Block 1004, Block Group 1, Census Tract 114.23, Fulton County, Georgia,132,11,121,109,91,9,2,12
-1,131210115082015.000000000000000,Block 2015, Block Group 2, Census Tract 115.08, Fulton County, Georgia,132,18,114,100,77,8,4,14
-1,131210116581012.000000000000000,Block 1012, Block Group 1, Census Tract 116.58, Fulton County, Georgia,132,1,131,123,93,2,1,8
-1,131210119013031.000000000000000,Block 3031, Block Group 3, Census Tract 119.01, Fulton County, Georgia,132,2,130,129,24,102,0,1
-1,131210029001009.000000000000000,Block 1009, Block Group 1, Census Tract 29, Fulton County, Georgia,131,4,127,121,28,92,0,6
-1,131210030001015.000000000000000,Block 1015, Block Group 1, Census Tract 30, Fulton County, Georgia,131,12,119,117,101,14,2,2
-1,131210071002012.000000000000000,Block 2012, Block Group 2, Census Tract 71, Fulton County, Georgia,131,9,122,119,1,117,0,3
-1,131210096042002.000000000000000,Block 2002, Block Group 2, Census Tract 96.04, Fulton County, Georgia,131,9,122,118,116,0,0,4
-1,131210103111007.000000000000000,Block 1007, Block Group 1, Census Tract 103.11, Fulton County, Georgia,131,1,130,128,0,128,0,2
-1,131210105391009.000000000000000,Block 1009, Block Group 1, Census Tract 105.39, Fulton County, Georgia,131,0,131,130,56,72,0,1
-1,131210113061011.000000000000000,Block 1011, Block Group 1, Census Tract 113.06, Fulton County, Georgia,131,4,127,119,0,118,1,8
-1,131210114301003.000000000000000,Block 1003, Block Group 1, Census Tract 114.30, Fulton County, Georgia,131,13,118,108,35,64,4,10
-1,131210115101024.000000000000000,Block 1024, Block Group 1, Census Tract 115.10, Fulton County, Georgia,131,5,126,122,104,4,0,4
-1,131210002021007.000000000000000,Block 1007, Block Group 1, Census Tract 2.02, Fulton County, Georgia,130,4,126,113,102,3,0,13
-1,131210002023004.000000000000000,Block 3004, Block Group 3, Census Tract 2.02, Fulton County, Georgia,130,2,128,119,108,0,6,9
-1,131210010021013.000000000000000,Block 1013, Block Group 1, Census Tract 10.02, Fulton County, Georgia,130,3,127,126,47,76,0,1
-1,131210048002005.000000000000000,Block 2005, Block Group 2, Census Tract 48, Fulton County, Georgia,130,1,129,128,8,119,0,1
-1,131210101211002.000000000000000,Block 1002, Block Group 1, Census Tract 101.21, Fulton County, Georgia,130,4,126,113,98,8,0,13
-1,131210102111010.000000000000000,Block 1010, Block Group 1, Census Tract 102.11, Fulton County, Georgia,130,1,129,125,123,0,0,4
-1,131210104012009.000000000000000,Block 2009, Block Group 2, Census Tract 104.01, Fulton County, Georgia,130,11,119,107,18,88,0,12
-1,131210104022066.000000000000000,Block 2066, Block Group 2, Census Tract 104.02, Fulton County, Georgia,130,6,124,124,33,90,1,0
-1,131210114281001.000000000000000,Block 1001, Block Group 1, Census Tract 114.28, Fulton County, Georgia,130,2,128,128,117,8,0,0
-1,131210114341011.000000000000000,Block 1011, Block Group 1, Census Tract 114.34, Fulton County, Georgia,130,15,115,102,78,16,6,13
-1,131210114341012.000000000000000,Block 1012, Block Group 1, Census Tract 114.34, Fulton County, Georgia,130,19,111,106,79,5,2,5
-1,131210116411014.000000000000000,Block 1014, Block Group 1, Census Tract 116.41, Fulton County, Georgia,130,3,127,121,108,11,0,6
-1,131210119011034.000000000000000,Block 1034, Block Group 1, Census Tract 119.01, Fulton County, Georgia,130,2,128,123,81,35,0,5
-1,131210119021011.000000000000000,Block 1011, Block Group 1, Census Tract 119.02, Fulton County, Georgia,130,1,129,127,0,125,2,2
-1,131210010012012.000000000000000,Block 2012, Block Group 2, Census Tract 10.01, Fulton County, Georgia,129,16,113,101,73,4,0,12
-1,131210012062006.000000000000000,Block 2006, Block Group 2, Census Tract 12.06, Fulton County, Georgia,129,2,127,120,106,12,0,7
-1,131210076023004.000000000000000,Block 3004, Block Group 3, Census Tract 76.02, Fulton County, Georgia,129,1,128,120,7,113,0,8
-1,131210078062001.000000000000000,Block 2001, Block Group 2, Census Tract 78.06, Fulton County, Georgia,129,27,102,95,0,91,4,7
-1,131210080001002.000000000000000,Block 1002, Block Group 1, Census Tract 80, Fulton County, Georgia,129,0,129,122,12,109,0,7
-1,131210086013018.000000000000000,Block 3018, Block Group 3, Census Tract 86.01, Fulton County, Georgia,129,6,123,122,1,116,0,1
-1,131210100041009.000000000000000,Block 1009, Block Group 1, Census Tract 100.04, Fulton County, Georgia,129,2,127,123,111,10,0,4
-1,131210103112013.000000000000000,Block 2013, Block Group 2, Census Tract 103.11, Fulton County, Georgia,129,1,128,125,0,124,1,3
-1,131210103142004.000000000000000,Block 2004, Block Group 2, Census Tract 103.14, Fulton County, Georgia,129,3,126,116,10,104,2,10
-1,131210105361016.000000000000000,Block 1016, Block Group 1, Census Tract 105.36, Fulton County, Georgia,129,8,121,112,4,104,0,9
-1,131210113104000.000000000000000,Block 4000, Block Group 4, Census Tract 113.10, Fulton County, Georgia,129,32,97,88,4,83,0,9
-1,131210114174006.000000000000000,Block 4006, Block Group 4, Census Tract 114.17, Fulton County, Georgia,129,15,114,104,104,0,0,10
-1,131210115073003.000000000000000,Block 3003, Block Group 3, Census Tract 115.07, Fulton County, Georgia,129,0,129,123,112,0,0,6
-1,131210116392002.000000000000000,Block 2002, Block Group 2, Census Tract 116.39, Fulton County, Georgia,129,19,110,109,60,28,0,1
-1,131210116562011.000000000000000,Block 2011, Block Group 2, Census Tract 116.56, Fulton County, Georgia,129,5,124,114,98,3,0,10
-1,131210116602005.000000000000000,Block 2005, Block Group 2, Census Tract 116.60, Fulton County, Georgia,129,7,122,117,104,1,5,5
-1,131210119013032.000000000000000,Block 3032, Block Group 3, Census Tract 119.01, Fulton County, Georgia,129,4,125,120,0,117,0,5
-1,131210004001003.000000000000000,Block 1003, Block Group 1, Census Tract 4, Fulton County, Georgia,128,5,123,122,114,3,2,1
-1,131210010012013.000000000000000,Block 2013, Block Group 2, Census Tract 10.01, Fulton County, Georgia,128,14,114,111,54,8,2,3
-1,131210015021006.000000000000000,Block 1006, Block Group 1, Census Tract 15.02, Fulton County, Georgia,128,45,83,78,75,0,1,5
-1,131210055031002.000000000000000,Block 1002, Block Group 1, Census Tract 55.03, Fulton County, Georgia,128,1,127,126,0,123,2,1
-1,131210083021014.000000000000000,Block 1014, Block Group 1, Census Tract 83.02, Fulton County, Georgia,128,0,128,128,4,121,0,0
-1,131210085002008.000000000000000,Block 2008, Block Group 2, Census Tract 85, Fulton County, Georgia,128,2,126,121,17,99,2,5
-1,131210091031001.000000000000000,Block 1001, Block Group 1, Census Tract 91.03, Fulton County, Georgia,128,6,122,115,107,2,3,7
-1,131210092021001.000000000000000,Block 1001, Block Group 1, Census Tract 92.02, Fulton County, Georgia,128,6,122,116,96,6,1,6
-1,131210099003012.000000000000000,Block 3012, Block Group 3, Census Tract 99, Fulton County, Georgia,128,7,121,114,96,5,2,7
-1,131210101332017.000000000000000,Block 2017, Block Group 2, Census Tract 101.33, Fulton County, Georgia,128,2,126,110,80,5,0,16
-1,131210105202013.000000000000000,Block 2013, Block Group 2, Census Tract 105.20, Fulton County, Georgia,128,1,127,126,0,125,0,1
-1,131210105221008.000000000000000,Block 1008, Block Group 1, Census Tract 105.22, Fulton County, Georgia,128,3,125,122,3,116,0,3
-1,131210115102019.000000000000000,Block 2019, Block Group 2, Census Tract 115.10, Fulton County, Georgia,128,7,121,116,113,3,0,5
-1,131210116292005.000000000000000,Block 2005, Block Group 2, Census Tract 116.29, Fulton County, Georgia,128,23,105,99,59,19,2,6
-1,131210001004005.000000000000000,Block 4005, Block Group 4, Census Tract 1, Fulton County, Georgia,127,3,124,123,123,0,0,1
-1,131210004002003.000000000000000,Block 2003, Block Group 2, Census Tract 4, Fulton County, Georgia,127,8,119,113,98,14,1,6
-1,131210005012012.000000000000000,Block 2012, Block Group 2, Census Tract 5.01, Fulton County, Georgia,127,28,99,94,29,44,3,5
-1,131210017011003.000000000000000,Block 1003, Block Group 1, Census Tract 17.01, Fulton County, Georgia,127,3,124,122,3,115,2,2
-1,131210078073000.000000000000000,Block 3000, Block Group 3, Census Tract 78.07, Fulton County, Georgia,127,9,118,108,1,107,0,10
-1,131210080002004.000000000000000,Block 2004, Block Group 2, Census Tract 80, Fulton County, Georgia,127,2,125,124,0,119,3,1
-1,131210083021008.000000000000000,Block 1008, Block Group 1, Census Tract 83.02, Fulton County, Georgia,127,3,124,123,0,123,0,1
-1,131210089071002.000000000000000,Block 1002, Block Group 1, Census Tract 89.07, Fulton County, Georgia,127,4,123,119,112,1,3,4
-1,131210097003006.000000000000000,Block 3006, Block Group 3, Census Tract 97, Fulton County, Georgia,127,1,126,124,122,1,0,2
-1,131210101081009.000000000000000,Block 1009, Block Group 1, Census Tract 101.08, Fulton County, Georgia,127,16,111,107,90,5,3,4
-1,131210103072004.000000000000000,Block 2004, Block Group 2, Census Tract 103.07, Fulton County, Georgia,127,4,123,115,3,107,0,8
-1,131210103091027.000000000000000,Block 1027, Block Group 1, Census Tract 103.09, Fulton County, Georgia,127,19,108,106,50,56,0,2
-1,131210105323010.000000000000000,Block 3010, Block Group 3, Census Tract 105.32, Fulton County, Georgia,127,8,119,117,2,115,0,2
-1,131210116332000.000000000000000,Block 2000, Block Group 2, Census Tract 116.33, Fulton County, Georgia,127,10,117,117,61,32,0,0
-1,131210001004000.000000000000000,Block 4000, Block Group 4, Census Tract 1, Fulton County, Georgia,126,6,120,108,101,2,1,12
-1,131210065002009.000000000000000,Block 2009, Block Group 2, Census Tract 65, Fulton County, Georgia,126,3,123,123,1,121,0,0
-1,131210070011009.000000000000000,Block 1009, Block Group 1, Census Tract 70.01, Fulton County, Georgia,126,10,116,116,5,111,0,0
-1,131210084003001.000000000000000,Block 3001, Block Group 3, Census Tract 84, Fulton County, Georgia,126,0,126,120,7,113,0,6
-1,131210101083006.000000000000000,Block 3006, Block Group 3, Census Tract 101.08, Fulton County, Georgia,126,4,122,121,111,8,0,1
-1,131210101341000.000000000000000,Block 1000, Block Group 1, Census Tract 101.34, Fulton County, Georgia,126,27,99,89,27,54,0,10
-1,131210102111012.000000000000000,Block 1012, Block Group 1, Census Tract 102.11, Fulton County, Georgia,126,1,125,116,115,0,0,9
-1,131210105171007.000000000000000,Block 1007, Block Group 1, Census Tract 105.17, Fulton County, Georgia,126,3,123,123,0,121,0,0
-1,131210105392026.000000000000000,Block 2026, Block Group 2, Census Tract 105.39, Fulton County, Georgia,126,3,123,123,0,121,0,0
-1,131210110003027.000000000000000,Block 3027, Block Group 3, Census Tract 110, Fulton County, Georgia,126,2,124,124,1,123,0,0
-1,131210114401011.000000000000000,Block 1011, Block Group 1, Census Tract 114.40, Fulton County, Georgia,126,11,115,111,104,1,5,4
-1,131210116422005.000000000000000,Block 2005, Block Group 2, Census Tract 116.42, Fulton County, Georgia,126,5,121,120,112,4,0,1
-1,131210116451001.000000000000000,Block 1001, Block Group 1, Census Tract 116.45, Fulton County, Georgia,126,13,113,104,22,47,4,9
-1,131210001002008.000000000000000,Block 2008, Block Group 2, Census Tract 1, Fulton County, Georgia,125,3,122,120,118,2,0,2
-1,131210052003010.000000000000000,Block 3010, Block Group 3, Census Tract 52, Fulton County, Georgia,125,4,121,115,107,8,0,6
-1,131210060002008.000000000000000,Block 2008, Block Group 2, Census Tract 60, Fulton County, Georgia,125,0,125,121,16,95,2,4
-1,131210072003008.000000000000000,Block 3008, Block Group 3, Census Tract 72, Fulton County, Georgia,125,2,123,123,2,121,0,0
-1,131210077082008.000000000000000,Block 2008, Block Group 2, Census Tract 77.08, Fulton County, Georgia,125,1,124,123,2,121,0,1
-1,131210078053005.000000000000000,Block 3005, Block Group 3, Census Tract 78.05, Fulton County, Georgia,125,1,124,124,0,121,0,0
-1,131210094112003.000000000000000,Block 2003, Block Group 2, Census Tract 94.11, Fulton County, Georgia,125,7,118,111,68,39,2,7
-1,131210102201011.000000000000000,Block 1011, Block Group 1, Census Tract 102.20, Fulton County, Georgia,125,14,111,106,98,0,0,5
-1,131210103082001.000000000000000,Block 2001, Block Group 2, Census Tract 103.08, Fulton County, Georgia,125,2,123,115,1,114,0,8
-1,131210114163011.000000000000000,Block 3011, Block Group 3, Census Tract 114.16, Fulton County, Georgia,125,3,122,121,113,4,0,1
-1,131210115112005.000000000000000,Block 2005, Block Group 2, Census Tract 115.11, Fulton County, Georgia,125,1,124,121,113,2,0,3
-1,131210116492002.000000000000000,Block 2002, Block Group 2, Census Tract 116.49, Fulton County, Georgia,125,7,118,111,31,10,1,7
-1,131210119013037.000000000000000,Block 3037, Block Group 3, Census Tract 119.01, Fulton County, Georgia,125,0,125,122,2,120,0,3
-1,131210012031002.000000000000000,Block 1002, Block Group 1, Census Tract 12.03, Fulton County, Georgia,124,13,111,105,50,33,0,6
-1,131210035001011.000000000000000,Block 1011, Block Group 1, Census Tract 35, Fulton County, Georgia,124,14,110,109,22,65,0,1
-1,131210086022011.000000000000000,Block 2011, Block Group 2, Census Tract 86.02, Fulton County, Georgia,124,10,114,111,1,96,6,3
-1,131210089091009.000000000000000,Block 1009, Block Group 1, Census Tract 89.09, Fulton County, Georgia,124,4,120,118,113,0,0,2
-1,131210098031002.000000000000000,Block 1002, Block Group 1, Census Tract 98.03, Fulton County, Georgia,124,11,113,106,99,1,2,7
-1,131210102042016.000000000000000,Block 2016, Block Group 2, Census Tract 102.04, Fulton County, Georgia,124,1,123,114,114,0,0,9
-1,131210103152001.000000000000000,Block 2001, Block Group 2, Census Tract 103.15, Fulton County, Georgia,124,3,121,109,0,109,0,12
-1,131210106043014.000000000000000,Block 3014, Block Group 3, Census Tract 106.04, Fulton County, Georgia,124,4,120,117,9,98,2,3
-1,131210116392004.000000000000000,Block 2004, Block Group 2, Census Tract 116.39, Fulton County, Georgia,124,18,106,98,40,32,1,8
-1,131210116492004.000000000000000,Block 2004, Block Group 2, Census Tract 116.49, Fulton County, Georgia,124,10,114,103,20,12,0,11
-1,131210005021006.000000000000000,Block 1006, Block Group 1, Census Tract 5.02, Fulton County, Georgia,123,10,113,103,88,10,0,10
-1,131210016001004.000000000000000,Block 1004, Block Group 1, Census Tract 16, Fulton County, Georgia,123,5,118,113,66,38,0,5
-1,131210021001013.000000000000000,Block 1013, Block Group 1, Census Tract 21, Fulton County, Georgia,123,8,115,104,37,58,2,11
-1,131210055032008.000000000000000,Block 2008, Block Group 2, Census Tract 55.03, Fulton County, Georgia,123,4,119,115,3,112,0,4
-1,131210060001000.000000000000000,Block 1000, Block Group 1, Census Tract 60, Fulton County, Georgia,123,2,121,116,29,87,0,5
-1,131210070012000.000000000000000,Block 2000, Block Group 2, Census Tract 70.01, Fulton County, Georgia,123,10,113,108,25,82,1,5
-1,131210085002024.000000000000000,Block 2024, Block Group 2, Census Tract 85, Fulton County, Georgia,123,0,123,119,18,100,0,4
-1,131210101152012.000000000000000,Block 2012, Block Group 2, Census Tract 101.15, Fulton County, Georgia,123,1,122,116,90,9,0,6
-1,131210101332014.000000000000000,Block 2014, Block Group 2, Census Tract 101.33, Fulton County, Georgia,123,17,106,97,65,21,0,9
-1,131210102201016.000000000000000,Block 1016, Block Group 1, Census Tract 102.20, Fulton County, Georgia,123,7,116,108,92,7,0,8
-1,131210102231003.000000000000000,Block 1003, Block Group 1, Census Tract 102.23, Fulton County, Georgia,123,9,114,105,98,2,0,9
-1,131210103071007.000000000000000,Block 1007, Block Group 1, Census Tract 103.07, Fulton County, Georgia,123,1,122,122,6,115,0,0
-1,131210105203001.000000000000000,Block 3001, Block Group 3, Census Tract 105.20, Fulton County, Georgia,123,9,114,110,6,99,1,4
-1,131210105282004.000000000000000,Block 2004, Block Group 2, Census Tract 105.28, Fulton County, Georgia,123,73,50,49,0,49,0,1
-1,131210113013002.000000000000000,Block 3002, Block Group 3, Census Tract 113.01, Fulton County, Georgia,123,30,93,93,15,78,0,0
-1,131210115091006.000000000000000,Block 1006, Block Group 1, Census Tract 115.09, Fulton County, Georgia,123,7,116,108,83,8,3,8
-1,131210002021001.000000000000000,Block 1001, Block Group 1, Census Tract 2.02, Fulton County, Georgia,122,8,114,114,114,0,0,0
-1,131210015011000.000000000000000,Block 1000, Block Group 1, Census Tract 15.01, Fulton County, Georgia,122,9,113,110,54,55,0,3
-1,131210015011010.000000000000000,Block 1010, Block Group 1, Census Tract 15.01, Fulton County, Georgia,122,2,120,104,95,2,2,16
-1,131210067012002.000000000000000,Block 2002, Block Group 2, Census Tract 67.01, Fulton County, Georgia,122,6,116,115,14,95,0,1
-1,131210077053015.000000000000000,Block 3015, Block Group 3, Census Tract 77.05, Fulton County, Georgia,122,2,120,120,0,120,0,0
-1,131210096061018.000000000000000,Block 1018, Block Group 1, Census Tract 96.06, Fulton County, Georgia,122,1,121,118,98,4,5,3
-1,131210099005006.000000000000000,Block 5006, Block Group 5, Census Tract 99, Fulton County, Georgia,122,2,120,117,104,0,0,3
-1,131210101071000.000000000000000,Block 1000, Block Group 1, Census Tract 101.07, Fulton County, Georgia,122,1,121,117,115,0,1,4
-1,131210102042013.000000000000000,Block 2013, Block Group 2, Census Tract 102.04, Fulton County, Georgia,122,7,115,111,98,4,5,4
-1,131210103082004.000000000000000,Block 2004, Block Group 2, Census Tract 103.08, Fulton County, Georgia,122,1,121,120,2,118,0,1
-1,131210103121005.000000000000000,Block 1005, Block Group 1, Census Tract 103.12, Fulton County, Georgia,122,0,122,122,3,119,0,0
-1,131210103131012.000000000000000,Block 1012, Block Group 1, Census Tract 103.13, Fulton County, Georgia,122,5,117,117,0,117,0,0
-1,131210105173010.000000000000000,Block 3010, Block Group 3, Census Tract 105.17, Fulton County, Georgia,122,6,116,113,3,108,0,3
-1,131210105274001.000000000000000,Block 4001, Block Group 4, Census Tract 105.27, Fulton County, Georgia,122,2,120,119,1,117,0,1
-1,131210115072004.000000000000000,Block 2004, Block Group 2, Census Tract 115.07, Fulton County, Georgia,122,4,118,117,113,4,0,1
-1,131210115101017.000000000000000,Block 1017, Block Group 1, Census Tract 115.10, Fulton County, Georgia,122,2,120,118,113,2,0,2
-1,131210116272002.000000000000000,Block 2002, Block Group 2, Census Tract 116.27, Fulton County, Georgia,122,3,119,110,81,9,0,9
-1,131210116592008.000000000000000,Block 2008, Block Group 2, Census Tract 116.59, Fulton County, Georgia,122,1,121,116,67,9,1,5
-1,131210120001014.000000000000000,Block 1014, Block Group 1, Census Tract 120, Fulton County, Georgia,122,5,117,115,6,105,4,2
-1,131210032002017.000000000000000,Block 2017, Block Group 2, Census Tract 32, Fulton County, Georgia,121,7,114,104,90,11,0,10
-1,131210090011004.000000000000000,Block 1004, Block Group 1, Census Tract 90.01, Fulton County, Georgia,121,1,120,108,101,6,0,12
-1,131210090011008.000000000000000,Block 1008, Block Group 1, Census Tract 90.01, Fulton County, Georgia,121,2,119,110,109,1,0,9
-1,131210091031005.000000000000000,Block 1005, Block Group 1, Census Tract 91.03, Fulton County, Georgia,121,8,113,111,86,17,0,2
-1,131210096043000.000000000000000,Block 3000, Block Group 3, Census Tract 96.04, Fulton County, Georgia,121,4,117,114,111,0,3,3
-1,131210097002000.000000000000000,Block 2000, Block Group 2, Census Tract 97, Fulton County, Georgia,121,8,113,107,101,5,0,6
-1,131210099002010.000000000000000,Block 2010, Block Group 2, Census Tract 99, Fulton County, Georgia,121,0,121,115,114,0,0,6
-1,131210102041005.000000000000000,Block 1005, Block Group 1, Census Tract 102.04, Fulton County, Georgia,121,10,111,109,102,6,0,2
-1,131210102114011.000000000000000,Block 4011, Block Group 4, Census Tract 102.11, Fulton County, Georgia,121,7,114,111,104,0,1,3
-1,131210103081003.000000000000000,Block 1003, Block Group 1, Census Tract 103.08, Fulton County, Georgia,121,5,116,115,1,113,1,1
-1,131210103122035.000000000000000,Block 2035, Block Group 2, Census Tract 103.12, Fulton County, Georgia,121,0,121,118,1,115,0,3
-1,131210103132006.000000000000000,Block 2006, Block Group 2, Census Tract 103.13, Fulton County, Georgia,121,1,120,117,0,117,0,3
-1,131210105263003.000000000000000,Block 3003, Block Group 3, Census Tract 105.26, Fulton County, Georgia,121,8,113,110,2,107,1,3
-1,131210112021009.000000000000000,Block 1009, Block Group 1, Census Tract 112.02, Fulton County, Georgia,121,8,113,111,37,74,0,2
-1,131210114161009.000000000000000,Block 1009, Block Group 1, Census Tract 114.16, Fulton County, Georgia,121,5,116,113,95,6,2,3
-1,131210114432002.000000000000000,Block 2002, Block Group 2, Census Tract 114.43, Fulton County, Georgia,121,6,115,112,73,11,0,3
-1,131210115073004.000000000000000,Block 3004, Block Group 3, Census Tract 115.07, Fulton County, Georgia,121,8,113,108,93,3,0,5
-1,131210115101016.000000000000000,Block 1016, Block Group 1, Census Tract 115.10, Fulton County, Georgia,121,9,112,110,103,4,0,2
-1,131210116521014.000000000000000,Block 1014, Block Group 1, Census Tract 116.52, Fulton County, Georgia,121,5,116,114,17,17,1,2
-1,131210002012011.000000000000000,Block 2011, Block Group 2, Census Tract 2.01, Fulton County, Georgia,120,3,117,114,100,0,2,3
-1,131210077032016.000000000000000,Block 2016, Block Group 2, Census Tract 77.03, Fulton County, Georgia,120,2,118,117,2,114,1,1
-1,131210077082015.000000000000000,Block 2015, Block Group 2, Census Tract 77.08, Fulton County, Georgia,120,1,119,114,0,112,1,5
-1,131210078062008.000000000000000,Block 2008, Block Group 2, Census Tract 78.06, Fulton County, Georgia,120,11,109,99,1,98,0,10
-1,131210078064002.000000000000000,Block 4002, Block Group 4, Census Tract 78.06, Fulton County, Georgia,120,4,116,111,4,107,0,5
-1,131210078073001.000000000000000,Block 3001, Block Group 3, Census Tract 78.07, Fulton County, Georgia,120,2,118,115,0,114,0,3
-1,131210080002002.000000000000000,Block 2002, Block Group 2, Census Tract 80, Fulton County, Georgia,120,0,120,112,5,104,3,8
-1,131210085003004.000000000000000,Block 3004, Block Group 3, Census Tract 85, Fulton County, Georgia,120,0,120,118,23,95,0,2
-1,131210092031013.000000000000000,Block 1013, Block Group 1, Census Tract 92.03, Fulton County, Georgia,120,7,113,96,39,24,0,17
-1,131210094082006.000000000000000,Block 2006, Block Group 2, Census Tract 94.08, Fulton County, Georgia,120,13,107,91,68,8,0,16
-1,131210098031005.000000000000000,Block 1005, Block Group 1, Census Tract 98.03, Fulton County, Georgia,120,8,112,103,92,5,0,9
-1,131210098041009.000000000000000,Block 1009, Block Group 1, Census Tract 98.04, Fulton County, Georgia,120,1,119,117,109,0,2,2
-1,131210103062007.000000000000000,Block 2007, Block Group 2, Census Tract 103.06, Fulton County, Georgia,120,3,117,110,10,100,0,7
-1,131210103092024.000000000000000,Block 2024, Block Group 2, Census Tract 103.09, Fulton County, Georgia,120,4,116,115,1,107,7,1
-1,131210105181007.000000000000000,Block 1007, Block Group 1, Census Tract 105.18, Fulton County, Georgia,120,4,116,116,0,116,0,0
-1,131210105241005.000000000000000,Block 1005, Block Group 1, Census Tract 105.24, Fulton County, Georgia,120,25,95,93,4,86,2,2
-1,131210105372006.000000000000000,Block 2006, Block Group 2, Census Tract 105.37, Fulton County, Georgia,120,4,116,113,0,113,0,3
-1,131210111002038.000000000000000,Block 2038, Block Group 2, Census Tract 111, Fulton County, Georgia,120,4,116,114,7,105,0,2
-1,131210114441006.000000000000000,Block 1006, Block Group 1, Census Tract 114.44, Fulton County, Georgia,120,15,105,92,75,8,1,13
-1,131210115131004.000000000000000,Block 1004, Block Group 1, Census Tract 115.13, Fulton County, Georgia,120,4,116,107,97,3,0,9
-1,131210116241004.000000000000000,Block 1004, Block Group 1, Census Tract 116.24, Fulton County, Georgia,120,3,117,108,61,11,3,9
-1,131210116491001.000000000000000,Block 1001, Block Group 1, Census Tract 116.49, Fulton County, Georgia,120,2,118,107,32,1,0,11
-1,131210013012006.000000000000000,Block 2006, Block Group 2, Census Tract 13.01, Fulton County, Georgia,119,6,113,109,83,17,0,4
-1,131210042001006.000000000000000,Block 1006, Block Group 1, Census Tract 42, Fulton County, Georgia,119,0,119,115,3,112,0,4
-1,131210058001030.000000000000000,Block 1030, Block Group 1, Census Tract 58, Fulton County, Georgia,119,1,118,118,13,105,0,0
-1,131210060004002.000000000000000,Block 4002, Block Group 4, Census Tract 60, Fulton County, Georgia,119,0,119,118,11,106,1,1
-1,131210078092016.000000000000000,Block 2016, Block Group 2, Census Tract 78.09, Fulton County, Georgia,119,0,119,117,0,117,0,2
-1,131210094092003.000000000000000,Block 2003, Block Group 2, Census Tract 94.09, Fulton County, Georgia,119,51,68,55,23,20,0,13
-1,131210101071004.000000000000000,Block 1004, Block Group 1, Census Tract 101.07, Fulton County, Georgia,119,6,113,110,104,3,2,3
-1,131210102111006.000000000000000,Block 1006, Block Group 1, Census Tract 102.11, Fulton County, Georgia,119,3,116,116,105,8,0,0
-1,131210103093013.000000000000000,Block 3013, Block Group 3, Census Tract 103.09, Fulton County, Georgia,119,5,114,112,4,106,0,2
-1,131210105311010.000000000000000,Block 1010, Block Group 1, Census Tract 105.31, Fulton County, Georgia,119,6,113,103,0,96,6,10
-1,131210106013005.000000000000000,Block 3005, Block Group 3, Census Tract 106.01, Fulton County, Georgia,119,1,118,118,7,111,0,0
-1,131210114372006.000000000000000,Block 2006, Block Group 2, Census Tract 114.37, Fulton County, Georgia,119,14,105,102,90,8,0,3
-1,131210115101015.000000000000000,Block 1015, Block Group 1, Census Tract 115.10, Fulton County, Georgia,119,1,118,113,68,4,0,5
-1,131210116423001.000000000000000,Block 3001, Block Group 3, Census Tract 116.42, Fulton County, Georgia,119,8,111,105,80,18,0,6
-1,131210018012000.000000000000000,Block 2000, Block Group 2, Census Tract 18.01, Fulton County, Georgia,118,9,109,102,57,23,0,7
-1,131210042001003.000000000000000,Block 1003, Block Group 1, Census Tract 42, Fulton County, Georgia,118,2,116,114,3,111,0,2
-1,131210069003007.000000000000000,Block 3007, Block Group 3, Census Tract 69, Fulton County, Georgia,118,3,115,108,58,36,0,7
-1,131210070014007.000000000000000,Block 4007, Block Group 4, Census Tract 70.01, Fulton County, Georgia,118,6,112,97,12,83,0,15
-1,131210087022009.000000000000000,Block 2009, Block Group 2, Census Tract 87.02, Fulton County, Georgia,118,8,110,108,34,73,0,2
-1,131210090022002.000000000000000,Block 2002, Block Group 2, Census Tract 90.02, Fulton County, Georgia,118,0,118,118,118,0,0,0
-1,131210102171004.000000000000000,Block 1004, Block Group 1, Census Tract 102.17, Fulton County, Georgia,118,19,99,91,20,48,0,8
-1,131210105183008.000000000000000,Block 3008, Block Group 3, Census Tract 105.18, Fulton County, Georgia,118,14,104,103,0,103,0,1
-1,131210105273002.000000000000000,Block 3002, Block Group 3, Census Tract 105.27, Fulton County, Georgia,118,31,87,83,3,80,0,4
-1,131210105311007.000000000000000,Block 1007, Block Group 1, Census Tract 105.31, Fulton County, Georgia,118,7,111,108,7,100,0,3
-1,131210108021011.000000000000000,Block 1011, Block Group 1, Census Tract 108.02, Fulton County, Georgia,118,65,53,53,19,27,0,0
-1,131210113014000.000000000000000,Block 4000, Block Group 4, Census Tract 113.01, Fulton County, Georgia,118,20,98,93,6,86,1,5
-1,131210114163012.000000000000000,Block 3012, Block Group 3, Census Tract 114.16, Fulton County, Georgia,118,8,110,107,91,7,3,3
-1,131210114411003.000000000000000,Block 1003, Block Group 1, Census Tract 114.41, Fulton County, Georgia,118,9,109,101,62,25,3,8
-1,131210114451002.000000000000000,Block 1002, Block Group 1, Census Tract 114.45, Fulton County, Georgia,118,2,116,114,109,3,2,2
-1,131210114452010.000000000000000,Block 2010, Block Group 2, Census Tract 114.45, Fulton County, Georgia,118,3,115,111,105,4,1,4
-1,131210116122006.000000000000000,Block 2006, Block Group 2, Census Tract 116.12, Fulton County, Georgia,118,5,113,107,51,26,0,6
-1,131210116383006.000000000000000,Block 3006, Block Group 3, Census Tract 116.38, Fulton County, Georgia,118,12,106,94,59,8,1,12
-1,131210116592004.000000000000000,Block 2004, Block Group 2, Census Tract 116.59, Fulton County, Georgia,118,10,108,86,68,2,0,22
-1,131210010012016.000000000000000,Block 2016, Block Group 2, Census Tract 10.01, Fulton County, Georgia,117,6,111,106,84,9,0,5
-1,131210030003003.000000000000000,Block 3003, Block Group 3, Census Tract 30, Fulton County, Georgia,117,12,105,100,82,9,0,5
-1,131210035002031.000000000000000,Block 2031, Block Group 2, Census Tract 35, Fulton County, Georgia,117,4,113,111,34,69,0,2
-1,131210036001001.000000000000000,Block 1001, Block Group 1, Census Tract 36, Fulton County, Georgia,117,3,114,114,9,104,0,0
-1,131210044002007.000000000000000,Block 2007, Block Group 2, Census Tract 44, Fulton County, Georgia,117,0,117,116,3,112,1,1
-1,131210078053004.000000000000000,Block 3004, Block Group 3, Census Tract 78.05, Fulton County, Georgia,117,1,116,116,11,103,0,0
-1,131210082021010.000000000000000,Block 1010, Block Group 1, Census Tract 82.02, Fulton County, Georgia,117,4,113,113,2,111,0,0
-1,131210091031000.000000000000000,Block 1000, Block Group 1, Census Tract 91.03, Fulton County, Georgia,117,6,111,109,100,5,0,2
-1,131210097002004.000000000000000,Block 2004, Block Group 2, Census Tract 97, Fulton County, Georgia,117,11,106,105,100,1,2,1
-1,131210100051008.000000000000000,Block 1008, Block Group 1, Census Tract 100.05, Fulton County, Georgia,117,5,112,106,101,5,0,6
-1,131210103132001.000000000000000,Block 2001, Block Group 2, Census Tract 103.13, Fulton County, Georgia,117,7,110,110,0,109,0,0
-1,131210105331003.000000000000000,Block 1003, Block Group 1, Census Tract 105.33, Fulton County, Georgia,117,10,107,107,0,103,3,0
-1,131210111003003.000000000000000,Block 3003, Block Group 3, Census Tract 111, Fulton County, Georgia,117,6,111,110,36,65,0,1
-1,131210115103002.000000000000000,Block 3002, Block Group 3, Census Tract 115.10, Fulton County, Georgia,117,5,112,105,101,2,0,7
-1,131210116423003.000000000000000,Block 3003, Block Group 3, Census Tract 116.42, Fulton County, Georgia,117,19,98,82,26,31,0,16
-1,131210002012010.000000000000000,Block 2010, Block Group 2, Census Tract 2.01, Fulton County, Georgia,116,12,104,98,91,0,3,6
-1,131210013011008.000000000000000,Block 1008, Block Group 1, Census Tract 13.01, Fulton County, Georgia,116,1,115,110,104,3,1,5
-1,131210073021006.000000000000000,Block 1006, Block Group 1, Census Tract 73.02, Fulton County, Georgia,116,3,113,110,3,105,0,3
-1,131210078062003.000000000000000,Block 2003, Block Group 2, Census Tract 78.06, Fulton County, Georgia,116,6,110,109,0,109,0,1
-1,131210078094000.000000000000000,Block 4000, Block Group 4, Census Tract 78.09, Fulton County, Georgia,116,1,115,113,0,111,0,2
-1,131210078103008.000000000000000,Block 3008, Block Group 3, Census Tract 78.10, Fulton County, Georgia,116,1,115,115,0,115,0,0
-1,131210098042004.000000000000000,Block 2004, Block Group 2, Census Tract 98.04, Fulton County, Georgia,116,14,102,101,90,2,0,1
-1,131210102043008.000000000000000,Block 3008, Block Group 3, Census Tract 102.04, Fulton County, Georgia,116,2,114,109,101,7,0,5
-1,131210102114012.000000000000000,Block 4012, Block Group 4, Census Tract 102.11, Fulton County, Georgia,116,2,114,111,100,2,0,3
-1,131210103061012.000000000000000,Block 1012, Block Group 1, Census Tract 103.06, Fulton County, Georgia,116,2,114,113,0,110,3,1
-1,131210105223010.000000000000000,Block 3010, Block Group 3, Census Tract 105.22, Fulton County, Georgia,116,0,116,116,0,110,3,0
-1,131210105322008.000000000000000,Block 2008, Block Group 2, Census Tract 105.32, Fulton County, Georgia,116,3,113,110,17,93,0,3
-1,131210113102008.000000000000000,Block 2008, Block Group 2, Census Tract 113.10, Fulton County, Georgia,116,3,113,111,0,108,0,2
-1,131210005021009.000000000000000,Block 1009, Block Group 1, Census Tract 5.02, Fulton County, Georgia,115,5,110,108,100,7,0,2
-1,131210013012005.000000000000000,Block 2005, Block Group 2, Census Tract 13.01, Fulton County, Georgia,115,4,111,107,96,6,3,4
-1,131210080001005.000000000000000,Block 1005, Block Group 1, Census Tract 80, Fulton County, Georgia,115,5,110,109,5,97,7,1
-1,131210089082003.000000000000000,Block 2003, Block Group 2, Census Tract 89.08, Fulton County, Georgia,115,20,95,89,83,6,0,6
-1,131210098021006.000000000000000,Block 1006, Block Group 1, Census Tract 98.02, Fulton County, Georgia,115,0,115,108,69,9,0,7
-1,131210098031007.000000000000000,Block 1007, Block Group 1, Census Tract 98.03, Fulton County, Georgia,115,0,115,112,111,1,0,3
-1,131210100061001.000000000000000,Block 1001, Block Group 1, Census Tract 100.06, Fulton County, Georgia,115,5,110,106,74,24,0,4
-1,131210101171002.000000000000000,Block 1002, Block Group 1, Census Tract 101.17, Fulton County, Georgia,115,31,84,73,4,37,7,11
-1,131210101361003.000000000000000,Block 1003, Block Group 1, Census Tract 101.36, Fulton County, Georgia,115,7,108,103,96,5,0,5
-1,131210104011040.000000000000000,Block 1040, Block Group 1, Census Tract 104.01, Fulton County, Georgia,115,12,103,102,2,99,1,1
-1,131210105271001.000000000000000,Block 1001, Block Group 1, Census Tract 105.27, Fulton County, Georgia,115,3,112,108,5,103,0,4
-1,131210113093008.000000000000000,Block 3008, Block Group 3, Census Tract 113.09, Fulton County, Georgia,115,7,108,108,0,106,0,0
-1,131210116332003.000000000000000,Block 2003, Block Group 2, Census Tract 116.33, Fulton County, Georgia,115,14,101,83,45,9,4,18
-1,131210116521027.000000000000000,Block 1027, Block Group 1, Census Tract 116.52, Fulton County, Georgia,115,3,112,107,17,22,0,5
-1,131210119013003.000000000000000,Block 3003, Block Group 3, Census Tract 119.01, Fulton County, Georgia,115,6,109,104,16,86,0,5
-1,131210037001001.000000000000000,Block 1001, Block Group 1, Census Tract 37, Fulton County, Georgia,114,2,112,108,2,106,0,4
-1,131210050002010.000000000000000,Block 2010, Block Group 2, Census Tract 50, Fulton County, Georgia,114,114,0,0,0,0,0,0
-1,131210070024001.000000000000000,Block 4001, Block Group 4, Census Tract 70.02, Fulton County, Georgia,114,1,113,107,0,106,0,6
-1,131210089082002.000000000000000,Block 2002, Block Group 2, Census Tract 89.08, Fulton County, Georgia,114,8,106,105,95,6,2,1
-1,131210098022005.000000000000000,Block 2005, Block Group 2, Census Tract 98.02, Fulton County, Georgia,114,0,114,110,100,6,0,4
-1,131210102114002.000000000000000,Block 4002, Block Group 4, Census Tract 102.11, Fulton County, Georgia,114,10,104,96,92,0,0,8
-1,131210103074003.000000000000000,Block 4003, Block Group 4, Census Tract 103.07, Fulton County, Georgia,114,3,111,109,0,109,0,2
-1,131210105372002.000000000000000,Block 2002, Block Group 2, Census Tract 105.37, Fulton County, Georgia,114,0,114,108,1,107,0,6
-1,131210108022011.000000000000000,Block 2011, Block Group 2, Census Tract 108.02, Fulton County, Georgia,114,39,75,73,24,46,0,2
-1,131210115051008.000000000000000,Block 1008, Block Group 1, Census Tract 115.05, Fulton County, Georgia,114,10,104,102,83,6,2,2
-1,131210116321008.000000000000000,Block 1008, Block Group 1, Census Tract 116.32, Fulton County, Georgia,114,9,105,103,15,16,1,2
-1,131210116352007.000000000000000,Block 2007, Block Group 2, Census Tract 116.35, Fulton County, Georgia,114,2,112,107,9,9,0,5
-1,131210116422004.000000000000000,Block 2004, Block Group 2, Census Tract 116.42, Fulton County, Georgia,114,11,103,94,92,1,1,9
-1,131210116462000.000000000000000,Block 2000, Block Group 2, Census Tract 116.46, Fulton County, Georgia,114,13,101,94,61,8,0,7
-1,131210116602013.000000000000000,Block 2013, Block Group 2, Census Tract 116.60, Fulton County, Georgia,114,10,104,99,33,12,3,5
-1,131210120001011.000000000000000,Block 1011, Block Group 1, Census Tract 120, Fulton County, Georgia,114,5,109,107,0,107,0,2
-1,131210001002002.000000000000000,Block 2002, Block Group 2, Census Tract 1, Fulton County, Georgia,113,3,110,109,102,0,2,1
-1,131210001003003.000000000000000,Block 3003, Block Group 3, Census Tract 1, Fulton County, Georgia,113,8,105,97,91,6,0,8
-1,131210005011007.000000000000000,Block 1007, Block Group 1, Census Tract 5.01, Fulton County, Georgia,113,12,101,90,66,9,2,11
-1,131210031001010.000000000000000,Block 1010, Block Group 1, Census Tract 31, Fulton County, Georgia,113,5,108,104,63,31,0,4
-1,131210077032001.000000000000000,Block 2001, Block Group 2, Census Tract 77.03, Fulton County, Georgia,113,5,108,105,0,105,0,3
-1,131210078072002.000000000000000,Block 2002, Block Group 2, Census Tract 78.07, Fulton County, Georgia,113,3,110,110,0,109,0,0
-1,131210080002005.000000000000000,Block 2005, Block Group 2, Census Tract 80, Fulton County, Georgia,113,0,113,111,6,105,0,2
-1,131210084003005.000000000000000,Block 3005, Block Group 3, Census Tract 84, Fulton County, Georgia,113,4,109,105,9,96,0,4
-1,131210086013008.000000000000000,Block 3008, Block Group 3, Census Tract 86.01, Fulton County, Georgia,113,1,112,111,8,102,0,1
-1,131210090022005.000000000000000,Block 2005, Block Group 2, Census Tract 90.02, Fulton County, Georgia,113,0,113,112,109,2,1,1
-1,131210099002009.000000000000000,Block 2009, Block Group 2, Census Tract 99, Fulton County, Georgia,113,1,112,111,105,1,0,1
-1,131210102121003.000000000000000,Block 1003, Block Group 1, Census Tract 102.12, Fulton County, Georgia,113,10,103,98,76,8,0,5
-1,131210102201001.000000000000000,Block 1001, Block Group 1, Census Tract 102.20, Fulton County, Georgia,113,5,108,97,92,2,0,11
-1,131210102201014.000000000000000,Block 1014, Block Group 1, Census Tract 102.20, Fulton County, Georgia,113,14,99,95,95,0,0,4
-1,131210105332010.000000000000000,Block 2010, Block Group 2, Census Tract 105.33, Fulton County, Georgia,113,0,113,111,1,107,0,2
-1,131210108012018.000000000000000,Block 2018, Block Group 2, Census Tract 108.01, Fulton County, Georgia,113,10,103,93,61,30,0,10
-1,131210114293002.000000000000000,Block 3002, Block Group 3, Census Tract 114.29, Fulton County, Georgia,113,15,98,95,51,4,2,3
-1,131210114463001.000000000000000,Block 3001, Block Group 3, Census Tract 114.46, Fulton County, Georgia,113,4,109,105,100,3,0,4
-1,131210115073005.000000000000000,Block 3005, Block Group 3, Census Tract 115.07, Fulton County, Georgia,113,5,108,101,93,5,3,7
-1,131210116292009.000000000000000,Block 2009, Block Group 2, Census Tract 116.29, Fulton County, Georgia,113,15,98,90,67,10,1,8
-1,131210004001010.000000000000000,Block 1010, Block Group 1, Census Tract 4, Fulton County, Georgia,112,1,111,108,98,9,0,3
-1,131210007001007.000000000000000,Block 1007, Block Group 1, Census Tract 7, Fulton County, Georgia,112,2,110,107,53,35,0,3
-1,131210015012003.000000000000000,Block 2003, Block Group 2, Census Tract 15.01, Fulton County, Georgia,112,7,105,99,78,8,0,6
-1,131210041002002.000000000000000,Block 2002, Block Group 2, Census Tract 41, Fulton County, Georgia,112,1,111,108,16,92,0,3
-1,131210052001005.000000000000000,Block 1005, Block Group 1, Census Tract 52, Fulton County, Georgia,112,4,108,105,82,20,1,3
-1,131210052003001.000000000000000,Block 3001, Block Group 3, Census Tract 52, Fulton County, Georgia,112,6,106,101,64,32,0,5
-1,131210066012019.000000000000000,Block 2019, Block Group 2, Census Tract 66.01, Fulton County, Georgia,112,5,107,107,24,83,0,0
-1,131210073011009.000000000000000,Block 1009, Block Group 1, Census Tract 73.01, Fulton County, Georgia,112,0,112,109,0,108,1,3
-1,131210077032014.000000000000000,Block 2014, Block Group 2, Census Tract 77.03, Fulton County, Georgia,112,3,109,106,3,103,0,3
-1,131210079001003.000000000000000,Block 1003, Block Group 1, Census Tract 79, Fulton County, Georgia,112,2,110,102,2,100,0,8
-1,131210079004014.000000000000000,Block 4014, Block Group 4, Census Tract 79, Fulton County, Georgia,112,0,112,111,0,106,2,1
-1,131210091041002.000000000000000,Block 1002, Block Group 1, Census Tract 91.04, Fulton County, Georgia,112,11,101,87,63,17,0,14
-1,131210094051005.000000000000000,Block 1005, Block Group 1, Census Tract 94.05, Fulton County, Georgia,112,13,99,97,50,27,5,2
-1,131210097003011.000000000000000,Block 3011, Block Group 3, Census Tract 97, Fulton County, Georgia,112,8,104,102,91,6,0,2
-1,131210098041005.000000000000000,Block 1005, Block Group 1, Census Tract 98.04, Fulton County, Georgia,112,1,111,109,100,4,1,2
-1,131210105281020.000000000000000,Block 1020, Block Group 1, Census Tract 105.28, Fulton County, Georgia,112,17,95,95,6,89,0,0
-1,131210105382021.000000000000000,Block 2021, Block Group 2, Census Tract 105.38, Fulton County, Georgia,112,2,110,109,2,105,2,1
-1,131210105391005.000000000000000,Block 1005, Block Group 1, Census Tract 105.39, Fulton County, Georgia,112,1,111,108,0,102,1,3
-1,131210110001000.000000000000000,Block 1000, Block Group 1, Census Tract 110, Fulton County, Georgia,112,86,26,21,0,21,0,5
-1,131210116601012.000000000000000,Block 1012, Block Group 1, Census Tract 116.60, Fulton County, Georgia,112,10,102,96,71,10,0,6
-1,131210014003004.000000000000000,Block 3004, Block Group 3, Census Tract 14, Fulton County, Georgia,111,6,105,103,95,2,0,2
-1,131210015021000.000000000000000,Block 1000, Block Group 1, Census Tract 15.02, Fulton County, Georgia,111,7,104,97,92,1,2,7
-1,131210025001002.000000000000000,Block 1002, Block Group 1, Census Tract 25, Fulton County, Georgia,111,9,102,100,8,92,0,2
-1,131210025002010.000000000000000,Block 2010, Block Group 2, Census Tract 25, Fulton County, Georgia,111,4,107,104,1,103,0,3
-1,131210028022003.000000000000000,Block 2003, Block Group 2, Census Tract 28.02, Fulton County, Georgia,111,6,105,102,29,65,2,3
-1,131210041001001.000000000000000,Block 1001, Block Group 1, Census Tract 41, Fulton County, Georgia,111,0,111,109,2,107,0,2
-1,131210061002015.000000000000000,Block 2015, Block Group 2, Census Tract 61, Fulton County, Georgia,111,0,111,110,4,106,0,1
-1,131210080003003.000000000000000,Block 3003, Block Group 3, Census Tract 80, Fulton County, Georgia,111,4,107,100,7,93,0,7
-1,131210082022007.000000000000000,Block 2007, Block Group 2, Census Tract 82.02, Fulton County, Georgia,111,1,110,109,2,106,1,1
-1,131210083021000.000000000000000,Block 1000, Block Group 1, Census Tract 83.02, Fulton County, Georgia,111,2,109,106,0,105,1,3
-1,131210085003031.000000000000000,Block 3031, Block Group 3, Census Tract 85, Fulton County, Georgia,111,2,109,105,1,104,0,4
-1,131210090011001.000000000000000,Block 1001, Block Group 1, Census Tract 90.01, Fulton County, Georgia,111,2,109,104,97,0,4,5
-1,131210090022010.000000000000000,Block 2010, Block Group 2, Census Tract 90.02, Fulton County, Georgia,111,4,107,106,103,2,0,1
-1,131210098021019.000000000000000,Block 1019, Block Group 1, Census Tract 98.02, Fulton County, Georgia,111,4,107,106,106,0,0,1
-1,131210100072003.000000000000000,Block 2003, Block Group 2, Census Tract 100.07, Fulton County, Georgia,111,8,103,102,91,0,0,1
-1,131210102111003.000000000000000,Block 1003, Block Group 1, Census Tract 102.11, Fulton County, Georgia,111,3,108,105,98,6,1,3
-1,131210102202004.000000000000000,Block 2004, Block Group 2, Census Tract 102.20, Fulton County, Georgia,111,4,107,94,75,11,0,13
-1,131210102232004.000000000000000,Block 2004, Block Group 2, Census Tract 102.23, Fulton County, Georgia,111,2,109,105,65,31,0,4
-1,131210103122034.000000000000000,Block 2034, Block Group 2, Census Tract 103.12, Fulton County, Georgia,111,0,111,108,0,108,0,3
-1,131210106043005.000000000000000,Block 3005, Block Group 3, Census Tract 106.04, Fulton County, Georgia,111,15,96,94,1,87,4,2
-1,131210112024012.000000000000000,Block 4012, Block Group 4, Census Tract 112.02, Fulton County, Georgia,111,25,86,80,44,33,2,6
-1,131210114164006.000000000000000,Block 4006, Block Group 4, Census Tract 114.16, Fulton County, Georgia,111,1,110,100,84,9,0,10
-1,131210114372015.000000000000000,Block 2015, Block Group 2, Census Tract 114.37, Fulton County, Georgia,111,26,85,75,64,6,0,10
-1,131210115071010.000000000000000,Block 1010, Block Group 1, Census Tract 115.07, Fulton County, Georgia,111,1,110,102,100,2,0,8
-1,131210115152003.000000000000000,Block 2003, Block Group 2, Census Tract 115.15, Fulton County, Georgia,111,2,109,95,91,0,0,14
-1,131210116282006.000000000000000,Block 2006, Block Group 2, Census Tract 116.28, Fulton County, Georgia,111,3,108,91,84,1,3,17
-1,131210070013002.000000000000000,Block 3002, Block Group 3, Census Tract 70.01, Fulton County, Georgia,110,4,106,103,0,103,0,3
-1,131210070021001.000000000000000,Block 1001, Block Group 1, Census Tract 70.02, Fulton County, Georgia,110,3,107,101,5,96,0,6
-1,131210078091001.000000000000000,Block 1001, Block Group 1, Census Tract 78.09, Fulton County, Georgia,110,0,110,108,0,108,0,2
-1,131210081043010.000000000000000,Block 3010, Block Group 3, Census Tract 81.04, Fulton County, Georgia,110,0,110,109,6,103,0,1
-1,131210082042002.000000000000000,Block 2002, Block Group 2, Census Tract 82.04, Fulton County, Georgia,110,5,105,104,0,103,0,1
-1,131210085003000.000000000000000,Block 3000, Block Group 3, Census Tract 85, Fulton County, Georgia,110,2,108,93,0,91,0,15
-1,131210088011007.000000000000000,Block 1007, Block Group 1, Census Tract 88.01, Fulton County, Georgia,110,2,108,102,73,22,0,6
-1,131210091051010.000000000000000,Block 1010, Block Group 1, Census Tract 91.05, Fulton County, Georgia,110,1,109,107,102,1,0,2
-1,131210101211001.000000000000000,Block 1001, Block Group 1, Census Tract 101.21, Fulton County, Georgia,110,11,99,98,75,8,1,1
-1,131210102201005.000000000000000,Block 1005, Block Group 1, Census Tract 102.20, Fulton County, Georgia,110,5,105,103,95,0,2,2
-1,131210103091025.000000000000000,Block 1025, Block Group 1, Census Tract 103.09, Fulton County, Georgia,110,1,109,104,5,99,0,5
-1,131210105362015.000000000000000,Block 2015, Block Group 2, Census Tract 105.36, Fulton County, Georgia,110,10,100,98,4,94,0,2
-1,131210105401029.000000000000000,Block 1029, Block Group 1, Census Tract 105.40, Fulton County, Georgia,110,8,102,101,1,94,0,1
-1,131210113071014.000000000000000,Block 1014, Block Group 1, Census Tract 113.07, Fulton County, Georgia,110,6,104,102,8,94,0,2
-1,131210113091001.000000000000000,Block 1001, Block Group 1, Census Tract 113.09, Fulton County, Georgia,110,12,98,92,0,89,1,6
-1,131210114192003.000000000000000,Block 2003, Block Group 2, Census Tract 114.19, Fulton County, Georgia,110,10,100,95,65,6,0,5
-1,131210116292008.000000000000000,Block 2008, Block Group 2, Census Tract 116.29, Fulton County, Georgia,110,17,93,89,67,5,0,4
-1,131210005011006.000000000000000,Block 1006, Block Group 1, Census Tract 5.01, Fulton County, Georgia,109,1,108,103,69,12,0,5
-1,131210012042003.000000000000000,Block 2003, Block Group 2, Census Tract 12.04, Fulton County, Georgia,109,4,105,104,88,9,0,1
-1,131210019023007.000000000000000,Block 3007, Block Group 3, Census Tract 19.02, Fulton County, Georgia,109,0,109,108,26,81,0,1
-1,131210062001017.000000000000000,Block 1017, Block Group 1, Census Tract 62, Fulton County, Georgia,109,1,108,108,1,107,0,0
-1,131210081043019.000000000000000,Block 3019, Block Group 3, Census Tract 81.04, Fulton County, Georgia,109,3,106,102,6,96,0,4
-1,131210082042010.000000000000000,Block 2010, Block Group 2, Census Tract 82.04, Fulton County, Georgia,109,0,109,108,8,99,1,1
-1,131210100052017.000000000000000,Block 2017, Block Group 2, Census Tract 100.05, Fulton County, Georgia,109,3,106,100,94,5,1,6
-1,131210100052020.000000000000000,Block 2020, Block Group 2, Census Tract 100.05, Fulton County, Georgia,109,5,104,104,83,10,0,0
-1,131210101171003.000000000000000,Block 1003, Block Group 1, Census Tract 101.17, Fulton County, Georgia,109,12,97,91,39,28,1,6
-1,131210105274004.000000000000000,Block 4004, Block Group 4, Census Tract 105.27, Fulton County, Georgia,109,2,107,106,5,99,0,1
-1,131210113011008.000000000000000,Block 1008, Block Group 1, Census Tract 113.01, Fulton County, Georgia,109,18,91,91,21,70,0,0
-1,131210114231005.000000000000000,Block 1005, Block Group 1, Census Tract 114.23, Fulton County, Georgia,109,3,106,94,88,5,1,12
-1,131210116301003.000000000000000,Block 1003, Block Group 1, Census Tract 116.30, Fulton County, Georgia,109,10,99,90,27,26,2,9
-1,131210116383007.000000000000000,Block 3007, Block Group 3, Census Tract 116.38, Fulton County, Georgia,109,6,103,97,33,9,0,6
-1,131210002023008.000000000000000,Block 3008, Block Group 3, Census Tract 2.02, Fulton County, Georgia,108,6,102,98,94,1,0,4
-1,131210019011002.000000000000000,Block 1002, Block Group 1, Census Tract 19.01, Fulton County, Georgia,108,1,107,103,4,99,0,4
-1,131210073013003.000000000000000,Block 3003, Block Group 3, Census Tract 73.01, Fulton County, Georgia,108,12,96,92,6,84,0,4
-1,131210076023000.000000000000000,Block 3000, Block Group 3, Census Tract 76.02, Fulton County, Georgia,108,1,107,104,2,102,0,3
-1,131210087011017.000000000000000,Block 1017, Block Group 1, Census Tract 87.01, Fulton County, Georgia,108,4,104,101,8,93,0,3
-1,131210091051003.000000000000000,Block 1003, Block Group 1, Census Tract 91.05, Fulton County, Georgia,108,0,108,106,105,0,0,2
-1,131210095012003.000000000000000,Block 2003, Block Group 2, Census Tract 95.01, Fulton County, Georgia,108,0,108,108,108,0,0,0
-1,131210095012006.000000000000000,Block 2006, Block Group 2, Census Tract 95.01, Fulton County, Georgia,108,1,107,105,105,0,0,2
-1,131210095012011.000000000000000,Block 2011, Block Group 2, Census Tract 95.01, Fulton County, Georgia,108,0,108,107,107,0,0,1
-1,131210099002005.000000000000000,Block 2005, Block Group 2, Census Tract 99, Fulton County, Georgia,108,0,108,108,107,1,0,0
-1,131210102113004.000000000000000,Block 3004, Block Group 3, Census Tract 102.11, Fulton County, Georgia,108,7,101,99,85,5,0,2
-1,131210102162008.000000000000000,Block 2008, Block Group 2, Census Tract 102.16, Fulton County, Georgia,108,14,94,90,76,7,2,4
-1,131210105341010.000000000000000,Block 1010, Block Group 1, Census Tract 105.34, Fulton County, Georgia,108,12,96,92,1,91,0,4
-1,131210105382014.000000000000000,Block 2014, Block Group 2, Census Tract 105.38, Fulton County, Georgia,108,1,107,106,7,99,0,1
-1,131210105391027.000000000000000,Block 1027, Block Group 1, Census Tract 105.39, Fulton County, Georgia,108,1,107,107,0,107,0,0
-1,131210105392027.000000000000000,Block 2027, Block Group 2, Census Tract 105.39, Fulton County, Georgia,108,3,105,103,1,100,1,2
-1,131210114163001.000000000000000,Block 3001, Block Group 3, Census Tract 114.16, Fulton County, Georgia,108,10,98,96,87,4,0,2
-1,131210115073007.000000000000000,Block 3007, Block Group 3, Census Tract 115.07, Fulton County, Georgia,108,2,106,106,104,0,0,0
-1,131210116383015.000000000000000,Block 3015, Block Group 3, Census Tract 116.38, Fulton County, Georgia,108,32,76,70,57,13,0,6
-1,131210006021001.000000000000000,Block 1001, Block Group 1, Census Tract 6.02, Fulton County, Georgia,107,5,102,89,48,27,0,13
-1,131210013012003.000000000000000,Block 2003, Block Group 2, Census Tract 13.01, Fulton County, Georgia,107,10,97,92,79,3,5,5
-1,131210021002000.000000000000000,Block 2000, Block Group 2, Census Tract 21, Fulton County, Georgia,107,6,101,100,12,82,0,1
-1,131210067012006.000000000000000,Block 2006, Block Group 2, Census Tract 67.01, Fulton County, Georgia,107,0,107,106,1,105,0,1
-1,131210070021000.000000000000000,Block 1000, Block Group 1, Census Tract 70.02, Fulton County, Georgia,107,9,98,97,6,90,0,1
-1,131210075003005.000000000000000,Block 3005, Block Group 3, Census Tract 75, Fulton County, Georgia,107,10,97,97,0,90,0,0
-1,131210078081009.000000000000000,Block 1009, Block Group 1, Census Tract 78.08, Fulton County, Georgia,107,2,105,104,0,100,0,1
-1,131210082021009.000000000000000,Block 1009, Block Group 1, Census Tract 82.02, Fulton County, Georgia,107,3,104,102,0,102,0,2
-1,131210087013007.000000000000000,Block 3007, Block Group 3, Census Tract 87.01, Fulton County, Georgia,107,0,107,103,5,96,2,4
-1,131210099003011.000000000000000,Block 3011, Block Group 3, Census Tract 99, Fulton County, Georgia,107,4,103,94,94,0,0,9
-1,131210101211004.000000000000000,Block 1004, Block Group 1, Census Tract 101.21, Fulton County, Georgia,107,14,93,90,38,15,0,3
-1,131210102111000.000000000000000,Block 1000, Block Group 1, Census Tract 102.11, Fulton County, Georgia,107,7,100,93,91,0,0,7
-1,131210102151003.000000000000000,Block 1003, Block Group 1, Census Tract 102.15, Fulton County, Georgia,107,19,88,85,36,49,0,3
-1,131210102172000.000000000000000,Block 2000, Block Group 2, Census Tract 102.17, Fulton County, Georgia,107,15,92,87,62,13,3,5
-1,131210103103000.000000000000000,Block 3000, Block Group 3, Census Tract 103.10, Fulton County, Georgia,107,1,106,102,0,102,0,4
-1,131210103122018.000000000000000,Block 2018, Block Group 2, Census Tract 103.12, Fulton County, Georgia,107,10,97,97,1,96,0,0
-1,131210103153005.000000000000000,Block 3005, Block Group 3, Census Tract 103.15, Fulton County, Georgia,107,0,107,102,0,101,1,5
-1,131210105291017.000000000000000,Block 1017, Block Group 1, Census Tract 105.29, Fulton County, Georgia,107,3,104,104,9,90,5,0
-1,131210105352012.000000000000000,Block 2012, Block Group 2, Census Tract 105.35, Fulton County, Georgia,107,27,80,77,35,40,0,3
-1,131210114323000.000000000000000,Block 3000, Block Group 3, Census Tract 114.32, Fulton County, Georgia,107,12,95,95,80,5,0,0
-1,131210114462001.000000000000000,Block 2001, Block Group 2, Census Tract 114.46, Fulton County, Georgia,107,6,101,93,88,1,4,8
-1,131210115103006.000000000000000,Block 3006, Block Group 3, Census Tract 115.10, Fulton County, Georgia,107,15,92,91,87,0,0,1
-1,131210115131013.000000000000000,Block 1013, Block Group 1, Census Tract 115.13, Fulton County, Georgia,107,4,103,100,96,4,0,3
-1,131210116271003.000000000000000,Block 1003, Block Group 1, Census Tract 116.27, Fulton County, Georgia,107,11,96,91,43,8,0,5
-1,131210116533003.000000000000000,Block 3003, Block Group 3, Census Tract 116.53, Fulton County, Georgia,107,13,94,84,65,10,1,10
-1,131210021002004.000000000000000,Block 2004, Block Group 2, Census Tract 21, Fulton County, Georgia,106,1,105,93,0,89,0,12
-1,131210050001000.000000000000000,Block 1000, Block Group 1, Census Tract 50, Fulton County, Georgia,106,7,99,97,78,14,0,2
-1,131210072001002.000000000000000,Block 1002, Block Group 1, Census Tract 72, Fulton County, Georgia,106,0,106,105,4,100,1,1
-1,131210074002010.000000000000000,Block 2010, Block Group 2, Census Tract 74, Fulton County, Georgia,106,6,100,99,0,92,0,1
-1,131210077103001.000000000000000,Block 3001, Block Group 3, Census Tract 77.10, Fulton County, Georgia,106,3,103,100,0,100,0,3
-1,131210077103005.000000000000000,Block 3005, Block Group 3, Census Tract 77.10, Fulton County, Georgia,106,9,97,94,0,93,0,3
-1,131210080003000.000000000000000,Block 3000, Block Group 3, Census Tract 80, Fulton County, Georgia,106,4,102,102,13,87,2,0
-1,131210087022012.000000000000000,Block 2012, Block Group 2, Census Tract 87.02, Fulton County, Georgia,106,2,104,104,7,94,0,0
-1,131210090022004.000000000000000,Block 2004, Block Group 2, Census Tract 90.02, Fulton County, Georgia,106,0,106,106,106,0,0,0
-1,131210092022017.000000000000000,Block 2017, Block Group 2, Census Tract 92.02, Fulton County, Georgia,106,12,94,78,77,0,0,16
-1,131210095041000.000000000000000,Block 1000, Block Group 1, Census Tract 95.04, Fulton County, Georgia,106,0,106,98,94,0,0,8
-1,131210098022007.000000000000000,Block 2007, Block Group 2, Census Tract 98.02, Fulton County, Georgia,106,1,105,103,73,9,0,2
-1,131210102201012.000000000000000,Block 1012, Block Group 1, Census Tract 102.20, Fulton County, Georgia,106,9,97,97,91,0,0,0
-1,131210103081000.000000000000000,Block 1000, Block Group 1, Census Tract 103.08, Fulton County, Georgia,106,8,98,89,0,87,0,9
-1,131210105191015.000000000000000,Block 1015, Block Group 1, Census Tract 105.19, Fulton County, Georgia,106,9,97,97,1,95,1,0
-1,131210105191022.000000000000000,Block 1022, Block Group 1, Census Tract 105.19, Fulton County, Georgia,106,8,98,98,0,97,0,0
-1,131210105264009.000000000000000,Block 4009, Block Group 4, Census Tract 105.26, Fulton County, Georgia,106,9,97,97,1,95,0,0
-1,131210105284003.000000000000000,Block 4003, Block Group 4, Census Tract 105.28, Fulton County, Georgia,106,4,102,102,8,94,0,0
-1,131210105382016.000000000000000,Block 2016, Block Group 2, Census Tract 105.38, Fulton County, Georgia,106,9,97,93,3,89,1,4
-1,131210113061026.000000000000000,Block 1026, Block Group 1, Census Tract 113.06, Fulton County, Georgia,106,5,101,100,1,99,0,1
-1,131210114352007.000000000000000,Block 2007, Block Group 2, Census Tract 114.35, Fulton County, Georgia,106,6,100,100,96,4,0,0
-1,131210114363001.000000000000000,Block 3001, Block Group 3, Census Tract 114.36, Fulton County, Georgia,106,1,105,98,60,18,0,7
-1,131210114371008.000000000000000,Block 1008, Block Group 1, Census Tract 114.37, Fulton County, Georgia,106,37,69,68,34,30,0,1
-1,131210114381002.000000000000000,Block 1002, Block Group 1, Census Tract 114.38, Fulton County, Georgia,106,49,57,52,12,30,2,5
-1,131210115091015.000000000000000,Block 1015, Block Group 1, Census Tract 115.09, Fulton County, Georgia,106,14,92,83,78,0,3,9
-1,131210115111005.000000000000000,Block 1005, Block Group 1, Census Tract 115.11, Fulton County, Georgia,106,6,100,99,59,9,0,1
-1,131210115131006.000000000000000,Block 1006, Block Group 1, Census Tract 115.13, Fulton County, Georgia,106,2,104,94,82,11,0,10
-1,131210116371000.000000000000000,Block 1000, Block Group 1, Census Tract 116.37, Fulton County, Georgia,106,5,101,97,63,6,0,4
-1,131210116474005.000000000000000,Block 4005, Block Group 4, Census Tract 116.47, Fulton County, Georgia,106,39,67,65,32,28,0,2
-1,131210120003038.000000000000000,Block 3038, Block Group 3, Census Tract 120, Fulton County, Georgia,106,1,105,105,9,95,1,0
-1,131210123002037.000000000000000,Block 2037, Block Group 2, Census Tract 123, Fulton County, Georgia,106,16,90,90,55,35,0,0
-1,131210002022008.000000000000000,Block 2008, Block Group 2, Census Tract 2.02, Fulton County, Georgia,105,1,104,98,95,0,1,6
-1,131210002022011.000000000000000,Block 2011, Block Group 2, Census Tract 2.02, Fulton County, Georgia,105,1,104,98,96,0,0,6
-1,131210005012010.000000000000000,Block 2010, Block Group 2, Census Tract 5.01, Fulton County, Georgia,105,9,96,96,28,55,0,0
-1,131210010022017.000000000000000,Block 2017, Block Group 2, Census Tract 10.02, Fulton County, Georgia,105,14,91,89,77,0,0,2
-1,131210011013001.000000000000000,Block 3001, Block Group 3, Census Tract 11.01, Fulton County, Georgia,105,12,93,85,65,10,5,8
-1,131210012032002.000000000000000,Block 2002, Block Group 2, Census Tract 12.03, Fulton County, Georgia,105,11,94,86,58,9,2,8
-1,131210015021003.000000000000000,Block 1003, Block Group 1, Census Tract 15.02, Fulton County, Georgia,105,7,98,92,87,4,0,6
-1,131210021001022.000000000000000,Block 1022, Block Group 1, Census Tract 21, Fulton County, Georgia,105,8,97,92,57,27,0,5
-1,131210030001019.000000000000000,Block 1019, Block Group 1, Census Tract 30, Fulton County, Georgia,105,0,105,92,89,3,0,13
-1,131210052001003.000000000000000,Block 1003, Block Group 1, Census Tract 52, Fulton County, Georgia,105,11,94,89,79,4,0,5
-1,131210076023007.000000000000000,Block 3007, Block Group 3, Census Tract 76.02, Fulton County, Georgia,105,0,105,103,0,103,0,2
-1,131210081042003.000000000000000,Block 2003, Block Group 2, Census Tract 81.04, Fulton County, Georgia,105,0,105,94,2,92,0,11
-1,131210082041003.000000000000000,Block 1003, Block Group 1, Census Tract 82.04, Fulton County, Georgia,105,2,103,102,7,95,0,1
-1,131210091032001.000000000000000,Block 2001, Block Group 2, Census Tract 91.03, Fulton County, Georgia,105,13,92,90,63,19,0,2
-1,131210099004003.000000000000000,Block 4003, Block Group 4, Census Tract 99, Fulton County, Georgia,105,14,91,84,84,0,0,7
-1,131210101273005.000000000000000,Block 3005, Block Group 3, Census Tract 101.27, Fulton County, Georgia,105,7,98,94,38,33,0,4
-1,131210101281000.000000000000000,Block 1000, Block Group 1, Census Tract 101.28, Fulton County, Georgia,105,40,65,58,39,9,0,7
-1,131210105171002.000000000000000,Block 1002, Block Group 1, Census Tract 105.17, Fulton County, Georgia,105,15,90,84,0,79,5,6
-1,131210105311004.000000000000000,Block 1004, Block Group 1, Census Tract 105.31, Fulton County, Georgia,105,2,103,102,4,92,3,1
-1,131210105401015.000000000000000,Block 1015, Block Group 1, Census Tract 105.40, Fulton County, Georgia,105,12,93,92,8,84,0,1
-1,131210114301011.000000000000000,Block 1011, Block Group 1, Census Tract 114.30, Fulton County, Georgia,105,89,16,14,4,9,0,2
-1,131210114452007.000000000000000,Block 2007, Block Group 2, Census Tract 114.45, Fulton County, Georgia,105,10,95,87,85,2,0,8
-1,131210115131000.000000000000000,Block 1000, Block Group 1, Census Tract 115.13, Fulton County, Georgia,105,7,98,97,95,1,0,1
-1,131210116271001.000000000000000,Block 1001, Block Group 1, Census Tract 116.27, Fulton County, Georgia,105,5,100,89,52,16,1,11
-1,131210116383012.000000000000000,Block 3012, Block Group 3, Census Tract 116.38, Fulton County, Georgia,105,13,92,87,64,14,0,5
-1,131210116552006.000000000000000,Block 2006, Block Group 2, Census Tract 116.55, Fulton County, Georgia,105,1,104,104,87,10,0,0
-1,131210001001003.000000000000000,Block 1003, Block Group 1, Census Tract 1, Fulton County, Georgia,104,0,104,99,97,1,1,5
-1,131210005011008.000000000000000,Block 1008, Block Group 1, Census Tract 5.01, Fulton County, Georgia,104,4,100,97,67,13,0,3
-1,131210013012004.000000000000000,Block 2004, Block Group 2, Census Tract 13.01, Fulton County, Georgia,104,2,102,89,85,2,0,13
-1,131210015021010.000000000000000,Block 1010, Block Group 1, Census Tract 15.02, Fulton County, Georgia,104,10,94,84,66,8,0,10
-1,131210030002006.000000000000000,Block 2006, Block Group 2, Census Tract 30, Fulton County, Georgia,104,8,96,88,70,17,0,8
-1,131210065001001.000000000000000,Block 1001, Block Group 1, Census Tract 65, Fulton County, Georgia,104,10,94,94,11,83,0,0
-1,131210070022010.000000000000000,Block 2010, Block Group 2, Census Tract 70.02, Fulton County, Georgia,104,63,41,38,17,21,0,3
-1,131210073012002.000000000000000,Block 2002, Block Group 2, Census Tract 73.01, Fulton County, Georgia,104,6,98,96,0,95,0,2
-1,131210093012001.000000000000000,Block 2001, Block Group 2, Census Tract 93.01, Fulton County, Georgia,104,0,104,98,98,0,0,6
-1,131210094101000.000000000000000,Block 1000, Block Group 1, Census Tract 94.10, Fulton County, Georgia,104,5,99,95,57,24,2,4
-1,131210096061010.000000000000000,Block 1010, Block Group 1, Census Tract 96.06, Fulton County, Georgia,104,13,91,81,74,2,0,10
-1,131210099004002.000000000000000,Block 4002, Block Group 4, Census Tract 99, Fulton County, Georgia,104,8,96,93,87,0,4,3
-1,131210101071007.000000000000000,Block 1007, Block Group 1, Census Tract 101.07, Fulton County, Georgia,104,6,98,95,94,0,0,3
-1,131210101361006.000000000000000,Block 1006, Block Group 1, Census Tract 101.36, Fulton County, Georgia,104,6,98,94,84,6,0,4
-1,131210102042014.000000000000000,Block 2014, Block Group 2, Census Tract 102.04, Fulton County, Georgia,104,5,99,94,84,3,0,5
-1,131210103151011.000000000000000,Block 1011, Block Group 1, Census Tract 103.15, Fulton County, Georgia,104,1,103,103,0,103,0,0
-1,131210105172000.000000000000000,Block 2000, Block Group 2, Census Tract 105.17, Fulton County, Georgia,104,0,104,104,0,101,3,0
-1,131210105182006.000000000000000,Block 2006, Block Group 2, Census Tract 105.18, Fulton County, Georgia,104,10,94,92,3,89,0,2
-1,131210105262006.000000000000000,Block 2006, Block Group 2, Census Tract 105.26, Fulton County, Georgia,104,5,99,97,2,95,0,2
-1,131210108012015.000000000000000,Block 2015, Block Group 2, Census Tract 108.01, Fulton County, Georgia,104,23,81,78,6,69,2,3
-1,131210108022001.000000000000000,Block 2001, Block Group 2, Census Tract 108.02, Fulton County, Georgia,104,40,64,60,6,53,0,4
-1,131210113093010.000000000000000,Block 3010, Block Group 3, Census Tract 113.09, Fulton County, Georgia,104,2,102,101,5,93,0,1
-1,131210114413001.000000000000000,Block 3001, Block Group 3, Census Tract 114.41, Fulton County, Georgia,104,3,101,91,77,7,2,10
-1,131210116422002.000000000000000,Block 2002, Block Group 2, Census Tract 116.42, Fulton County, Georgia,104,20,84,82,77,5,0,2
-1,131210116571002.000000000000000,Block 1002, Block Group 1, Census Tract 116.57, Fulton County, Georgia,104,6,98,93,62,23,1,5
-1,131210001005001.000000000000000,Block 5001, Block Group 5, Census Tract 1, Fulton County, Georgia,103,1,102,98,83,2,1,4
-1,131210012041005.000000000000000,Block 1005, Block Group 1, Census Tract 12.04, Fulton County, Georgia,103,7,96,94,72,17,0,2
-1,131210014002000.000000000000000,Block 2000, Block Group 2, Census Tract 14, Fulton County, Georgia,103,1,102,95,74,10,0,7
-1,131210018012001.000000000000000,Block 2001, Block Group 2, Census Tract 18.01, Fulton County, Georgia,103,7,96,88,52,29,0,8
-1,131210035001013.000000000000000,Block 1013, Block Group 1, Census Tract 35, Fulton County, Georgia,103,2,101,97,32,62,0,4
-1,131210067011010.000000000000000,Block 1010, Block Group 1, Census Tract 67.01, Fulton County, Georgia,103,5,98,97,5,92,0,1
-1,131210070021003.000000000000000,Block 1003, Block Group 1, Census Tract 70.02, Fulton County, Georgia,103,7,96,96,0,94,1,0
-1,131210077082001.000000000000000,Block 2001, Block Group 2, Census Tract 77.08, Fulton County, Georgia,103,0,103,101,2,97,0,2
-1,131210082031003.000000000000000,Block 1003, Block Group 1, Census Tract 82.03, Fulton County, Georgia,103,3,100,99,4,95,0,1
-1,131210097001000.000000000000000,Block 1000, Block Group 1, Census Tract 97, Fulton County, Georgia,103,4,99,99,88,4,3,0
-1,131210101242003.000000000000000,Block 2003, Block Group 2, Census Tract 101.24, Fulton County, Georgia,103,24,79,75,7,68,0,4
-1,131210103092025.000000000000000,Block 2025, Block Group 2, Census Tract 103.09, Fulton County, Georgia,103,1,102,99,3,94,0,3
-1,131210103093001.000000000000000,Block 3001, Block Group 3, Census Tract 103.09, Fulton County, Georgia,103,3,100,96,0,96,0,4
-1,131210105171001.000000000000000,Block 1001, Block Group 1, Census Tract 105.17, Fulton County, Georgia,103,2,101,100,7,89,4,1
-1,131210105171004.000000000000000,Block 1004, Block Group 1, Census Tract 105.17, Fulton County, Georgia,103,0,103,103,6,97,0,0
-1,131210114174003.000000000000000,Block 4003, Block Group 4, Census Tract 114.17, Fulton County, Georgia,103,17,86,81,78,3,0,5
-1,131210115103001.000000000000000,Block 3001, Block Group 3, Census Tract 115.10, Fulton County, Georgia,103,2,101,98,69,15,0,3
-1,131210115151007.000000000000000,Block 1007, Block Group 1, Census Tract 115.15, Fulton County, Georgia,103,25,78,75,74,0,1,3
-1,131210116372012.000000000000000,Block 2012, Block Group 2, Census Tract 116.37, Fulton County, Georgia,103,7,96,89,37,23,0,7
-1,131210116462006.000000000000000,Block 2006, Block Group 2, Census Tract 116.46, Fulton County, Georgia,103,54,49,42,33,5,0,7
-1,131210119011040.000000000000000,Block 1040, Block Group 1, Census Tract 119.01, Fulton County, Georgia,103,2,101,95,52,34,0,6
-1,131210002023006.000000000000000,Block 3006, Block Group 3, Census Tract 2.02, Fulton County, Georgia,102,2,100,93,78,3,0,7
-1,131210004001000.000000000000000,Block 1000, Block Group 1, Census Tract 4, Fulton County, Georgia,102,10,92,90,86,2,0,2
-1,131210010011008.000000000000000,Block 1008, Block Group 1, Census Tract 10.01, Fulton County, Georgia,102,16,86,82,55,10,0,4
-1,131210013022006.000000000000000,Block 2006, Block Group 2, Census Tract 13.02, Fulton County, Georgia,102,6,96,95,87,1,0,1
-1,131210035002038.000000000000000,Block 2038, Block Group 2, Census Tract 35, Fulton County, Georgia,102,3,99,96,11,85,0,3
-1,131210053001006.000000000000000,Block 1006, Block Group 1, Census Tract 53, Fulton County, Georgia,102,5,97,94,9,85,0,3
-1,131210053001008.000000000000000,Block 1008, Block Group 1, Census Tract 53, Fulton County, Georgia,102,5,97,96,44,52,0,1
-1,131210079002007.000000000000000,Block 2007, Block Group 2, Census Tract 79, Fulton County, Georgia,102,1,101,101,6,95,0,0
-1,131210079003017.000000000000000,Block 3017, Block Group 3, Census Tract 79, Fulton County, Georgia,102,5,97,96,2,93,1,1
-1,131210082043005.000000000000000,Block 3005, Block Group 3, Census Tract 82.04, Fulton County, Georgia,102,0,102,99,4,95,0,3
-1,131210091033006.000000000000000,Block 3006, Block Group 3, Census Tract 91.03, Fulton County, Georgia,102,9,93,90,59,30,0,3
-1,131210093021003.000000000000000,Block 1003, Block Group 1, Census Tract 93.02, Fulton County, Georgia,102,2,100,98,92,6,0,2
-1,131210095011005.000000000000000,Block 1005, Block Group 1, Census Tract 95.01, Fulton County, Georgia,102,4,98,96,96,0,0,2
-1,131210095041009.000000000000000,Block 1009, Block Group 1, Census Tract 95.04, Fulton County, Georgia,102,2,100,98,87,9,1,2
-1,131210096011001.000000000000000,Block 1001, Block Group 1, Census Tract 96.01, Fulton County, Georgia,102,12,90,88,76,2,0,2
-1,131210099002003.000000000000000,Block 2003, Block Group 2, Census Tract 99, Fulton County, Georgia,102,3,99,98,95,0,0,1
-1,131210100052007.000000000000000,Block 2007, Block Group 2, Census Tract 100.05, Fulton County, Georgia,102,2,100,97,94,0,0,3
-1,131210102201017.000000000000000,Block 1017, Block Group 1, Census Tract 102.20, Fulton County, Georgia,102,7,95,87,85,0,1,8
-1,131210104011030.000000000000000,Block 1030, Block Group 1, Census Tract 104.01, Fulton County, Georgia,102,13,89,86,14,70,0,3
-1,131210105261005.000000000000000,Block 1005, Block Group 1, Census Tract 105.26, Fulton County, Georgia,102,0,102,102,2,100,0,0
-1,131210105291020.000000000000000,Block 1020, Block Group 1, Census Tract 105.29, Fulton County, Georgia,102,3,99,99,1,95,3,0
-1,131210105322005.000000000000000,Block 2005, Block Group 2, Census Tract 105.32, Fulton County, Georgia,102,14,88,84,0,84,0,4
-1,131210110003016.000000000000000,Block 3016, Block Group 3, Census Tract 110, Fulton County, Georgia,102,35,67,60,5,53,0,7
-1,131210114161012.000000000000000,Block 1012, Block Group 1, Census Tract 114.16, Fulton County, Georgia,102,9,93,86,80,1,2,7
-1,131210116383003.000000000000000,Block 3003, Block Group 3, Census Tract 116.38, Fulton County, Georgia,102,2,100,90,55,19,2,10
-1,131210116392001.000000000000000,Block 2001, Block Group 2, Census Tract 116.39, Fulton County, Georgia,102,17,85,76,42,22,0,9
-1,131210116471011.000000000000000,Block 1011, Block Group 1, Census Tract 116.47, Fulton County, Georgia,102,15,87,83,73,1,3,4
-1,131210001002000.000000000000000,Block 2000, Block Group 2, Census Tract 1, Fulton County, Georgia,101,4,97,90,82,4,0,7
-1,131210002021002.000000000000000,Block 1002, Block Group 1, Census Tract 2.02, Fulton County, Georgia,101,8,93,90,86,3,0,3
-1,131210005021011.000000000000000,Block 1011, Block Group 1, Census Tract 5.02, Fulton County, Georgia,101,3,98,95,93,1,0,3
-1,131210013011011.000000000000000,Block 1011, Block Group 1, Census Tract 13.01, Fulton County, Georgia,101,20,81,79,74,4,1,2
-1,131210025003000.000000000000000,Block 3000, Block Group 3, Census Tract 25, Fulton County, Georgia,101,1,100,97,0,97,0,3
-1,131210040001006.000000000000000,Block 1006, Block Group 1, Census Tract 40, Fulton County, Georgia,101,5,96,95,7,86,0,1
-1,131210053001012.000000000000000,Block 1012, Block Group 1, Census Tract 53, Fulton County, Georgia,101,1,100,98,27,71,0,2
-1,131210064001001.000000000000000,Block 1001, Block Group 1, Census Tract 64, Fulton County, Georgia,101,13,88,88,40,48,0,0
-1,131210070023005.000000000000000,Block 3005, Block Group 3, Census Tract 70.02, Fulton County, Georgia,101,10,91,89,13,76,0,2
-1,131210072002005.000000000000000,Block 2005, Block Group 2, Census Tract 72, Fulton County, Georgia,101,8,93,93,1,90,2,0
-1,131210074002007.000000000000000,Block 2007, Block Group 2, Census Tract 74, Fulton County, Georgia,101,16,85,84,4,77,0,1
-1,131210076041001.000000000000000,Block 1001, Block Group 1, Census Tract 76.04, Fulton County, Georgia,101,10,91,77,2,74,1,14
-1,131210078072001.000000000000000,Block 2001, Block Group 2, Census Tract 78.07, Fulton County, Georgia,101,30,71,71,0,70,1,0
-1,131210093012007.000000000000000,Block 2007, Block Group 2, Census Tract 93.01, Fulton County, Georgia,101,0,101,98,93,0,0,3
-1,131210095013007.000000000000000,Block 3007, Block Group 3, Census Tract 95.01, Fulton County, Georgia,101,11,90,86,86,0,0,4
-1,131210103072005.000000000000000,Block 2005, Block Group 2, Census Tract 103.07, Fulton County, Georgia,101,0,101,97,6,88,2,4
-1,131210103093014.000000000000000,Block 3014, Block Group 3, Census Tract 103.09, Fulton County, Georgia,101,2,99,99,0,99,0,0
-1,131210104023012.000000000000000,Block 3012, Block Group 3, Census Tract 104.02, Fulton County, Georgia,101,8,93,86,69,17,0,7
-1,131210105183007.000000000000000,Block 3007, Block Group 3, Census Tract 105.18, Fulton County, Georgia,101,2,99,99,0,99,0,0
-1,131210105281009.000000000000000,Block 1009, Block Group 1, Census Tract 105.28, Fulton County, Georgia,101,19,82,78,0,76,0,4
-1,131210114234007.000000000000000,Block 4007, Block Group 4, Census Tract 114.23, Fulton County, Georgia,101,3,98,91,79,0,6,7
-1,131210114401003.000000000000000,Block 1003, Block Group 1, Census Tract 114.40, Fulton County, Georgia,101,5,96,96,71,13,2,0
-1,131210115053003.000000000000000,Block 3003, Block Group 3, Census Tract 115.05, Fulton County, Georgia,101,5,96,86,64,19,0,10
-1,131210116281002.000000000000000,Block 1002, Block Group 1, Census Tract 116.28, Fulton County, Georgia,101,6,95,85,26,13,0,10
-1,131210116281003.000000000000000,Block 1003, Block Group 1, Census Tract 116.28, Fulton County, Georgia,101,8,93,84,11,11,0,9
-1,131210120003027.000000000000000,Block 3027, Block Group 3, Census Tract 120, Fulton County, Georgia,101,2,99,95,2,92,1,4
-1,131210123002025.000000000000000,Block 2025, Block Group 2, Census Tract 123, Fulton County, Georgia,101,2,99,95,0,95,0,4
-1,131210004002004.000000000000000,Block 2004, Block Group 2, Census Tract 4, Fulton County, Georgia,100,6,94,92,88,4,0,2
-1,131210041003009.000000000000000,Block 3009, Block Group 3, Census Tract 41, Fulton County, Georgia,100,3,97,96,16,80,0,1
-1,131210061001003.000000000000000,Block 1003, Block Group 1, Census Tract 61, Fulton County, Georgia,100,8,92,89,9,79,1,3
-1,131210061003016.000000000000000,Block 3016, Block Group 3, Census Tract 61, Fulton County, Georgia,100,2,98,95,1,93,1,3
-1,131210066012000.000000000000000,Block 2000, Block Group 2, Census Tract 66.01, Fulton County, Georgia,100,4,96,85,32,53,0,11
-1,131210078092003.000000000000000,Block 2003, Block Group 2, Census Tract 78.09, Fulton County, Georgia,100,1,99,98,0,98,0,1
-1,131210091051008.000000000000000,Block 1008, Block Group 1, Census Tract 91.05, Fulton County, Georgia,100,0,100,100,99,0,1,0
-1,131210099001008.000000000000000,Block 1008, Block Group 1, Census Tract 99, Fulton County, Georgia,100,4,96,93,91,0,1,3
-1,131210100042001.000000000000000,Block 2001, Block Group 2, Census Tract 100.04, Fulton County, Georgia,100,6,94,94,80,9,0,0
-1,131210102123006.000000000000000,Block 3006, Block Group 3, Census Tract 102.12, Fulton County, Georgia,100,7,93,87,76,2,0,6
-1,131210103122027.000000000000000,Block 2027, Block Group 2, Census Tract 103.12, Fulton County, Georgia,100,0,100,99,0,97,0,1
-1,131210103151003.000000000000000,Block 1003, Block Group 1, Census Tract 103.15, Fulton County, Georgia,100,0,100,96,3,93,0,4
-1,131210105172004.000000000000000,Block 2004, Block Group 2, Census Tract 105.17, Fulton County, Georgia,100,4,96,92,1,91,0,4
-1,131210105203007.000000000000000,Block 3007, Block Group 3, Census Tract 105.20, Fulton County, Georgia,100,3,97,96,0,96,0,1
-1,131210105211001.000000000000000,Block 1001, Block Group 1, Census Tract 105.21, Fulton County, Georgia,100,12,88,87,9,77,1,1
-1,131210105401018.000000000000000,Block 1018, Block Group 1, Census Tract 105.40, Fulton County, Georgia,100,2,98,96,1,85,0,2
-1,131210114171002.000000000000000,Block 1002, Block Group 1, Census Tract 114.17, Fulton County, Georgia,100,6,94,90,83,3,0,4
-1,131210114174004.000000000000000,Block 4004, Block Group 4, Census Tract 114.17, Fulton County, Georgia,100,3,97,95,92,2,1,2
-1,131210114282000.000000000000000,Block 2000, Block Group 2, Census Tract 114.28, Fulton County, Georgia,100,4,96,84,66,11,0,12
-1,131210114462004.000000000000000,Block 2004, Block Group 2, Census Tract 114.46, Fulton County, Georgia,100,9,91,82,74,1,0,9
-1,131210115051004.000000000000000,Block 1004, Block Group 1, Census Tract 115.05, Fulton County, Georgia,100,9,91,87,70,9,0,4
-1,131210115091020.000000000000000,Block 1020, Block Group 1, Census Tract 115.09, Fulton County, Georgia,100,1,99,97,88,5,0,2
-1,131210116122002.000000000000000,Block 2002, Block Group 2, Census Tract 116.12, Fulton County, Georgia,100,10,90,89,41,4,1,1
-1,131210116181001.000000000000000,Block 1001, Block Group 1, Census Tract 116.18, Fulton County, Georgia,100,16,84,79,15,13,0,5
-1,131210116473007.000000000000000,Block 3007, Block Group 3, Census Tract 116.47, Fulton County, Georgia,100,5,95,95,70,11,2,0
-1,131210116592006.000000000000000,Block 2006, Block Group 2, Census Tract 116.59, Fulton County, Georgia,100,3,97,93,88,1,2,4
-1,131210004002010.000000000000000,Block 2010, Block Group 2, Census Tract 4, Fulton County, Georgia,99,4,95,93,85,4,4,2
-1,131210005022026.000000000000000,Block 2026, Block Group 2, Census Tract 5.02, Fulton County, Georgia,99,1,98,92,86,3,0,6
-1,131210038001021.000000000000000,Block 1021, Block Group 1, Census Tract 38, Fulton County, Georgia,99,0,99,99,0,99,0,0
-1,131210044002006.000000000000000,Block 2006, Block Group 2, Census Tract 44, Fulton County, Georgia,99,3,96,93,14,79,0,3
-1,131210069001010.000000000000000,Block 1010, Block Group 1, Census Tract 69, Fulton County, Georgia,99,10,89,86,12,72,0,3
-1,131210078061015.000000000000000,Block 1015, Block Group 1, Census Tract 78.06, Fulton County, Georgia,99,6,93,91,2,89,0,2
-1,131210082022010.000000000000000,Block 2010, Block Group 2, Census Tract 82.02, Fulton County, Georgia,99,4,95,94,1,93,0,1
-1,131210083011012.000000000000000,Block 1012, Block Group 1, Census Tract 83.01, Fulton County, Georgia,99,0,99,97,4,93,0,2
-1,131210089081002.000000000000000,Block 1002, Block Group 1, Census Tract 89.08, Fulton County, Georgia,99,12,87,83,49,23,1,4
-1,131210099001007.000000000000000,Block 1007, Block Group 1, Census Tract 99, Fulton County, Georgia,99,3,96,92,92,0,0,4
-1,131210099002004.000000000000000,Block 2004, Block Group 2, Census Tract 99, Fulton County, Georgia,99,4,95,95,89,2,3,0
-1,131210100031001.000000000000000,Block 1001, Block Group 1, Census Tract 100.03, Fulton County, Georgia,99,6,93,87,78,4,1,6
-1,131210101071008.000000000000000,Block 1008, Block Group 1, Census Tract 101.07, Fulton County, Georgia,99,10,89,88,87,1,0,1
-1,131210101261002.000000000000000,Block 1002, Block Group 1, Census Tract 101.26, Fulton County, Georgia,99,27,72,66,51,14,1,6
-1,131210102114004.000000000000000,Block 4004, Block Group 4, Census Tract 102.11, Fulton County, Georgia,99,5,94,90,86,0,4,4
-1,131210102121000.000000000000000,Block 1000, Block Group 1, Census Tract 102.12, Fulton County, Georgia,99,9,90,90,85,3,0,0
-1,131210102151002.000000000000000,Block 1002, Block Group 1, Census Tract 102.15, Fulton County, Georgia,99,16,83,69,22,46,1,14
-1,131210102222001.000000000000000,Block 2001, Block Group 2, Census Tract 102.22, Fulton County, Georgia,99,1,98,88,78,9,0,10
-1,131210105191037.000000000000000,Block 1037, Block Group 1, Census Tract 105.19, Fulton County, Georgia,99,4,95,92,32,60,0,3
-1,131210106043010.000000000000000,Block 3010, Block Group 3, Census Tract 106.04, Fulton County, Georgia,99,6,93,90,0,89,0,3
-1,131210113013000.000000000000000,Block 3000, Block Group 3, Census Tract 113.01, Fulton County, Georgia,99,3,96,96,4,88,0,0
-1,131210114422008.000000000000000,Block 2008, Block Group 2, Census Tract 114.42, Fulton County, Georgia,99,4,95,93,62,12,5,2
-1,131210115053001.000000000000000,Block 3001, Block Group 3, Census Tract 115.05, Fulton County, Georgia,99,2,97,94,85,2,0,3
-1,131210115082002.000000000000000,Block 2002, Block Group 2, Census Tract 115.08, Fulton County, Georgia,99,18,81,78,68,5,0,3
-1,131210116332005.000000000000000,Block 2005, Block Group 2, Census Tract 116.33, Fulton County, Georgia,99,6,93,82,72,2,0,11
-1,131210116501020.000000000000000,Block 1020, Block Group 1, Census Tract 116.50, Fulton County, Georgia,99,7,92,90,13,11,3,2
-1,131210116602024.000000000000000,Block 2024, Block Group 2, Census Tract 116.60, Fulton County, Georgia,99,1,98,98,65,3,1,0
-1,131210119021009.000000000000000,Block 1009, Block Group 1, Census Tract 119.02, Fulton County, Georgia,99,3,96,92,56,29,3,4
-1,131210120003041.000000000000000,Block 3041, Block Group 3, Census Tract 120, Fulton County, Georgia,99,1,98,96,9,87,0,2
-1,131210123002035.000000000000000,Block 2035, Block Group 2, Census Tract 123, Fulton County, Georgia,99,9,90,88,42,45,0,2
-1,131210001004001.000000000000000,Block 4001, Block Group 4, Census Tract 1, Fulton County, Georgia,98,7,91,82,75,1,1,9
-1,131210002021000.000000000000000,Block 1000, Block Group 1, Census Tract 2.02, Fulton County, Georgia,98,19,79,78,72,0,0,1
-1,131210002023002.000000000000000,Block 3002, Block Group 3, Census Tract 2.02, Fulton County, Georgia,98,6,92,82,80,0,0,10
-1,131210002023007.000000000000000,Block 3007, Block Group 3, Census Tract 2.02, Fulton County, Georgia,98,2,96,94,85,3,3,2
-1,131210017012009.000000000000000,Block 2009, Block Group 2, Census Tract 17.01, Fulton County, Georgia,98,7,91,85,42,33,0,6
-1,131210026001002.000000000000000,Block 1002, Block Group 1, Census Tract 26, Fulton County, Georgia,98,3,95,95,7,86,1,0
-1,131210060001003.000000000000000,Block 1003, Block Group 1, Census Tract 60, Fulton County, Georgia,98,1,97,96,8,88,0,1
-1,131210061001002.000000000000000,Block 1002, Block Group 1, Census Tract 61, Fulton County, Georgia,98,2,96,95,0,95,0,1
-1,131210061003021.000000000000000,Block 3021, Block Group 3, Census Tract 61, Fulton County, Georgia,98,8,90,88,9,79,0,2
-1,131210061003024.000000000000000,Block 3024, Block Group 3, Census Tract 61, Fulton County, Georgia,98,2,96,96,19,77,0,0
-1,131210066011006.000000000000000,Block 1006, Block Group 1, Census Tract 66.01, Fulton County, Georgia,98,3,95,90,19,70,1,5
-1,131210066021006.000000000000000,Block 1006, Block Group 1, Census Tract 66.02, Fulton County, Georgia,98,1,97,95,5,90,0,2
-1,131210067022008.000000000000000,Block 2008, Block Group 2, Census Tract 67.02, Fulton County, Georgia,98,4,94,89,9,80,0,5
-1,131210069001009.000000000000000,Block 1009, Block Group 1, Census Tract 69, Fulton County, Georgia,98,7,91,89,33,56,0,2
-1,131210078061007.000000000000000,Block 1007, Block Group 1, Census Tract 78.06, Fulton County, Georgia,98,1,97,95,0,95,0,2
-1,131210078091000.000000000000000,Block 1000, Block Group 1, Census Tract 78.09, Fulton County, Georgia,98,4,94,94,0,93,0,0
-1,131210082043015.000000000000000,Block 3015, Block Group 3, Census Tract 82.04, Fulton County, Georgia,98,4,94,94,0,94,0,0
-1,131210089082008.000000000000000,Block 2008, Block Group 2, Census Tract 89.08, Fulton County, Georgia,98,11,87,79,68,0,0,8
-1,131210093011016.000000000000000,Block 1016, Block Group 1, Census Tract 93.01, Fulton County, Georgia,98,4,94,87,86,1,0,7
-1,131210095041003.000000000000000,Block 1003, Block Group 1, Census Tract 95.04, Fulton County, Georgia,98,3,95,91,85,0,0,4
-1,131210098023000.000000000000000,Block 3000, Block Group 3, Census Tract 98.02, Fulton County, Georgia,98,6,92,91,88,0,1,1
-1,131210101303002.000000000000000,Block 3002, Block Group 3, Census Tract 101.30, Fulton County, Georgia,98,0,98,96,19,16,4,2
-1,131210102114009.000000000000000,Block 4009, Block Group 4, Census Tract 102.11, Fulton County, Georgia,98,3,95,95,77,8,0,0
-1,131210105292003.000000000000000,Block 2003, Block Group 2, Census Tract 105.29, Fulton County, Georgia,98,5,93,93,0,93,0,0
-1,131210108024023.000000000000000,Block 4023, Block Group 4, Census Tract 108.02, Fulton County, Georgia,98,54,44,43,34,8,1,1
-1,131210113016009.000000000000000,Block 6009, Block Group 6, Census Tract 113.01, Fulton County, Georgia,98,18,80,80,16,63,1,0
-1,131210113061028.000000000000000,Block 1028, Block Group 1, Census Tract 113.06, Fulton County, Georgia,98,6,92,86,1,85,0,6
-1,131210114352004.000000000000000,Block 2004, Block Group 2, Census Tract 114.35, Fulton County, Georgia,98,6,92,87,69,15,3,5
-1,131210116312003.000000000000000,Block 2003, Block Group 2, Census Tract 116.31, Fulton County, Georgia,98,11,87,67,16,17,4,20
-1,131210116321000.000000000000000,Block 1000, Block Group 1, Census Tract 116.32, Fulton County, Georgia,98,13,85,82,16,2,0,3
-1,131210116353014.000000000000000,Block 3014, Block Group 3, Census Tract 116.35, Fulton County, Georgia,98,9,89,87,14,0,0,2
-1,131210053002025.000000000000000,Block 2025, Block Group 2, Census Tract 53, Fulton County, Georgia,97,3,94,83,71,12,0,11
-1,131210064001007.000000000000000,Block 1007, Block Group 1, Census Tract 64, Fulton County, Georgia,97,3,94,87,1,86,0,7
-1,131210073022011.000000000000000,Block 2011, Block Group 2, Census Tract 73.02, Fulton County, Georgia,97,2,95,95,0,95,0,0
-1,131210077081004.000000000000000,Block 1004, Block Group 1, Census Tract 77.08, Fulton County, Georgia,97,7,90,90,0,89,1,0
-1,131210077091009.000000000000000,Block 1009, Block Group 1, Census Tract 77.09, Fulton County, Georgia,97,0,97,96,0,94,0,1
-1,131210077111003.000000000000000,Block 1003, Block Group 1, Census Tract 77.11, Fulton County, Georgia,97,13,84,84,2,82,0,0
-1,131210081031005.000000000000000,Block 1005, Block Group 1, Census Tract 81.03, Fulton County, Georgia,97,3,94,93,5,86,2,1
-1,131210088022009.000000000000000,Block 2009, Block Group 2, Census Tract 88.02, Fulton County, Georgia,97,5,92,91,56,27,0,1
-1,131210089071006.000000000000000,Block 1006, Block Group 1, Census Tract 89.07, Fulton County, Georgia,97,6,91,84,60,13,0,7
-1,131210092031014.000000000000000,Block 1014, Block Group 1, Census Tract 92.03, Fulton County, Georgia,97,8,89,86,49,26,1,3
-1,131210098023007.000000000000000,Block 3007, Block Group 3, Census Tract 98.02, Fulton County, Georgia,97,3,94,91,77,8,0,3
-1,131210101361008.000000000000000,Block 1008, Block Group 1, Census Tract 101.36, Fulton County, Georgia,97,2,95,93,80,4,0,2
-1,131210103051002.000000000000000,Block 1002, Block Group 1, Census Tract 103.05, Fulton County, Georgia,97,1,96,96,0,95,0,0
-1,131210103112006.000000000000000,Block 2006, Block Group 2, Census Tract 103.11, Fulton County, Georgia,97,2,95,95,0,95,0,0
-1,131210105083012.000000000000000,Block 3012, Block Group 3, Census Tract 105.08, Fulton County, Georgia,97,9,88,87,0,87,0,1
-1,131210105222028.000000000000000,Block 2028, Block Group 2, Census Tract 105.22, Fulton County, Georgia,97,0,97,94,0,94,0,3
-1,131210105291006.000000000000000,Block 1006, Block Group 1, Census Tract 105.29, Fulton County, Georgia,97,2,95,88,2,85,1,7
-1,131210113062004.000000000000000,Block 2004, Block Group 2, Census Tract 113.06, Fulton County, Georgia,97,6,91,86,0,84,0,5
-1,131210114191007.000000000000000,Block 1007, Block Group 1, Census Tract 114.19, Fulton County, Georgia,97,12,85,85,44,37,1,0
-1,131210115112001.000000000000000,Block 2001, Block Group 2, Census Tract 115.11, Fulton County, Georgia,97,5,92,90,76,9,0,2
-1,131210116183019.000000000000000,Block 3019, Block Group 3, Census Tract 116.18, Fulton County, Georgia,97,8,89,89,26,9,0,0
-1,131210116292007.000000000000000,Block 2007, Block Group 2, Census Tract 116.29, Fulton County, Georgia,97,10,87,77,47,9,0,10
-1,131210116411007.000000000000000,Block 1007, Block Group 1, Census Tract 116.41, Fulton County, Georgia,97,2,95,88,78,3,0,7
-1,131210116542007.000000000000000,Block 2007, Block Group 2, Census Tract 116.54, Fulton County, Georgia,97,13,84,75,62,9,1,9
-1,131210118022015.000000000000000,Block 2015, Block Group 2, Census Tract 118.02, Fulton County, Georgia,97,0,97,97,0,94,3,0
-1,131210120001009.000000000000000,Block 1009, Block Group 1, Census Tract 120, Fulton County, Georgia,97,1,96,89,8,79,0,7
-1,131210001003012.000000000000000,Block 3012, Block Group 3, Census Tract 1, Fulton County, Georgia,96,2,94,88,83,3,1,6
-1,131210004001002.000000000000000,Block 1002, Block Group 1, Census Tract 4, Fulton County, Georgia,96,3,93,91,84,6,1,2
-1,131210016001001.000000000000000,Block 1001, Block Group 1, Census Tract 16, Fulton County, Georgia,96,0,96,87,82,3,1,9
-1,131210017022005.000000000000000,Block 2005, Block Group 2, Census Tract 17.02, Fulton County, Georgia,96,5,91,82,53,28,0,9
-1,131210029002007.000000000000000,Block 2007, Block Group 2, Census Tract 29, Fulton County, Georgia,96,3,93,92,69,18,0,1
-1,131210030002001.000000000000000,Block 2001, Block Group 2, Census Tract 30, Fulton County, Georgia,96,1,95,86,82,3,0,9
-1,131210040001002.000000000000000,Block 1002, Block Group 1, Census Tract 40, Fulton County, Georgia,96,3,93,89,6,83,0,4
-1,131210062002002.000000000000000,Block 2002, Block Group 2, Census Tract 62, Fulton County, Georgia,96,2,94,94,10,84,0,0
-1,131210066012021.000000000000000,Block 2021, Block Group 2, Census Tract 66.01, Fulton County, Georgia,96,4,92,92,16,75,0,0
-1,131210070021002.000000000000000,Block 1002, Block Group 1, Census Tract 70.02, Fulton County, Georgia,96,8,88,87,14,73,0,1
-1,131210078062000.000000000000000,Block 2000, Block Group 2, Census Tract 78.06, Fulton County, Georgia,96,7,89,89,0,89,0,0
-1,131210078073005.000000000000000,Block 3005, Block Group 3, Census Tract 78.07, Fulton County, Georgia,96,5,91,84,3,81,0,7
-1,131210080001004.000000000000000,Block 1004, Block Group 1, Census Tract 80, Fulton County, Georgia,96,7,89,88,9,78,0,1
-1,131210082021007.000000000000000,Block 1007, Block Group 1, Census Tract 82.02, Fulton County, Georgia,96,0,96,95,0,92,3,1
-1,131210088021019.000000000000000,Block 1019, Block Group 1, Census Tract 88.02, Fulton County, Georgia,96,6,90,79,60,8,5,11
-1,131210091033001.000000000000000,Block 3001, Block Group 3, Census Tract 91.03, Fulton County, Georgia,96,13,83,78,73,0,5,5
-1,131210096061011.000000000000000,Block 1011, Block Group 1, Census Tract 96.06, Fulton County, Georgia,96,4,92,90,88,1,0,2
-1,131210096073003.000000000000000,Block 3003, Block Group 3, Census Tract 96.07, Fulton County, Georgia,96,12,84,73,67,0,0,11
-1,131210099003009.000000000000000,Block 3009, Block Group 3, Census Tract 99, Fulton County, Georgia,96,1,95,92,87,3,1,3
-1,131210100041010.000000000000000,Block 1010, Block Group 1, Census Tract 100.04, Fulton County, Georgia,96,13,83,77,70,3,0,6
-1,131210102201008.000000000000000,Block 1008, Block Group 1, Census Tract 102.20, Fulton County, Georgia,96,6,90,89,88,1,0,1
-1,131210103091011.000000000000000,Block 1011, Block Group 1, Census Tract 103.09, Fulton County, Georgia,96,1,95,93,22,70,1,2
-1,131210105192004.000000000000000,Block 2004, Block Group 2, Census Tract 105.19, Fulton County, Georgia,96,10,86,85,1,82,0,1
-1,131210105281014.000000000000000,Block 1014, Block Group 1, Census Tract 105.28, Fulton County, Georgia,96,9,87,87,10,75,1,0
-1,131210110001002.000000000000000,Block 1002, Block Group 1, Census Tract 110, Fulton County, Georgia,96,92,4,4,3,0,0,0
-1,131210113015000.000000000000000,Block 5000, Block Group 5, Census Tract 113.01, Fulton County, Georgia,96,11,85,85,0,85,0,0
-1,131210114384002.000000000000000,Block 4002, Block Group 4, Census Tract 114.38, Fulton County, Georgia,96,56,40,36,20,16,0,4
-1,131210115081004.000000000000000,Block 1004, Block Group 1, Census Tract 115.08, Fulton County, Georgia,96,4,92,85,81,4,0,7
-1,131210115082027.000000000000000,Block 2027, Block Group 2, Census Tract 115.08, Fulton County, Georgia,96,4,92,85,75,2,3,7
-1,131210115132003.000000000000000,Block 2003, Block Group 2, Census Tract 115.13, Fulton County, Georgia,96,5,91,89,69,18,0,2
-1,131210115132007.000000000000000,Block 2007, Block Group 2, Census Tract 115.13, Fulton County, Georgia,96,2,94,94,89,1,2,0
-1,131210116302002.000000000000000,Block 2002, Block Group 2, Census Tract 116.30, Fulton County, Georgia,96,13,83,74,31,5,0,9
-1,131210001001006.000000000000000,Block 1006, Block Group 1, Census Tract 1, Fulton County, Georgia,95,11,84,76,71,0,0,8
-1,131210002011009.000000000000000,Block 1009, Block Group 1, Census Tract 2.01, Fulton County, Georgia,95,9,86,82,77,4,0,4
-1,131210014002001.000000000000000,Block 2001, Block Group 2, Census Tract 14, Fulton County, Georgia,95,2,93,88,83,2,0,5
-1,131210049002009.000000000000000,Block 2009, Block Group 2, Census Tract 49, Fulton County, Georgia,95,1,94,90,76,14,0,4
-1,131210066011008.000000000000000,Block 1008, Block Group 1, Census Tract 66.01, Fulton County, Georgia,95,1,94,91,22,69,0,3
-1,131210074003002.000000000000000,Block 3002, Block Group 3, Census Tract 74, Fulton County, Georgia,95,3,92,89,4,85,0,3
-1,131210077093001.000000000000000,Block 3001, Block Group 3, Census Tract 77.09, Fulton County, Georgia,95,5,90,87,0,87,0,3
-1,131210078102006.000000000000000,Block 2006, Block Group 2, Census Tract 78.10, Fulton County, Georgia,95,0,95,91,0,91,0,4
-1,131210085002004.000000000000000,Block 2004, Block Group 2, Census Tract 85, Fulton County, Georgia,95,0,95,95,9,86,0,0
-1,131210086012006.000000000000000,Block 2006, Block Group 2, Census Tract 86.01, Fulton County, Georgia,95,4,91,86,8,77,1,5
-1,131210093022003.000000000000000,Block 2003, Block Group 2, Census Tract 93.02, Fulton County, Georgia,95,8,87,79,79,0,0,8
-1,131210096044002.000000000000000,Block 4002, Block Group 4, Census Tract 96.04, Fulton County, Georgia,95,9,86,81,67,7,7,5
-1,131210097002001.000000000000000,Block 2001, Block Group 2, Census Tract 97, Fulton County, Georgia,95,4,91,79,77,0,0,12
-1,131210100071008.000000000000000,Block 1008, Block Group 1, Census Tract 100.07, Fulton County, Georgia,95,7,88,82,81,1,0,6
-1,131210101151009.000000000000000,Block 1009, Block Group 1, Census Tract 101.15, Fulton County, Georgia,95,3,92,90,81,0,4,2
-1,131210101302001.000000000000000,Block 2001, Block Group 2, Census Tract 101.30, Fulton County, Georgia,95,4,91,88,76,8,0,3
-1,131210101321004.000000000000000,Block 1004, Block Group 1, Census Tract 101.32, Fulton County, Georgia,95,24,71,68,60,6,0,3
-1,131210102202000.000000000000000,Block 2000, Block Group 2, Census Tract 102.20, Fulton County, Georgia,95,6,89,83,75,6,1,6
-1,131210103082006.000000000000000,Block 2006, Block Group 2, Census Tract 103.08, Fulton County, Georgia,95,1,94,88,24,62,0,6
-1,131210103103010.000000000000000,Block 3010, Block Group 3, Census Tract 103.10, Fulton County, Georgia,95,0,95,92,0,92,0,3
-1,131210103112015.000000000000000,Block 2015, Block Group 2, Census Tract 103.11, Fulton County, Georgia,95,1,94,90,0,90,0,4
-1,131210104013032.000000000000000,Block 3032, Block Group 3, Census Tract 104.01, Fulton County, Georgia,95,8,87,85,20,61,4,2
-1,131210105083001.000000000000000,Block 3001, Block Group 3, Census Tract 105.08, Fulton County, Georgia,95,0,95,93,2,88,0,2
-1,131210105222027.000000000000000,Block 2027, Block Group 2, Census Tract 105.22, Fulton County, Georgia,95,7,88,88,1,82,2,0
-1,131210105311002.000000000000000,Block 1002, Block Group 1, Census Tract 105.31, Fulton County, Georgia,95,3,92,88,1,84,2,4
-1,131210105312007.000000000000000,Block 2007, Block Group 2, Census Tract 105.31, Fulton County, Georgia,95,5,90,88,0,86,0,2
-1,131210108012022.000000000000000,Block 2022, Block Group 2, Census Tract 108.01, Fulton County, Georgia,95,3,92,92,20,68,0,0
-1,131210108022005.000000000000000,Block 2005, Block Group 2, Census Tract 108.02, Fulton County, Georgia,95,30,65,65,7,56,0,0
-1,131210113091005.000000000000000,Block 1005, Block Group 1, Census Tract 113.09, Fulton County, Georgia,95,8,87,85,2,83,0,2
-1,131210114361001.000000000000000,Block 1001, Block Group 1, Census Tract 114.36, Fulton County, Georgia,95,24,71,66,61,5,0,5
-1,131210114422014.000000000000000,Block 2014, Block Group 2, Census Tract 114.42, Fulton County, Georgia,95,10,85,81,46,22,1,4
-1,131210114452006.000000000000000,Block 2006, Block Group 2, Census Tract 114.45, Fulton County, Georgia,95,3,92,87,84,2,1,5
-1,131210115102024.000000000000000,Block 2024, Block Group 2, Census Tract 115.10, Fulton County, Georgia,95,9,86,79,75,2,0,7
-1,131210116402005.000000000000000,Block 2005, Block Group 2, Census Tract 116.40, Fulton County, Georgia,95,7,88,75,69,6,0,13
-1,131210116402024.000000000000000,Block 2024, Block Group 2, Census Tract 116.40, Fulton County, Georgia,95,10,85,85,77,3,0,0
-1,131210116502004.000000000000000,Block 2004, Block Group 2, Census Tract 116.50, Fulton County, Georgia,95,15,80,73,33,2,0,7
-1,131210116552016.000000000000000,Block 2016, Block Group 2, Census Tract 116.55, Fulton County, Georgia,95,16,79,75,70,3,0,4
-1,131210120001006.000000000000000,Block 1006, Block Group 1, Census Tract 120, Fulton County, Georgia,95,0,95,94,20,73,0,1
-1,131210001003011.000000000000000,Block 3011, Block Group 3, Census Tract 1, Fulton County, Georgia,94,7,87,71,67,0,0,16
-1,131210017022007.000000000000000,Block 2007, Block Group 2, Census Tract 17.02, Fulton County, Georgia,94,6,88,85,72,6,2,3
-1,131210049002029.000000000000000,Block 2029, Block Group 2, Census Tract 49, Fulton County, Georgia,94,3,91,87,77,7,1,4
-1,131210052002001.000000000000000,Block 2001, Block Group 2, Census Tract 52, Fulton County, Georgia,94,7,87,84,78,2,0,3
-1,131210052002005.000000000000000,Block 2005, Block Group 2, Census Tract 52, Fulton County, Georgia,94,3,91,87,57,29,1,4
-1,131210055012015.000000000000000,Block 2015, Block Group 2, Census Tract 55.01, Fulton County, Georgia,94,9,85,80,0,79,1,5
-1,131210061003025.000000000000000,Block 3025, Block Group 3, Census Tract 61, Fulton County, Georgia,94,3,91,89,7,82,0,2
-1,131210065003015.000000000000000,Block 3015, Block Group 3, Census Tract 65, Fulton County, Georgia,94,8,86,86,26,59,1,0
-1,131210072003004.000000000000000,Block 3004, Block Group 3, Census Tract 72, Fulton County, Georgia,94,4,90,89,1,85,3,1
-1,131210075003016.000000000000000,Block 3016, Block Group 3, Census Tract 75, Fulton County, Georgia,94,8,86,84,2,77,2,2
-1,131210078092008.000000000000000,Block 2008, Block Group 2, Census Tract 78.09, Fulton County, Georgia,94,1,93,91,0,91,0,2
-1,131210080005012.000000000000000,Block 5012, Block Group 5, Census Tract 80, Fulton County, Georgia,94,1,93,93,2,91,0,0
-1,131210095012001.000000000000000,Block 2001, Block Group 2, Census Tract 95.01, Fulton County, Georgia,94,4,90,90,89,0,1,0
-1,131210098042000.000000000000000,Block 2000, Block Group 2, Census Tract 98.04, Fulton County, Georgia,94,6,88,81,78,1,0,7
-1,131210101081006.000000000000000,Block 1006, Block Group 1, Census Tract 101.08, Fulton County, Georgia,94,1,93,89,86,0,1,4
-1,131210103153008.000000000000000,Block 3008, Block Group 3, Census Tract 103.15, Fulton County, Georgia,94,3,91,85,0,83,2,6
-1,131210105211009.000000000000000,Block 1009, Block Group 1, Census Tract 105.21, Fulton County, Georgia,94,0,94,91,8,83,0,3
-1,131210105352004.000000000000000,Block 2004, Block Group 2, Census Tract 105.35, Fulton County, Georgia,94,7,87,86,0,86,0,1
-1,131210105391018.000000000000000,Block 1018, Block Group 1, Census Tract 105.39, Fulton County, Georgia,94,3,91,91,0,91,0,0
-1,131210114341018.000000000000000,Block 1018, Block Group 1, Census Tract 114.34, Fulton County, Georgia,94,28,66,63,45,15,3,3
-1,131210116293009.000000000000000,Block 3009, Block Group 3, Census Tract 116.29, Fulton County, Georgia,94,2,92,89,51,14,0,3
-1,131210116401015.000000000000000,Block 1015, Block Group 1, Census Tract 116.40, Fulton County, Georgia,94,21,73,66,36,22,5,7
-1,131210116493010.000000000000000,Block 3010, Block Group 3, Census Tract 116.49, Fulton County, Georgia,94,1,93,89,17,9,4,4
-1,131210120001004.000000000000000,Block 1004, Block Group 1, Census Tract 120, Fulton County, Georgia,94,1,93,89,0,89,0,4
-1,131210017012004.000000000000000,Block 2004, Block Group 2, Census Tract 17.01, Fulton County, Georgia,93,12,81,79,60,17,2,2
-1,131210019021008.000000000000000,Block 1008, Block Group 1, Census Tract 19.02, Fulton County, Georgia,93,3,90,87,34,48,0,3
-1,131210041001006.000000000000000,Block 1006, Block Group 1, Census Tract 41, Fulton County, Georgia,93,6,87,86,5,62,0,1
-1,131210044002022.000000000000000,Block 2022, Block Group 2, Census Tract 44, Fulton County, Georgia,93,6,87,81,5,73,3,6
-1,131210063001000.000000000000000,Block 1000, Block Group 1, Census Tract 63, Fulton County, Georgia,93,0,93,89,3,86,0,4
-1,131210066012020.000000000000000,Block 2020, Block Group 2, Census Tract 66.01, Fulton County, Georgia,93,0,93,89,12,74,3,4
-1,131210070011000.000000000000000,Block 1000, Block Group 1, Census Tract 70.01, Fulton County, Georgia,93,5,88,85,4,78,3,3
-1,131210076022001.000000000000000,Block 2001, Block Group 2, Census Tract 76.02, Fulton County, Georgia,93,1,92,81,5,72,0,11
-1,131210077093005.000000000000000,Block 3005, Block Group 3, Census Tract 77.09, Fulton County, Georgia,93,0,93,87,0,87,0,6
-1,131210078064012.000000000000000,Block 4012, Block Group 4, Census Tract 78.06, Fulton County, Georgia,93,2,91,90,0,90,0,1
-1,131210082031001.000000000000000,Block 1001, Block Group 1, Census Tract 82.03, Fulton County, Georgia,93,1,92,90,5,84,0,2
-1,131210084002001.000000000000000,Block 2001, Block Group 2, Census Tract 84, Fulton County, Georgia,93,11,82,79,1,78,0,3
-1,131210085003028.000000000000000,Block 3028, Block Group 3, Census Tract 85, Fulton County, Georgia,93,4,89,89,3,86,0,0
-1,131210086022009.000000000000000,Block 2009, Block Group 2, Census Tract 86.02, Fulton County, Georgia,93,5,88,82,4,78,0,6
-1,131210092022021.000000000000000,Block 2021, Block Group 2, Census Tract 92.02, Fulton County, Georgia,93,0,93,91,84,3,4,2
-1,131210093022004.000000000000000,Block 2004, Block Group 2, Census Tract 93.02, Fulton County, Georgia,93,10,83,70,65,4,0,13
-1,131210100051013.000000000000000,Block 1013, Block Group 1, Census Tract 100.05, Fulton County, Georgia,93,0,93,91,91,0,0,2
-1,131210100052014.000000000000000,Block 2014, Block Group 2, Census Tract 100.05, Fulton County, Georgia,93,3,90,84,75,0,1,6
-1,131210102162002.000000000000000,Block 2002, Block Group 2, Census Tract 102.16, Fulton County, Georgia,93,12,81,72,37,10,2,9
-1,131210103061011.000000000000000,Block 1011, Block Group 1, Census Tract 103.06, Fulton County, Georgia,93,0,93,89,2,87,0,4
-1,131210103062000.000000000000000,Block 2000, Block Group 2, Census Tract 103.06, Fulton County, Georgia,93,0,93,90,0,87,3,3
-1,131210105253001.000000000000000,Block 3001, Block Group 3, Census Tract 105.25, Fulton County, Georgia,93,4,89,87,0,86,0,2
-1,131210105362010.000000000000000,Block 2010, Block Group 2, Census Tract 105.36, Fulton County, Georgia,93,3,90,85,0,85,0,5
-1,131210112022009.000000000000000,Block 2009, Block Group 2, Census Tract 112.02, Fulton County, Georgia,93,38,55,52,17,33,2,3
-1,131210113012000.000000000000000,Block 2000, Block Group 2, Census Tract 113.01, Fulton County, Georgia,93,14,79,79,7,70,0,0
-1,131210114291002.000000000000000,Block 1002, Block Group 1, Census Tract 114.29, Fulton County, Georgia,93,16,77,68,47,6,4,9
-1,131210115091014.000000000000000,Block 1014, Block Group 1, Census Tract 115.09, Fulton County, Georgia,93,8,85,83,82,0,0,2
-1,131210115122031.000000000000000,Block 2031, Block Group 2, Census Tract 115.12, Fulton County, Georgia,93,4,89,81,76,0,2,8
-1,131210001002005.000000000000000,Block 2005, Block Group 2, Census Tract 1, Fulton County, Georgia,92,2,90,87,86,0,0,3
-1,131210017012002.000000000000000,Block 2002, Block Group 2, Census Tract 17.01, Fulton County, Georgia,92,7,85,81,2,77,0,4
-1,131210061003019.000000000000000,Block 3019, Block Group 3, Census Tract 61, Fulton County, Georgia,92,4,88,84,2,82,0,4
-1,131210069003020.000000000000000,Block 3020, Block Group 3, Census Tract 69, Fulton County, Georgia,92,14,78,77,64,13,0,1
-1,131210070014008.000000000000000,Block 4008, Block Group 4, Census Tract 70.01, Fulton County, Georgia,92,11,81,76,4,72,0,5
-1,131210075003011.000000000000000,Block 3011, Block Group 3, Census Tract 75, Fulton County, Georgia,92,6,86,85,5,79,0,1
-1,131210078094005.000000000000000,Block 4005, Block Group 4, Census Tract 78.09, Fulton County, Georgia,92,12,80,80,0,80,0,0
-1,131210080005004.000000000000000,Block 5004, Block Group 5, Census Tract 80, Fulton County, Georgia,92,0,92,88,4,84,0,4
-1,131210100031003.000000000000000,Block 1003, Block Group 1, Census Tract 100.03, Fulton County, Georgia,92,3,89,83,76,3,0,6
-1,131210101202009.000000000000000,Block 2009, Block Group 2, Census Tract 101.20, Fulton County, Georgia,92,7,85,72,58,10,3,13
-1,131210102114000.000000000000000,Block 4000, Block Group 4, Census Tract 102.11, Fulton County, Georgia,92,14,78,74,72,2,0,4
-1,131210103103016.000000000000000,Block 3016, Block Group 3, Census Tract 103.10, Fulton County, Georgia,92,0,92,92,0,92,0,0
-1,131210105181001.000000000000000,Block 1001, Block Group 1, Census Tract 105.18, Fulton County, Georgia,92,5,87,85,0,74,8,2
-1,131210105203002.000000000000000,Block 3002, Block Group 3, Census Tract 105.20, Fulton County, Georgia,92,0,92,90,2,81,3,2
-1,131210105292004.000000000000000,Block 2004, Block Group 2, Census Tract 105.29, Fulton County, Georgia,92,4,88,87,3,84,0,1
-1,131210105302015.000000000000000,Block 2015, Block Group 2, Census Tract 105.30, Fulton County, Georgia,92,0,92,92,0,84,5,0
-1,131210108022007.000000000000000,Block 2007, Block Group 2, Census Tract 108.02, Fulton County, Georgia,92,16,76,73,19,50,0,3
-1,131210108023001.000000000000000,Block 3001, Block Group 3, Census Tract 108.02, Fulton County, Georgia,92,22,70,70,36,29,0,0
-1,131210113012004.000000000000000,Block 2004, Block Group 2, Census Tract 113.01, Fulton County, Georgia,92,23,69,68,12,56,0,1
-1,131210113081013.000000000000000,Block 1013, Block Group 1, Census Tract 113.08, Fulton County, Georgia,92,0,92,89,7,82,0,3
-1,131210115053008.000000000000000,Block 3008, Block Group 3, Census Tract 115.05, Fulton County, Georgia,92,4,88,83,80,0,0,5
-1,131210116413003.000000000000000,Block 3003, Block Group 3, Census Tract 116.41, Fulton County, Georgia,92,8,84,81,68,10,3,3
-1,131210116423010.000000000000000,Block 3010, Block Group 3, Census Tract 116.42, Fulton County, Georgia,92,9,83,79,36,9,0,4
-1,131210116453009.000000000000000,Block 3009, Block Group 3, Census Tract 116.45, Fulton County, Georgia,92,14,78,76,22,33,0,2
-1,131210116551011.000000000000000,Block 1011, Block Group 1, Census Tract 116.55, Fulton County, Georgia,92,9,83,80,76,4,0,3
-1,131210119022007.000000000000000,Block 2007, Block Group 2, Census Tract 119.02, Fulton County, Georgia,92,6,86,83,59,20,0,3
-1,131210001003005.000000000000000,Block 3005, Block Group 3, Census Tract 1, Fulton County, Georgia,91,9,82,77,71,2,0,5
-1,131210006012000.000000000000000,Block 2000, Block Group 2, Census Tract 6.01, Fulton County, Georgia,91,8,83,79,45,4,5,4
-1,131210012041002.000000000000000,Block 1002, Block Group 1, Census Tract 12.04, Fulton County, Georgia,91,4,87,75,63,0,2,12
-1,131210042001002.000000000000000,Block 1002, Block Group 1, Census Tract 42, Fulton County, Georgia,91,0,91,90,6,84,0,1
-1,131210042002016.000000000000000,Block 2016, Block Group 2, Census Tract 42, Fulton County, Georgia,91,1,90,80,12,68,0,10
-1,131210055012003.000000000000000,Block 2003, Block Group 2, Census Tract 55.01, Fulton County, Georgia,91,2,89,89,3,85,0,0
-1,131210058001049.000000000000000,Block 1049, Block Group 1, Census Tract 58, Fulton County, Georgia,91,10,81,76,13,60,0,5
-1,131210065002001.000000000000000,Block 2001, Block Group 2, Census Tract 65, Fulton County, Georgia,91,3,88,86,15,71,0,2
-1,131210070022005.000000000000000,Block 2005, Block Group 2, Census Tract 70.02, Fulton County, Georgia,91,3,88,88,14,74,0,0
-1,131210077111004.000000000000000,Block 1004, Block Group 1, Census Tract 77.11, Fulton County, Georgia,91,2,89,87,0,87,0,2
-1,131210079003000.000000000000000,Block 3000, Block Group 3, Census Tract 79, Fulton County, Georgia,91,0,91,91,5,84,0,0
-1,131210088021018.000000000000000,Block 1018, Block Group 1, Census Tract 88.02, Fulton County, Georgia,91,16,75,72,58,10,0,3
-1,131210090022019.000000000000000,Block 2019, Block Group 2, Census Tract 90.02, Fulton County, Georgia,91,4,87,87,86,0,0,0
-1,131210091051007.000000000000000,Block 1007, Block Group 1, Census Tract 91.05, Fulton County, Georgia,91,1,90,87,87,0,0,3
-1,131210096061014.000000000000000,Block 1014, Block Group 1, Census Tract 96.06, Fulton County, Georgia,91,4,87,84,84,0,0,3
-1,131210098022011.000000000000000,Block 2011, Block Group 2, Census Tract 98.02, Fulton County, Georgia,91,4,87,86,61,21,0,1
-1,131210099001010.000000000000000,Block 1010, Block Group 1, Census Tract 99, Fulton County, Georgia,91,0,91,91,87,3,1,0
-1,131210102123001.000000000000000,Block 3001, Block Group 3, Census Tract 102.12, Fulton County, Georgia,91,10,81,77,70,6,1,4
-1,131210102123007.000000000000000,Block 3007, Block Group 3, Census Tract 102.12, Fulton County, Georgia,91,11,80,71,62,5,1,9
-1,131210102162007.000000000000000,Block 2007, Block Group 2, Census Tract 102.16, Fulton County, Georgia,91,9,82,75,65,7,0,7
-1,131210102231004.000000000000000,Block 1004, Block Group 1, Census Tract 102.23, Fulton County, Georgia,91,1,90,89,67,14,0,1
-1,131210105173005.000000000000000,Block 3005, Block Group 3, Census Tract 105.17, Fulton County, Georgia,91,6,85,78,0,76,2,7
-1,131210105211004.000000000000000,Block 1004, Block Group 1, Census Tract 105.21, Fulton County, Georgia,91,6,85,85,2,81,0,0
-1,131210112023034.000000000000000,Block 3034, Block Group 3, Census Tract 112.02, Fulton County, Georgia,91,0,91,89,17,69,2,2
-1,131210114192016.000000000000000,Block 2016, Block Group 2, Census Tract 114.19, Fulton County, Georgia,91,1,90,87,87,0,0,3
-1,131210114342003.000000000000000,Block 2003, Block Group 2, Census Tract 114.34, Fulton County, Georgia,91,16,75,65,42,6,0,10
-1,131210114391003.000000000000000,Block 1003, Block Group 1, Census Tract 114.39, Fulton County, Georgia,91,10,81,72,70,0,2,9
-1,131210115082012.000000000000000,Block 2012, Block Group 2, Census Tract 115.08, Fulton County, Georgia,91,2,89,83,76,2,0,6
-1,131210115111000.000000000000000,Block 1000, Block Group 1, Census Tract 115.11, Fulton County, Georgia,91,17,74,65,15,49,0,9
-1,131210116333004.000000000000000,Block 3004, Block Group 3, Census Tract 116.33, Fulton County, Georgia,91,9,82,74,36,11,1,8
-1,131210116372004.000000000000000,Block 2004, Block Group 2, Census Tract 116.37, Fulton County, Georgia,91,4,87,79,68,1,1,8
-1,131210116411002.000000000000000,Block 1002, Block Group 1, Census Tract 116.41, Fulton County, Georgia,91,1,90,87,82,3,0,3
-1,131210116541002.000000000000000,Block 1002, Block Group 1, Census Tract 116.54, Fulton County, Georgia,91,10,81,72,58,0,0,9
-1,131210116592009.000000000000000,Block 2009, Block Group 2, Census Tract 116.59, Fulton County, Georgia,91,17,74,66,54,0,0,8
-1,131210116601003.000000000000000,Block 1003, Block Group 1, Census Tract 116.60, Fulton County, Georgia,91,4,87,78,37,16,0,9
-1,131210002022001.000000000000000,Block 2001, Block Group 2, Census Tract 2.02, Fulton County, Georgia,90,2,88,82,76,1,0,6
-1,131210012052006.000000000000000,Block 2006, Block Group 2, Census Tract 12.05, Fulton County, Georgia,90,8,82,78,61,10,0,4
-1,131210013022003.000000000000000,Block 2003, Block Group 2, Census Tract 13.02, Fulton County, Georgia,90,4,86,81,27,54,0,5
-1,131210029001018.000000000000000,Block 1018, Block Group 1, Census Tract 29, Fulton County, Georgia,90,5,85,78,61,11,0,7
-1,131210050002015.000000000000000,Block 2015, Block Group 2, Census Tract 50, Fulton County, Georgia,90,5,85,78,71,7,0,7
-1,131210058001050.000000000000000,Block 1050, Block Group 1, Census Tract 58, Fulton County, Georgia,90,7,83,78,22,56,0,5
-1,131210072003000.000000000000000,Block 3000, Block Group 3, Census Tract 72, Fulton County, Georgia,90,19,71,68,1,67,0,3
-1,131210075001011.000000000000000,Block 1011, Block Group 1, Census Tract 75, Fulton County, Georgia,90,19,71,68,8,58,0,3
-1,131210081041014.000000000000000,Block 1014, Block Group 1, Census Tract 81.04, Fulton County, Georgia,90,1,89,87,6,81,0,2
-1,131210083011003.000000000000000,Block 1003, Block Group 1, Census Tract 83.01, Fulton County, Georgia,90,1,89,85,0,85,0,4
-1,131210087013006.000000000000000,Block 3006, Block Group 3, Census Tract 87.01, Fulton County, Georgia,90,4,86,83,3,80,0,3
-1,131210093021005.000000000000000,Block 1005, Block Group 1, Census Tract 93.02, Fulton County, Georgia,90,1,89,87,86,0,0,2
-1,131210095012000.000000000000000,Block 2000, Block Group 2, Census Tract 95.01, Fulton County, Georgia,90,3,87,86,83,3,0,1
-1,131210098041018.000000000000000,Block 1018, Block Group 1, Census Tract 98.04, Fulton County, Georgia,90,2,88,81,73,6,0,7
-1,131210099002002.000000000000000,Block 2002, Block Group 2, Census Tract 99, Fulton County, Georgia,90,0,90,89,89,0,0,1
-1,131210102201022.000000000000000,Block 1022, Block Group 1, Census Tract 102.20, Fulton County, Georgia,90,1,89,87,78,3,2,2
-1,131210103111014.000000000000000,Block 1014, Block Group 1, Census Tract 103.11, Fulton County, Georgia,90,2,88,85,0,82,0,3
-1,131210105181006.000000000000000,Block 1006, Block Group 1, Census Tract 105.18, Fulton County, Georgia,90,1,89,88,6,80,0,1
-1,131210105351005.000000000000000,Block 1005, Block Group 1, Census Tract 105.35, Fulton County, Georgia,90,5,85,79,1,78,0,6
-1,131210105401014.000000000000000,Block 1014, Block Group 1, Census Tract 105.40, Fulton County, Georgia,90,31,59,57,7,50,0,2
-1,131210113105002.000000000000000,Block 5002, Block Group 5, Census Tract 113.10, Fulton County, Georgia,90,55,35,35,8,27,0,0
-1,131210115051005.000000000000000,Block 1005, Block Group 1, Census Tract 115.05, Fulton County, Georgia,90,3,87,76,76,0,0,11
-1,131210115112014.000000000000000,Block 2014, Block Group 2, Census Tract 115.11, Fulton County, Georgia,90,3,87,84,68,6,0,3
-1,131210116402014.000000000000000,Block 2014, Block Group 2, Census Tract 116.40, Fulton County, Georgia,90,5,85,80,64,9,0,5
-1,131210002022006.000000000000000,Block 2006, Block Group 2, Census Tract 2.02, Fulton County, Georgia,89,0,89,83,69,10,0,6
-1,131210012032009.000000000000000,Block 2009, Block Group 2, Census Tract 12.03, Fulton County, Georgia,89,9,80,73,58,8,2,7
-1,131210013021004.000000000000000,Block 1004, Block Group 1, Census Tract 13.02, Fulton County, Georgia,89,8,81,76,14,59,0,5
-1,131210016001000.000000000000000,Block 1000, Block Group 1, Census Tract 16, Fulton County, Georgia,89,8,81,76,54,17,1,5
-1,131210032002018.000000000000000,Block 2018, Block Group 2, Census Tract 32, Fulton County, Georgia,89,9,80,76,70,6,0,4
-1,131210041002004.000000000000000,Block 2004, Block Group 2, Census Tract 41, Fulton County, Georgia,89,7,82,82,17,65,0,0
-1,131210049001007.000000000000000,Block 1007, Block Group 1, Census Tract 49, Fulton County, Georgia,89,2,87,83,29,50,0,4
-1,131210053003009.000000000000000,Block 3009, Block Group 3, Census Tract 53, Fulton County, Georgia,89,5,84,81,56,24,0,3
-1,131210055011015.000000000000000,Block 1015, Block Group 1, Census Tract 55.01, Fulton County, Georgia,89,2,87,85,36,49,0,2
-1,131210058001045.000000000000000,Block 1045, Block Group 1, Census Tract 58, Fulton County, Georgia,89,7,82,75,34,41,0,7
-1,131210073022016.000000000000000,Block 2016, Block Group 2, Census Tract 73.02, Fulton County, Georgia,89,4,85,84,1,83,0,1
-1,131210077092007.000000000000000,Block 2007, Block Group 2, Census Tract 77.09, Fulton County, Georgia,89,1,88,85,1,82,0,3
-1,131210078101009.000000000000000,Block 1009, Block Group 1, Census Tract 78.10, Fulton County, Georgia,89,4,85,79,1,78,0,6
-1,131210082042008.000000000000000,Block 2008, Block Group 2, Census Tract 82.04, Fulton County, Georgia,89,5,84,83,3,80,0,1
-1,131210084003000.000000000000000,Block 3000, Block Group 3, Census Tract 84, Fulton County, Georgia,89,0,89,89,2,87,0,0
-1,131210087012000.000000000000000,Block 2000, Block Group 2, Census Tract 87.01, Fulton County, Georgia,89,1,88,83,3,79,0,5
-1,131210089091007.000000000000000,Block 1007, Block Group 1, Census Tract 89.09, Fulton County, Georgia,89,10,79,78,71,3,0,1
-1,131210098031001.000000000000000,Block 1001, Block Group 1, Census Tract 98.03, Fulton County, Georgia,89,6,83,80,73,0,0,3
-1,131210101081008.000000000000000,Block 1008, Block Group 1, Census Tract 101.08, Fulton County, Georgia,89,2,87,81,67,12,0,6
-1,131210102171009.000000000000000,Block 1009, Block Group 1, Census Tract 102.17, Fulton County, Georgia,89,5,84,79,66,8,0,5
-1,131210103131000.000000000000000,Block 1000, Block Group 1, Census Tract 103.13, Fulton County, Georgia,89,5,84,79,0,75,1,5
-1,131210105211010.000000000000000,Block 1010, Block Group 1, Census Tract 105.21, Fulton County, Georgia,89,0,89,88,0,88,0,1
-1,131210105241002.000000000000000,Block 1002, Block Group 1, Census Tract 105.24, Fulton County, Georgia,89,2,87,86,3,80,0,1
-1,131210105331006.000000000000000,Block 1006, Block Group 1, Census Tract 105.33, Fulton County, Georgia,89,8,81,81,18,63,0,0
-1,131210105401007.000000000000000,Block 1007, Block Group 1, Census Tract 105.40, Fulton County, Georgia,89,7,82,80,0,80,0,2
-1,131210108022002.000000000000000,Block 2002, Block Group 2, Census Tract 108.02, Fulton County, Georgia,89,33,56,56,5,51,0,0
-1,131210112022005.000000000000000,Block 2005, Block Group 2, Census Tract 112.02, Fulton County, Georgia,89,8,81,78,26,51,0,3
-1,131210113063005.000000000000000,Block 3005, Block Group 3, Census Tract 113.06, Fulton County, Georgia,89,4,85,84,1,82,1,1
-1,131210113081007.000000000000000,Block 1007, Block Group 1, Census Tract 113.08, Fulton County, Georgia,89,3,86,85,8,77,0,1
-1,131210114282001.000000000000000,Block 2001, Block Group 2, Census Tract 114.28, Fulton County, Georgia,89,10,79,74,62,7,0,5
-1,131210114353001.000000000000000,Block 3001, Block Group 3, Census Tract 114.35, Fulton County, Georgia,89,36,53,48,41,0,0,5
-1,131210114412004.000000000000000,Block 2004, Block Group 2, Census Tract 114.41, Fulton County, Georgia,89,9,80,69,63,1,0,11
-1,131210115101026.000000000000000,Block 1026, Block Group 1, Census Tract 115.10, Fulton County, Georgia,89,0,89,86,64,5,0,3
-1,131210116402018.000000000000000,Block 2018, Block Group 2, Census Tract 116.40, Fulton County, Georgia,89,37,52,51,37,9,0,1
-1,131210116412004.000000000000000,Block 2004, Block Group 2, Census Tract 116.41, Fulton County, Georgia,89,0,89,78,76,0,0,11
-1,131210116442002.000000000000000,Block 2002, Block Group 2, Census Tract 116.44, Fulton County, Georgia,89,5,84,75,37,5,1,9
-1,131210002023013.000000000000000,Block 3013, Block Group 3, Census Tract 2.02, Fulton County, Georgia,88,6,82,77,64,1,0,5
-1,131210006012004.000000000000000,Block 2004, Block Group 2, Census Tract 6.01, Fulton County, Georgia,88,12,76,71,35,1,0,5
-1,131210017011006.000000000000000,Block 1006, Block Group 1, Census Tract 17.01, Fulton County, Georgia,88,2,86,83,29,49,0,3
-1,131210029001020.000000000000000,Block 1020, Block Group 1, Census Tract 29, Fulton County, Georgia,88,7,81,80,41,39,0,1
-1,131210058001040.000000000000000,Block 1040, Block Group 1, Census Tract 58, Fulton County, Georgia,88,2,86,86,13,72,0,0
-1,131210062002000.000000000000000,Block 2000, Block Group 2, Census Tract 62, Fulton County, Georgia,88,0,88,88,3,85,0,0
-1,131210066011014.000000000000000,Block 1014, Block Group 1, Census Tract 66.01, Fulton County, Georgia,88,2,86,77,22,51,4,9
-1,131210070023007.000000000000000,Block 3007, Block Group 3, Census Tract 70.02, Fulton County, Georgia,88,3,85,82,2,75,2,3
-1,131210078081006.000000000000000,Block 1006, Block Group 1, Census Tract 78.08, Fulton County, Georgia,88,6,82,81,6,71,2,1
-1,131210085003012.000000000000000,Block 3012, Block Group 3, Census Tract 85, Fulton County, Georgia,88,2,86,83,0,83,0,3
-1,131210087012001.000000000000000,Block 2001, Block Group 2, Census Tract 87.01, Fulton County, Georgia,88,6,82,74,2,72,0,8
-1,131210092032005.000000000000000,Block 2005, Block Group 2, Census Tract 92.03, Fulton County, Georgia,88,8,80,71,64,3,3,9
-1,131210093011003.000000000000000,Block 1003, Block Group 1, Census Tract 93.01, Fulton County, Georgia,88,0,88,87,86,0,0,1
-1,131210096043002.000000000000000,Block 3002, Block Group 3, Census Tract 96.04, Fulton County, Georgia,88,10,78,71,64,0,1,7
-1,131210100042007.000000000000000,Block 2007, Block Group 2, Census Tract 100.04, Fulton County, Georgia,88,3,85,78,75,2,0,7
-1,131210100051003.000000000000000,Block 1003, Block Group 1, Census Tract 100.05, Fulton County, Georgia,88,3,85,79,76,0,2,6
-1,131210101081010.000000000000000,Block 1010, Block Group 1, Census Tract 101.08, Fulton County, Georgia,88,2,86,83,72,11,0,3
-1,131210102114001.000000000000000,Block 4001, Block Group 4, Census Tract 102.11, Fulton County, Georgia,88,3,85,83,78,1,0,2
-1,131210102123004.000000000000000,Block 3004, Block Group 3, Census Tract 102.12, Fulton County, Georgia,88,20,68,65,48,7,0,3
-1,131210103061008.000000000000000,Block 1008, Block Group 1, Census Tract 103.06, Fulton County, Georgia,88,5,83,78,2,76,0,5
-1,131210103103002.000000000000000,Block 3002, Block Group 3, Census Tract 103.10, Fulton County, Georgia,88,1,87,85,0,85,0,2
-1,131210104022000.000000000000000,Block 2000, Block Group 2, Census Tract 104.02, Fulton County, Georgia,88,0,88,83,20,63,0,5
-1,131210105201016.000000000000000,Block 1016, Block Group 1, Census Tract 105.20, Fulton County, Georgia,88,5,83,83,0,82,0,0
-1,131210105202002.000000000000000,Block 2002, Block Group 2, Census Tract 105.20, Fulton County, Georgia,88,2,86,82,3,76,2,4
-1,131210105253002.000000000000000,Block 3002, Block Group 3, Census Tract 105.25, Fulton County, Georgia,88,0,88,83,3,78,0,5
-1,131210105261027.000000000000000,Block 1027, Block Group 1, Census Tract 105.26, Fulton County, Georgia,88,4,84,78,0,74,4,6
-1,131210105273007.000000000000000,Block 3007, Block Group 3, Census Tract 105.27, Fulton County, Georgia,88,19,69,64,23,41,0,5
-1,131210105312011.000000000000000,Block 2011, Block Group 2, Census Tract 105.31, Fulton County, Georgia,88,4,84,83,0,83,0,1
-1,131210105382012.000000000000000,Block 2012, Block Group 2, Census Tract 105.38, Fulton County, Georgia,88,3,85,84,0,81,3,1
-1,131210114221002.000000000000000,Block 1002, Block Group 1, Census Tract 114.22, Fulton County, Georgia,88,3,85,77,74,0,0,8
-1,131210114371018.000000000000000,Block 1018, Block Group 1, Census Tract 114.37, Fulton County, Georgia,88,12,76,72,0,72,0,4
-1,131210115092011.000000000000000,Block 2011, Block Group 2, Census Tract 115.09, Fulton County, Georgia,88,4,84,81,67,6,4,3
-1,131210116383004.000000000000000,Block 3004, Block Group 3, Census Tract 116.38, Fulton County, Georgia,88,15,73,62,38,15,2,11
-1,131210116441012.000000000000000,Block 1012, Block Group 1, Census Tract 116.44, Fulton County, Georgia,88,6,82,67,11,29,0,15
-1,131210116462017.000000000000000,Block 2017, Block Group 2, Census Tract 116.46, Fulton County, Georgia,88,17,71,62,35,6,0,9
-1,131210010022008.000000000000000,Block 2008, Block Group 2, Census Tract 10.02, Fulton County, Georgia,87,5,82,80,60,5,5,2
-1,131210024001010.000000000000000,Block 1010, Block Group 1, Census Tract 24, Fulton County, Georgia,87,8,79,78,16,62,0,1
-1,131210025002016.000000000000000,Block 2016, Block Group 2, Census Tract 25, Fulton County, Georgia,87,7,80,78,2,74,0,2
-1,131210042002006.000000000000000,Block 2006, Block Group 2, Census Tract 42, Fulton County, Georgia,87,0,87,85,5,80,0,2
-1,131210066011002.000000000000000,Block 1002, Block Group 1, Census Tract 66.01, Fulton County, Georgia,87,1,86,82,24,58,0,4
-1,131210068021006.000000000000000,Block 1006, Block Group 1, Census Tract 68.02, Fulton County, Georgia,87,9,78,78,1,76,0,0
-1,131210070014002.000000000000000,Block 4002, Block Group 4, Census Tract 70.01, Fulton County, Georgia,87,10,77,75,9,66,0,2
-1,131210077093003.000000000000000,Block 3003, Block Group 3, Census Tract 77.09, Fulton County, Georgia,87,6,81,78,5,72,1,3
-1,131210082031007.000000000000000,Block 1007, Block Group 1, Census Tract 82.03, Fulton County, Georgia,87,1,86,86,6,79,1,0
-1,131210085002025.000000000000000,Block 2025, Block Group 2, Census Tract 85, Fulton County, Georgia,87,2,85,85,0,85,0,0
-1,131210089071009.000000000000000,Block 1009, Block Group 1, Census Tract 89.07, Fulton County, Georgia,87,17,70,59,18,34,2,11
-1,131210090011007.000000000000000,Block 1007, Block Group 1, Census Tract 90.01, Fulton County, Georgia,87,1,86,80,74,0,0,6
-1,131210096012005.000000000000000,Block 2005, Block Group 2, Census Tract 96.01, Fulton County, Georgia,87,10,77,69,53,15,0,8
-1,131210096044001.000000000000000,Block 4001, Block Group 4, Census Tract 96.04, Fulton County, Georgia,87,22,65,57,41,4,1,8
-1,131210101301000.000000000000000,Block 1000, Block Group 1, Census Tract 101.30, Fulton County, Georgia,87,15,72,68,37,1,1,4
-1,131210103051029.000000000000000,Block 1029, Block Group 1, Census Tract 103.05, Fulton County, Georgia,87,0,87,87,0,87,0,0
-1,131210103063022.000000000000000,Block 3022, Block Group 3, Census Tract 103.06, Fulton County, Georgia,87,1,86,81,2,77,0,5
-1,131210104011025.000000000000000,Block 1025, Block Group 1, Census Tract 104.01, Fulton County, Georgia,87,2,85,84,2,77,2,1
-1,131210104013012.000000000000000,Block 3012, Block Group 3, Census Tract 104.01, Fulton County, Georgia,87,29,58,56,25,31,0,2
-1,131210104013041.000000000000000,Block 3041, Block Group 3, Census Tract 104.01, Fulton County, Georgia,87,7,80,80,18,62,0,0
-1,131210105182010.000000000000000,Block 2010, Block Group 2, Census Tract 105.18, Fulton County, Georgia,87,13,74,73,4,69,0,1
-1,131210105202011.000000000000000,Block 2011, Block Group 2, Census Tract 105.20, Fulton County, Georgia,87,3,84,78,4,68,0,6
-1,131210105261028.000000000000000,Block 1028, Block Group 1, Census Tract 105.26, Fulton County, Georgia,87,9,78,77,2,75,0,1
-1,131210105382019.000000000000000,Block 2019, Block Group 2, Census Tract 105.38, Fulton County, Georgia,87,0,87,85,1,84,0,2
-1,131210105401010.000000000000000,Block 1010, Block Group 1, Census Tract 105.40, Fulton County, Georgia,87,10,77,70,5,65,0,7
-1,131210108021012.000000000000000,Block 1012, Block Group 1, Census Tract 108.02, Fulton County, Georgia,87,48,39,32,15,12,0,7
-1,131210113012001.000000000000000,Block 2001, Block Group 2, Census Tract 113.01, Fulton County, Georgia,87,30,57,55,4,51,0,2
-1,131210113081004.000000000000000,Block 1004, Block Group 1, Census Tract 113.08, Fulton County, Georgia,87,3,84,83,0,82,0,1
-1,131210114281004.000000000000000,Block 1004, Block Group 1, Census Tract 114.28, Fulton County, Georgia,87,5,82,79,51,28,0,3
-1,131210114353006.000000000000000,Block 3006, Block Group 3, Census Tract 114.35, Fulton County, Georgia,87,1,86,82,69,10,0,4
-1,131210114461011.000000000000000,Block 1011, Block Group 1, Census Tract 114.46, Fulton County, Georgia,87,4,83,80,64,6,0,3
-1,131210115071016.000000000000000,Block 1016, Block Group 1, Census Tract 115.07, Fulton County, Georgia,87,5,82,74,72,2,0,8
-1,131210115111001.000000000000000,Block 1001, Block Group 1, Census Tract 115.11, Fulton County, Georgia,87,5,82,81,63,8,0,1
-1,131210116582010.000000000000000,Block 2010, Block Group 2, Census Tract 116.58, Fulton County, Georgia,87,14,73,70,32,16,0,3
-1,131210116602012.000000000000000,Block 2012, Block Group 2, Census Tract 116.60, Fulton County, Georgia,87,4,83,80,64,8,0,3
-1,131210120002015.000000000000000,Block 2015, Block Group 2, Census Tract 120, Fulton County, Georgia,87,0,87,83,6,75,0,4
-1,131210120003040.000000000000000,Block 3040, Block Group 3, Census Tract 120, Fulton County, Georgia,87,0,87,86,2,82,0,1
-1,131210123003011.000000000000000,Block 3011, Block Group 3, Census Tract 123, Fulton County, Georgia,87,2,85,85,21,64,0,0
-1,131210030001021.000000000000000,Block 1021, Block Group 1, Census Tract 30, Fulton County, Georgia,86,3,83,78,70,5,3,5
-1,131210031002010.000000000000000,Block 2010, Block Group 2, Census Tract 31, Fulton County, Georgia,86,2,84,83,13,70,0,1
-1,131210050002000.000000000000000,Block 2000, Block Group 2, Census Tract 50, Fulton County, Georgia,86,8,78,76,68,2,0,2
-1,131210053002022.000000000000000,Block 2022, Block Group 2, Census Tract 53, Fulton County, Georgia,86,6,80,76,68,7,1,4
-1,131210057001002.000000000000000,Block 1002, Block Group 1, Census Tract 57, Fulton County, Georgia,86,2,84,83,7,75,0,1
-1,131210066011010.000000000000000,Block 1010, Block Group 1, Census Tract 66.01, Fulton County, Georgia,86,1,85,76,20,54,0,9
-1,131210066021013.000000000000000,Block 1013, Block Group 1, Census Tract 66.02, Fulton County, Georgia,86,0,86,85,4,81,0,1
-1,131210071001000.000000000000000,Block 1000, Block Group 1, Census Tract 71, Fulton County, Georgia,86,7,79,78,0,77,0,1
-1,131210077072014.000000000000000,Block 2014, Block Group 2, Census Tract 77.07, Fulton County, Georgia,86,1,85,82,4,77,0,3
-1,131210077111008.000000000000000,Block 1008, Block Group 1, Census Tract 77.11, Fulton County, Georgia,86,5,81,78,2,73,0,3
-1,131210080002006.000000000000000,Block 2006, Block Group 2, Census Tract 80, Fulton County, Georgia,86,7,79,74,12,62,0,5
-1,131210082031004.000000000000000,Block 1004, Block Group 1, Census Tract 82.03, Fulton County, Georgia,86,7,79,78,0,78,0,1
-1,131210082041007.000000000000000,Block 1007, Block Group 1, Census Tract 82.04, Fulton County, Georgia,86,1,85,82,0,82,0,3
-1,131210088011025.000000000000000,Block 1025, Block Group 1, Census Tract 88.01, Fulton County, Georgia,86,11,75,74,38,35,0,1
-1,131210097001004.000000000000000,Block 1004, Block Group 1, Census Tract 97, Fulton County, Georgia,86,2,84,82,75,2,1,2
-1,131210098031006.000000000000000,Block 1006, Block Group 1, Census Tract 98.03, Fulton County, Georgia,86,5,81,76,73,0,0,5
-1,131210101201005.000000000000000,Block 1005, Block Group 1, Census Tract 101.20, Fulton County, Georgia,86,10,76,71,24,47,0,5
-1,131210103053003.000000000000000,Block 3003, Block Group 3, Census Tract 103.05, Fulton County, Georgia,86,0,86,80,0,78,0,6
-1,131210103061004.000000000000000,Block 1004, Block Group 1, Census Tract 103.06, Fulton County, Georgia,86,5,81,73,0,73,0,8
-1,131210103152007.000000000000000,Block 2007, Block Group 2, Census Tract 103.15, Fulton County, Georgia,86,0,86,82,0,82,0,4
-1,131210105202009.000000000000000,Block 2009, Block Group 2, Census Tract 105.20, Fulton County, Georgia,86,4,82,80,4,75,1,2
-1,131210105211003.000000000000000,Block 1003, Block Group 1, Census Tract 105.21, Fulton County, Georgia,86,7,79,79,0,79,0,0
-1,131210105264011.000000000000000,Block 4011, Block Group 4, Census Tract 105.26, Fulton County, Georgia,86,7,79,79,2,77,0,0
-1,131210105292020.000000000000000,Block 2020, Block Group 2, Census Tract 105.29, Fulton County, Georgia,86,2,84,76,8,68,0,8
-1,131210105293016.000000000000000,Block 3016, Block Group 3, Census Tract 105.29, Fulton County, Georgia,86,6,80,77,1,76,0,3
-1,131210105293026.000000000000000,Block 3026, Block Group 3, Census Tract 105.29, Fulton County, Georgia,86,1,85,85,10,75,0,0
-1,131210105321002.000000000000000,Block 1002, Block Group 1, Census Tract 105.32, Fulton County, Georgia,86,8,78,77,2,74,0,1
-1,131210105342010.000000000000000,Block 2010, Block Group 2, Census Tract 105.34, Fulton County, Georgia,86,0,86,84,0,77,6,2
-1,131210105362013.000000000000000,Block 2013, Block Group 2, Census Tract 105.36, Fulton County, Georgia,86,6,80,75,1,71,3,5
-1,131210105381007.000000000000000,Block 1007, Block Group 1, Census Tract 105.38, Fulton County, Georgia,86,3,83,81,10,71,0,2
-1,131210105391003.000000000000000,Block 1003, Block Group 1, Census Tract 105.39, Fulton County, Georgia,86,2,84,84,0,83,0,0
-1,131210105391023.000000000000000,Block 1023, Block Group 1, Census Tract 105.39, Fulton County, Georgia,86,0,86,84,3,80,1,2
-1,131210106031011.000000000000000,Block 1011, Block Group 1, Census Tract 106.03, Fulton County, Georgia,86,13,73,73,1,67,5,0
-1,131210112025001.000000000000000,Block 5001, Block Group 5, Census Tract 112.02, Fulton County, Georgia,86,7,79,75,14,60,0,4
-1,131210113016011.000000000000000,Block 6011, Block Group 6, Census Tract 113.01, Fulton County, Georgia,86,3,83,80,7,68,0,3
-1,131210114232007.000000000000000,Block 2007, Block Group 2, Census Tract 114.23, Fulton County, Georgia,86,2,84,83,78,1,0,1
-1,131210114232008.000000000000000,Block 2008, Block Group 2, Census Tract 114.23, Fulton County, Georgia,86,4,82,74,67,7,0,8
-1,131210114441005.000000000000000,Block 1005, Block Group 1, Census Tract 114.44, Fulton County, Georgia,86,2,84,83,19,5,2,1
-1,131210115091018.000000000000000,Block 1018, Block Group 1, Census Tract 115.09, Fulton County, Georgia,86,13,73,66,63,0,1,7
-1,131210115101022.000000000000000,Block 1022, Block Group 1, Census Tract 115.10, Fulton County, Georgia,86,8,78,75,68,1,0,3
-1,131210116342001.000000000000000,Block 2001, Block Group 2, Census Tract 116.34, Fulton County, Georgia,86,27,59,51,25,11,4,8
-1,131210116392003.000000000000000,Block 2003, Block Group 2, Census Tract 116.39, Fulton County, Georgia,86,6,80,72,34,24,0,8
-1,131210116421004.000000000000000,Block 1004, Block Group 1, Census Tract 116.42, Fulton County, Georgia,86,5,81,73,56,11,0,8
-1,131210002011000.000000000000000,Block 1000, Block Group 1, Census Tract 2.01, Fulton County, Georgia,85,1,84,82,74,3,1,2
-1,131210002023011.000000000000000,Block 3011, Block Group 3, Census Tract 2.02, Fulton County, Georgia,85,5,80,73,68,1,4,7
-1,131210015011009.000000000000000,Block 1009, Block Group 1, Census Tract 15.01, Fulton County, Georgia,85,6,79,71,61,10,0,8
-1,131210030003004.000000000000000,Block 3004, Block Group 3, Census Tract 30, Fulton County, Georgia,85,9,76,72,71,1,0,4
-1,131210031001018.000000000000000,Block 1018, Block Group 1, Census Tract 31, Fulton County, Georgia,85,5,80,80,65,15,0,0
-1,131210049001008.000000000000000,Block 1008, Block Group 1, Census Tract 49, Fulton County, Georgia,85,8,77,75,30,39,6,2
-1,131210050001006.000000000000000,Block 1006, Block Group 1, Census Tract 50, Fulton County, Georgia,85,3,82,79,64,6,1,3
-1,131210061001010.000000000000000,Block 1010, Block Group 1, Census Tract 61, Fulton County, Georgia,85,0,85,83,11,72,0,2
-1,131210065003014.000000000000000,Block 3014, Block Group 3, Census Tract 65, Fulton County, Georgia,85,0,85,83,21,62,0,2
-1,131210070011004.000000000000000,Block 1004, Block Group 1, Census Tract 70.01, Fulton County, Georgia,85,28,57,56,0,56,0,1
-1,131210075002001.000000000000000,Block 2001, Block Group 2, Census Tract 75, Fulton County, Georgia,85,4,81,80,9,71,0,1
-1,131210075003004.000000000000000,Block 3004, Block Group 3, Census Tract 75, Fulton County, Georgia,85,4,81,72,2,69,1,9
-1,131210076022007.000000000000000,Block 2007, Block Group 2, Census Tract 76.02, Fulton County, Georgia,85,1,84,83,13,68,2,1
-1,131210077111006.000000000000000,Block 1006, Block Group 1, Census Tract 77.11, Fulton County, Georgia,85,2,83,83,0,83,0,0
-1,131210086013013.000000000000000,Block 3013, Block Group 3, Census Tract 86.01, Fulton County, Georgia,85,5,80,76,4,70,0,4
-1,131210094111000.000000000000000,Block 1000, Block Group 1, Census Tract 94.11, Fulton County, Georgia,85,8,77,67,44,16,0,10
-1,131210098021005.000000000000000,Block 1005, Block Group 1, Census Tract 98.02, Fulton County, Georgia,85,2,83,80,70,10,0,3
-1,131210098021014.000000000000000,Block 1014, Block Group 1, Census Tract 98.02, Fulton County, Georgia,85,3,82,81,77,0,0,1
-1,131210099002011.000000000000000,Block 2011, Block Group 2, Census Tract 99, Fulton County, Georgia,85,0,85,84,79,3,1,1
-1,131210100071000.000000000000000,Block 1000, Block Group 1, Census Tract 100.07, Fulton County, Georgia,85,7,78,71,68,2,0,7
-1,131210101071003.000000000000000,Block 1003, Block Group 1, Census Tract 101.07, Fulton County, Georgia,85,10,75,68,52,8,6,7
-1,131210101202007.000000000000000,Block 2007, Block Group 2, Census Tract 101.20, Fulton County, Georgia,85,9,76,70,39,14,4,6
-1,131210101211009.000000000000000,Block 1009, Block Group 1, Census Tract 101.21, Fulton County, Georgia,85,11,74,73,60,12,0,1
-1,131210101272003.000000000000000,Block 2003, Block Group 2, Census Tract 101.27, Fulton County, Georgia,85,14,71,67,59,8,0,4
-1,131210102044003.000000000000000,Block 4003, Block Group 4, Census Tract 102.04, Fulton County, Georgia,85,1,84,83,80,2,1,1
-1,131210103142003.000000000000000,Block 2003, Block Group 2, Census Tract 103.14, Fulton County, Georgia,85,3,82,78,12,66,0,4
-1,131210105083000.000000000000000,Block 3000, Block Group 3, Census Tract 105.08, Fulton County, Georgia,85,0,85,82,1,81,0,3
-1,131210108012021.000000000000000,Block 2021, Block Group 2, Census Tract 108.01, Fulton County, Georgia,85,7,78,73,36,37,0,5
-1,131210112025003.000000000000000,Block 5003, Block Group 5, Census Tract 112.02, Fulton County, Georgia,85,8,77,69,19,48,0,8
-1,131210113072010.000000000000000,Block 2010, Block Group 2, Census Tract 113.07, Fulton County, Georgia,85,8,77,76,0,70,0,1
-1,131210114361004.000000000000000,Block 1004, Block Group 1, Census Tract 114.36, Fulton County, Georgia,85,16,69,65,62,2,1,4
-1,131210115082009.000000000000000,Block 2009, Block Group 2, Census Tract 115.08, Fulton County, Georgia,85,7,78,72,45,10,2,6
-1,131210116123008.000000000000000,Block 3008, Block Group 3, Census Tract 116.12, Fulton County, Georgia,85,2,83,80,50,5,3,3
-1,131210116402019.000000000000000,Block 2019, Block Group 2, Census Tract 116.40, Fulton County, Georgia,85,7,78,71,62,0,1,7
-1,131210116402021.000000000000000,Block 2021, Block Group 2, Census Tract 116.40, Fulton County, Georgia,85,1,84,82,46,23,2,2
-1,131210116412007.000000000000000,Block 2007, Block Group 2, Census Tract 116.41, Fulton County, Georgia,85,0,85,83,73,1,1,2
-1,131210116531008.000000000000000,Block 1008, Block Group 1, Census Tract 116.53, Fulton County, Georgia,85,18,67,64,36,12,0,3
-1,131210116541007.000000000000000,Block 1007, Block Group 1, Census Tract 116.54, Fulton County, Georgia,85,15,70,65,28,20,0,5
-1,131210015012004.000000000000000,Block 2004, Block Group 2, Census Tract 15.01, Fulton County, Georgia,84,1,83,80,58,15,0,3
-1,131210060002007.000000000000000,Block 2007, Block Group 2, Census Tract 60, Fulton County, Georgia,84,1,83,82,7,75,0,1
-1,131210065002007.000000000000000,Block 2007, Block Group 2, Census Tract 65, Fulton County, Georgia,84,1,83,83,20,62,0,0
-1,131210067011005.000000000000000,Block 1005, Block Group 1, Census Tract 67.01, Fulton County, Georgia,84,0,84,82,0,82,0,2
-1,131210074002009.000000000000000,Block 2009, Block Group 2, Census Tract 74, Fulton County, Georgia,84,9,75,74,0,73,1,1
-1,131210077032007.000000000000000,Block 2007, Block Group 2, Census Tract 77.03, Fulton County, Georgia,84,6,78,72,0,71,0,6
-1,131210078051038.000000000000000,Block 1038, Block Group 1, Census Tract 78.05, Fulton County, Georgia,84,0,84,83,3,78,0,1
-1,131210078062004.000000000000000,Block 2004, Block Group 2, Census Tract 78.06, Fulton County, Georgia,84,3,81,69,1,68,0,12
-1,131210078103010.000000000000000,Block 3010, Block Group 3, Census Tract 78.10, Fulton County, Georgia,84,0,84,81,3,78,0,3
-1,131210080002007.000000000000000,Block 2007, Block Group 2, Census Tract 80, Fulton County, Georgia,84,0,84,80,1,77,0,4
-1,131210080005007.000000000000000,Block 5007, Block Group 5, Census Tract 80, Fulton County, Georgia,84,5,79,78,0,78,0,1
-1,131210088011017.000000000000000,Block 1017, Block Group 1, Census Tract 88.01, Fulton County, Georgia,84,9,75,65,21,37,1,10
-1,131210088021035.000000000000000,Block 1035, Block Group 1, Census Tract 88.02, Fulton County, Georgia,84,2,82,78,54,21,1,4
-1,131210089091011.000000000000000,Block 1011, Block Group 1, Census Tract 89.09, Fulton County, Georgia,84,6,78,71,53,14,0,7
-1,131210090022011.000000000000000,Block 2011, Block Group 2, Census Tract 90.02, Fulton County, Georgia,84,12,72,72,67,0,2,0
-1,131210098041022.000000000000000,Block 1022, Block Group 1, Census Tract 98.04, Fulton County, Georgia,84,1,83,79,77,0,0,4
-1,131210099002007.000000000000000,Block 2007, Block Group 2, Census Tract 99, Fulton County, Georgia,84,6,78,75,71,3,1,3
-1,131210103053006.000000000000000,Block 3006, Block Group 3, Census Tract 103.05, Fulton County, Georgia,84,1,83,81,0,80,0,2
-1,131210105261035.000000000000000,Block 1035, Block Group 1, Census Tract 105.26, Fulton County, Georgia,84,2,82,78,8,70,0,4
-1,131210105291018.000000000000000,Block 1018, Block Group 1, Census Tract 105.29, Fulton County, Georgia,84,2,82,77,0,73,4,5
-1,131210105371017.000000000000000,Block 1017, Block Group 1, Census Tract 105.37, Fulton County, Georgia,84,4,80,80,9,68,3,0
-1,131210108023016.000000000000000,Block 3016, Block Group 3, Census Tract 108.02, Fulton County, Georgia,84,35,49,45,38,4,0,4
-1,131210113012005.000000000000000,Block 2005, Block Group 2, Census Tract 113.01, Fulton County, Georgia,84,12,72,69,6,63,0,3
-1,131210114161001.000000000000000,Block 1001, Block Group 1, Census Tract 114.16, Fulton County, Georgia,84,10,74,64,53,9,0,10
-1,131210114421001.000000000000000,Block 1001, Block Group 1, Census Tract 114.42, Fulton County, Georgia,84,6,78,74,57,14,1,4
-1,131210114452004.000000000000000,Block 2004, Block Group 2, Census Tract 114.45, Fulton County, Georgia,84,1,83,81,80,1,0,2
-1,131210116123004.000000000000000,Block 3004, Block Group 3, Census Tract 116.12, Fulton County, Georgia,84,0,84,80,60,3,0,4
-1,131210116242004.000000000000000,Block 2004, Block Group 2, Census Tract 116.24, Fulton County, Georgia,84,4,80,74,37,7,0,6
-1,131210116291011.000000000000000,Block 1011, Block Group 1, Census Tract 116.29, Fulton County, Georgia,84,7,77,77,32,8,0,0
-1,131210004002011.000000000000000,Block 2011, Block Group 2, Census Tract 4, Fulton County, Georgia,83,0,83,81,80,0,0,2
-1,131210012042000.000000000000000,Block 2000, Block Group 2, Census Tract 12.04, Fulton County, Georgia,83,3,80,72,66,2,1,8
-1,131210024001013.000000000000000,Block 1013, Block Group 1, Census Tract 24, Fulton County, Georgia,83,2,81,80,10,67,1,1
-1,131210026001011.000000000000000,Block 1011, Block Group 1, Census Tract 26, Fulton County, Georgia,83,3,80,75,4,71,0,5
-1,131210041002003.000000000000000,Block 2003, Block Group 2, Census Tract 41, Fulton County, Georgia,83,2,81,80,0,80,0,1
-1,131210060003005.000000000000000,Block 3005, Block Group 3, Census Tract 60, Fulton County, Georgia,83,0,83,78,9,69,0,5
-1,131210064001008.000000000000000,Block 1008, Block Group 1, Census Tract 64, Fulton County, Georgia,83,19,64,61,1,60,0,3
-1,131210069003021.000000000000000,Block 3021, Block Group 3, Census Tract 69, Fulton County, Georgia,83,23,60,57,9,48,0,3
-1,131210071002000.000000000000000,Block 2000, Block Group 2, Census Tract 71, Fulton County, Georgia,83,18,65,63,5,58,0,2
-1,131210075001010.000000000000000,Block 1010, Block Group 1, Census Tract 75, Fulton County, Georgia,83,1,82,78,0,78,0,4
-1,131210076022006.000000000000000,Block 2006, Block Group 2, Census Tract 76.02, Fulton County, Georgia,83,0,83,82,5,75,1,1
-1,131210079002009.000000000000000,Block 2009, Block Group 2, Census Tract 79, Fulton County, Georgia,83,5,78,76,0,76,0,2
-1,131210089054002.000000000000000,Block 4002, Block Group 4, Census Tract 89.05, Fulton County, Georgia,83,3,80,78,73,0,0,2
-1,131210099001006.000000000000000,Block 1006, Block Group 1, Census Tract 99, Fulton County, Georgia,83,2,81,77,75,0,0,4
-1,131210100031002.000000000000000,Block 1002, Block Group 1, Census Tract 100.03, Fulton County, Georgia,83,10,73,71,58,4,1,2
-1,131210101341003.000000000000000,Block 1003, Block Group 1, Census Tract 101.34, Fulton County, Georgia,83,26,57,44,11,28,0,13
-1,131210101371002.000000000000000,Block 1002, Block Group 1, Census Tract 101.37, Fulton County, Georgia,83,9,74,64,60,1,0,10
-1,131210103092018.000000000000000,Block 2018, Block Group 2, Census Tract 103.09, Fulton County, Georgia,83,3,80,76,0,76,0,4
-1,131210104021049.000000000000000,Block 1049, Block Group 1, Census Tract 104.02, Fulton County, Georgia,83,8,75,69,19,50,0,6
-1,131210105171010.000000000000000,Block 1010, Block Group 1, Census Tract 105.17, Fulton County, Georgia,83,3,80,75,0,75,0,5
-1,131210105292019.000000000000000,Block 2019, Block Group 2, Census Tract 105.29, Fulton County, Georgia,83,2,81,81,7,73,1,0
-1,131210105301011.000000000000000,Block 1011, Block Group 1, Census Tract 105.30, Fulton County, Georgia,83,1,82,79,0,79,0,3
-1,131210105372008.000000000000000,Block 2008, Block Group 2, Census Tract 105.37, Fulton County, Georgia,83,2,81,73,0,73,0,8
-1,131210106043006.000000000000000,Block 3006, Block Group 3, Census Tract 106.04, Fulton County, Georgia,83,18,65,65,5,59,0,0
-1,131210114162001.000000000000000,Block 2001, Block Group 2, Census Tract 114.16, Fulton County, Georgia,83,4,79,79,66,12,0,0
-1,131210114192004.000000000000000,Block 2004, Block Group 2, Census Tract 114.19, Fulton County, Georgia,83,5,78,73,60,10,0,5
-1,131210116292006.000000000000000,Block 2006, Block Group 2, Census Tract 116.29, Fulton County, Georgia,83,10,73,68,41,21,0,5
-1,131210116391005.000000000000000,Block 1005, Block Group 1, Census Tract 116.39, Fulton County, Georgia,83,13,70,67,39,7,0,3
-1,131210116401014.000000000000000,Block 1014, Block Group 1, Census Tract 116.40, Fulton County, Georgia,83,4,79,78,73,0,0,1
-1,131210120002019.000000000000000,Block 2019, Block Group 2, Census Tract 120, Fulton County, Georgia,83,1,82,82,12,70,0,0
-1,131210001001011.000000000000000,Block 1011, Block Group 1, Census Tract 1, Fulton County, Georgia,82,4,78,72,72,0,0,6
-1,131210002011010.000000000000000,Block 1010, Block Group 1, Census Tract 2.01, Fulton County, Georgia,82,0,82,80,71,7,0,2
-1,131210012051003.000000000000000,Block 1003, Block Group 1, Census Tract 12.05, Fulton County, Georgia,82,14,68,66,57,2,0,2
-1,131210021003003.000000000000000,Block 3003, Block Group 3, Census Tract 21, Fulton County, Georgia,82,8,74,67,12,54,0,7
-1,131210040001008.000000000000000,Block 1008, Block Group 1, Census Tract 40, Fulton County, Georgia,82,0,82,82,0,79,3,0
-1,131210050001010.000000000000000,Block 1010, Block Group 1, Census Tract 50, Fulton County, Georgia,82,0,82,75,60,9,0,7
-1,131210053001005.000000000000000,Block 1005, Block Group 1, Census Tract 53, Fulton County, Georgia,82,0,82,80,61,15,0,2
-1,131210065002000.000000000000000,Block 2000, Block Group 2, Census Tract 65, Fulton County, Georgia,82,0,82,74,14,59,0,8
-1,131210066011009.000000000000000,Block 1009, Block Group 1, Census Tract 66.01, Fulton County, Georgia,82,8,74,71,13,58,0,3
-1,131210070021004.000000000000000,Block 1004, Block Group 1, Census Tract 70.02, Fulton County, Georgia,82,11,71,71,0,71,0,0
-1,131210073014000.000000000000000,Block 4000, Block Group 4, Census Tract 73.01, Fulton County, Georgia,82,8,74,73,2,68,0,1
-1,131210076021003.000000000000000,Block 1003, Block Group 1, Census Tract 76.02, Fulton County, Georgia,82,0,82,81,5,76,0,1
-1,131210077031001.000000000000000,Block 1001, Block Group 1, Census Tract 77.03, Fulton County, Georgia,82,3,79,72,6,66,0,7
-1,131210078103000.000000000000000,Block 3000, Block Group 3, Census Tract 78.10, Fulton County, Georgia,82,2,80,77,0,77,0,3
-1,131210080003001.000000000000000,Block 3001, Block Group 3, Census Tract 80, Fulton County, Georgia,82,2,80,80,0,80,0,0
-1,131210080005001.000000000000000,Block 5001, Block Group 5, Census Tract 80, Fulton County, Georgia,82,0,82,78,0,78,0,4
-1,131210089071008.000000000000000,Block 1008, Block Group 1, Census Tract 89.07, Fulton County, Georgia,82,2,80,75,54,10,0,5
-1,131210091051002.000000000000000,Block 1002, Block Group 1, Census Tract 91.05, Fulton County, Georgia,82,1,81,77,75,2,0,4
-1,131210095013006.000000000000000,Block 3006, Block Group 3, Census Tract 95.01, Fulton County, Georgia,82,2,80,79,77,0,0,1
-1,131210098023002.000000000000000,Block 3002, Block Group 3, Census Tract 98.02, Fulton County, Georgia,82,12,70,64,62,2,0,6
-1,131210100052019.000000000000000,Block 2019, Block Group 2, Census Tract 100.05, Fulton County, Georgia,82,0,82,80,71,3,1,2
-1,131210101263001.000000000000000,Block 3001, Block Group 3, Census Tract 101.26, Fulton County, Georgia,82,42,40,37,18,18,1,3
-1,131210103142006.000000000000000,Block 2006, Block Group 2, Census Tract 103.14, Fulton County, Georgia,82,4,78,73,20,53,0,5
-1,131210105191000.000000000000000,Block 1000, Block Group 1, Census Tract 105.19, Fulton County, Georgia,82,19,63,62,29,30,1,1
-1,131210105202018.000000000000000,Block 2018, Block Group 2, Census Tract 105.20, Fulton County, Georgia,82,2,80,80,11,68,0,0
-1,131210105211008.000000000000000,Block 1008, Block Group 1, Census Tract 105.21, Fulton County, Georgia,82,15,67,66,0,66,0,1
-1,131210105323006.000000000000000,Block 3006, Block Group 3, Census Tract 105.32, Fulton County, Georgia,82,15,67,66,6,60,0,1
-1,131210105342006.000000000000000,Block 2006, Block Group 2, Census Tract 105.34, Fulton County, Georgia,82,1,81,81,6,75,0,0
-1,131210105382013.000000000000000,Block 2013, Block Group 2, Census Tract 105.38, Fulton County, Georgia,82,3,79,79,3,76,0,0
-1,131210108013011.000000000000000,Block 3011, Block Group 3, Census Tract 108.01, Fulton County, Georgia,82,46,36,36,15,21,0,0
-1,131210113012002.000000000000000,Block 2002, Block Group 2, Census Tract 113.01, Fulton County, Georgia,82,16,66,62,4,58,0,4
-1,131210113081001.000000000000000,Block 1001, Block Group 1, Census Tract 113.08, Fulton County, Georgia,82,2,80,79,0,78,0,1
-1,131210114461003.000000000000000,Block 1003, Block Group 1, Census Tract 114.46, Fulton County, Georgia,82,9,73,58,51,6,0,15
-1,131210115102017.000000000000000,Block 2017, Block Group 2, Census Tract 115.10, Fulton County, Georgia,82,1,81,78,64,7,0,3
-1,131210116122004.000000000000000,Block 2004, Block Group 2, Census Tract 116.12, Fulton County, Georgia,82,4,78,72,62,1,0,6
-1,131210116183020.000000000000000,Block 3020, Block Group 3, Census Tract 116.18, Fulton County, Georgia,82,4,78,64,27,11,0,14
-1,131210116453008.000000000000000,Block 3008, Block Group 3, Census Tract 116.45, Fulton County, Georgia,82,20,62,48,34,3,0,14
-1,131210118011020.000000000000000,Block 1020, Block Group 1, Census Tract 118.01, Fulton County, Georgia,82,6,76,73,5,67,0,3
-1,131210119011042.000000000000000,Block 1042, Block Group 1, Census Tract 119.01, Fulton County, Georgia,82,4,78,78,37,31,0,0
-1,131210001003010.000000000000000,Block 3010, Block Group 3, Census Tract 1, Fulton County, Georgia,81,4,77,70,70,0,0,7
-1,131210012032006.000000000000000,Block 2006, Block Group 2, Census Tract 12.03, Fulton County, Georgia,81,12,69,66,54,2,0,3
-1,131210015021004.000000000000000,Block 1004, Block Group 1, Census Tract 15.02, Fulton County, Georgia,81,1,80,78,75,0,2,2
-1,131210017011011.000000000000000,Block 1011, Block Group 1, Census Tract 17.01, Fulton County, Georgia,81,11,70,68,31,32,3,2
-1,131210024002005.000000000000000,Block 2005, Block Group 2, Census Tract 24, Fulton County, Georgia,81,3,78,77,0,77,0,1
-1,131210049001003.000000000000000,Block 1003, Block Group 1, Census Tract 49, Fulton County, Georgia,81,4,77,76,19,53,0,1
-1,131210052003003.000000000000000,Block 3003, Block Group 3, Census Tract 52, Fulton County, Georgia,81,1,80,80,56,19,0,0
-1,131210060001004.000000000000000,Block 1004, Block Group 1, Census Tract 60, Fulton County, Georgia,81,0,81,81,24,57,0,0
-1,131210060004007.000000000000000,Block 4007, Block Group 4, Census Tract 60, Fulton County, Georgia,81,1,80,80,14,65,1,0
-1,131210061003026.000000000000000,Block 3026, Block Group 3, Census Tract 61, Fulton County, Georgia,81,4,77,77,13,64,0,0
-1,131210067022011.000000000000000,Block 2011, Block Group 2, Census Tract 67.02, Fulton County, Georgia,81,7,74,72,8,64,0,2
-1,131210077072008.000000000000000,Block 2008, Block Group 2, Census Tract 77.07, Fulton County, Georgia,81,2,79,75,0,75,0,4
-1,131210077092005.000000000000000,Block 2005, Block Group 2, Census Tract 77.09, Fulton County, Georgia,81,2,79,78,1,75,2,1
-1,131210078051028.000000000000000,Block 1028, Block Group 1, Census Tract 78.05, Fulton County, Georgia,81,2,79,76,0,76,0,3
-1,131210078071008.000000000000000,Block 1008, Block Group 1, Census Tract 78.07, Fulton County, Georgia,81,5,76,73,0,73,0,3
-1,131210080001003.000000000000000,Block 1003, Block Group 1, Census Tract 80, Fulton County, Georgia,81,4,77,71,4,67,0,6
-1,131210083011004.000000000000000,Block 1004, Block Group 1, Census Tract 83.01, Fulton County, Georgia,81,2,79,79,0,79,0,0
-1,131210083012012.000000000000000,Block 2012, Block Group 2, Census Tract 83.01, Fulton County, Georgia,81,1,80,79,3,76,0,1
-1,131210088011016.000000000000000,Block 1016, Block Group 1, Census Tract 88.01, Fulton County, Georgia,81,7,74,70,18,48,0,4
-1,131210093011015.000000000000000,Block 1015, Block Group 1, Census Tract 93.01, Fulton County, Georgia,81,0,81,76,73,3,0,5
-1,131210098022006.000000000000000,Block 2006, Block Group 2, Census Tract 98.02, Fulton County, Georgia,81,0,81,77,58,10,3,4
-1,131210100051009.000000000000000,Block 1009, Block Group 1, Census Tract 100.05, Fulton County, Georgia,81,5,76,70,66,3,1,6
-1,131210101062007.000000000000000,Block 2007, Block Group 2, Census Tract 101.06, Fulton County, Georgia,81,10,71,69,56,4,3,2
-1,131210101361001.000000000000000,Block 1001, Block Group 1, Census Tract 101.36, Fulton County, Georgia,81,4,77,76,64,0,0,1
-1,131210101362015.000000000000000,Block 2015, Block Group 2, Census Tract 101.36, Fulton County, Georgia,81,10,71,70,69,1,0,1
-1,131210105271012.000000000000000,Block 1012, Block Group 1, Census Tract 105.27, Fulton County, Georgia,81,6,75,71,0,70,0,4
-1,131210105283006.000000000000000,Block 3006, Block Group 3, Census Tract 105.28, Fulton County, Georgia,81,0,81,78,9,69,0,3
-1,131210105332011.000000000000000,Block 2011, Block Group 2, Census Tract 105.33, Fulton County, Georgia,81,4,77,75,0,74,1,2
-1,131210112025010.000000000000000,Block 5010, Block Group 5, Census Tract 112.02, Fulton County, Georgia,81,3,78,75,0,75,0,3
-1,131210113061016.000000000000000,Block 1016, Block Group 1, Census Tract 113.06, Fulton County, Georgia,81,1,80,79,3,76,0,1
-1,131210114161006.000000000000000,Block 1006, Block Group 1, Census Tract 114.16, Fulton County, Georgia,81,0,81,74,65,6,0,7
-1,131210114214002.000000000000000,Block 4002, Block Group 4, Census Tract 114.21, Fulton County, Georgia,81,36,45,35,23,4,0,10
-1,131210114342010.000000000000000,Block 2010, Block Group 2, Census Tract 114.34, Fulton County, Georgia,81,4,77,74,56,16,2,3
-1,131210114381005.000000000000000,Block 1005, Block Group 1, Census Tract 114.38, Fulton County, Georgia,81,2,79,68,56,8,2,11
-1,131210114461005.000000000000000,Block 1005, Block Group 1, Census Tract 114.46, Fulton County, Georgia,81,9,72,62,51,7,0,10
-1,131210115073009.000000000000000,Block 3009, Block Group 3, Census Tract 115.07, Fulton County, Georgia,81,1,80,70,53,8,1,10
-1,131210115122002.000000000000000,Block 2002, Block Group 2, Census Tract 115.12, Fulton County, Georgia,81,2,79,79,72,0,0,0
-1,131210116382001.000000000000000,Block 2001, Block Group 2, Census Tract 116.38, Fulton County, Georgia,81,5,76,71,57,9,0,5
-1,131210116401017.000000000000000,Block 1017, Block Group 1, Census Tract 116.40, Fulton County, Georgia,81,13,68,62,42,16,1,6
-1,131210116541001.000000000000000,Block 1001, Block Group 1, Census Tract 116.54, Fulton County, Georgia,81,9,72,60,39,1,0,12
-1,131210116542003.000000000000000,Block 2003, Block Group 2, Census Tract 116.54, Fulton County, Georgia,81,7,74,71,62,0,2,3
-1,131210116552007.000000000000000,Block 2007, Block Group 2, Census Tract 116.55, Fulton County, Georgia,81,10,71,70,61,3,0,1
-1,131210010022001.000000000000000,Block 2001, Block Group 2, Census Tract 10.02, Fulton County, Georgia,80,11,69,67,36,6,1,2
-1,131210013011004.000000000000000,Block 1004, Block Group 1, Census Tract 13.01, Fulton County, Georgia,80,2,78,70,60,0,0,8
-1,131210015011007.000000000000000,Block 1007, Block Group 1, Census Tract 15.01, Fulton County, Georgia,80,5,75,73,48,13,0,2
-1,131210017012007.000000000000000,Block 2007, Block Group 2, Census Tract 17.01, Fulton County, Georgia,80,1,79,75,3,70,0,4
-1,131210035002033.000000000000000,Block 2033, Block Group 2, Census Tract 35, Fulton County, Georgia,80,2,78,71,57,13,0,7
-1,131210040002001.000000000000000,Block 2001, Block Group 2, Census Tract 40, Fulton County, Georgia,80,3,77,76,7,69,0,1
-1,131210043003007.000000000000000,Block 3007, Block Group 3, Census Tract 43, Fulton County, Georgia,80,0,80,80,5,71,2,0
-1,131210055012005.000000000000000,Block 2005, Block Group 2, Census Tract 55.01, Fulton County, Georgia,80,7,73,72,22,50,0,1
-1,131210061003008.000000000000000,Block 3008, Block Group 3, Census Tract 61, Fulton County, Georgia,80,0,80,79,16,62,0,1
-1,131210071001010.000000000000000,Block 1010, Block Group 1, Census Tract 71, Fulton County, Georgia,80,5,75,75,3,72,0,0
-1,131210074002012.000000000000000,Block 2012, Block Group 2, Census Tract 74, Fulton County, Georgia,80,6,74,73,19,54,0,1
-1,131210083012007.000000000000000,Block 2007, Block Group 2, Census Tract 83.01, Fulton County, Georgia,80,0,80,79,7,72,0,1
-1,131210083022008.000000000000000,Block 2008, Block Group 2, Census Tract 83.02, Fulton County, Georgia,80,0,80,79,0,79,0,1
-1,131210085003011.000000000000000,Block 3011, Block Group 3, Census Tract 85, Fulton County, Georgia,80,1,79,78,5,73,0,1
-1,131210088021017.000000000000000,Block 1017, Block Group 1, Census Tract 88.02, Fulton County, Georgia,80,3,77,75,72,2,0,2
-1,131210089062007.000000000000000,Block 2007, Block Group 2, Census Tract 89.06, Fulton County, Georgia,80,7,73,64,62,0,1,9
-1,131210094112000.000000000000000,Block 2000, Block Group 2, Census Tract 94.11, Fulton County, Georgia,80,5,75,71,59,2,0,4
-1,131210096043001.000000000000000,Block 3001, Block Group 3, Census Tract 96.04, Fulton County, Georgia,80,13,67,67,52,13,0,0
-1,131210096043008.000000000000000,Block 3008, Block Group 3, Census Tract 96.04, Fulton County, Georgia,80,4,76,72,65,4,1,4
-1,131210098023006.000000000000000,Block 3006, Block Group 3, Census Tract 98.02, Fulton County, Georgia,80,7,73,72,56,3,0,1
-1,131210098041006.000000000000000,Block 1006, Block Group 1, Census Tract 98.04, Fulton County, Georgia,80,1,79,75,75,0,0,4
-1,131210100042004.000000000000000,Block 2004, Block Group 2, Census Tract 100.04, Fulton County, Georgia,80,2,78,70,60,6,3,8
-1,131210101172005.000000000000000,Block 2005, Block Group 2, Census Tract 101.17, Fulton County, Georgia,80,17,63,59,22,29,1,4
-1,131210101321006.000000000000000,Block 1006, Block Group 1, Census Tract 101.32, Fulton County, Georgia,80,9,71,65,62,2,0,6
-1,131210102043004.000000000000000,Block 3004, Block Group 3, Census Tract 102.04, Fulton County, Georgia,80,3,77,73,67,3,0,4
-1,131210103151005.000000000000000,Block 1005, Block Group 1, Census Tract 103.15, Fulton County, Georgia,80,1,79,76,0,75,1,3
-1,131210105271007.000000000000000,Block 1007, Block Group 1, Census Tract 105.27, Fulton County, Georgia,80,28,52,51,1,47,0,1
-1,131210105361000.000000000000000,Block 1000, Block Group 1, Census Tract 105.36, Fulton County, Georgia,80,0,80,80,2,74,3,0
-1,131210105381009.000000000000000,Block 1009, Block Group 1, Census Tract 105.38, Fulton County, Georgia,80,1,79,78,13,65,0,1
-1,131210113014003.000000000000000,Block 4003, Block Group 4, Census Tract 113.01, Fulton County, Georgia,80,12,68,63,11,49,0,5
-1,131210113016001.000000000000000,Block 6001, Block Group 6, Census Tract 113.01, Fulton County, Georgia,80,8,72,71,5,66,0,1
-1,131210113093001.000000000000000,Block 3001, Block Group 3, Census Tract 113.09, Fulton County, Georgia,80,7,73,67,0,52,5,6
-1,131210114232001.000000000000000,Block 2001, Block Group 2, Census Tract 114.23, Fulton County, Georgia,80,6,74,70,62,2,2,4
-1,131210114282005.000000000000000,Block 2005, Block Group 2, Census Tract 114.28, Fulton County, Georgia,80,7,73,64,35,3,0,9
-1,131210114352005.000000000000000,Block 2005, Block Group 2, Census Tract 114.35, Fulton County, Georgia,80,16,64,53,20,26,7,11
-1,131210114362001.000000000000000,Block 2001, Block Group 2, Census Tract 114.36, Fulton County, Georgia,80,5,75,64,52,9,0,11
-1,131210115102013.000000000000000,Block 2013, Block Group 2, Census Tract 115.10, Fulton County, Georgia,80,2,78,71,55,3,1,7
-1,131210116121006.000000000000000,Block 1006, Block Group 1, Census Tract 116.12, Fulton County, Georgia,80,0,80,70,43,0,0,10
-1,131210116372005.000000000000000,Block 2005, Block Group 2, Census Tract 116.37, Fulton County, Georgia,80,15,65,65,54,2,1,0
-1,131210005022020.000000000000000,Block 2020, Block Group 2, Census Tract 5.02, Fulton County, Georgia,79,1,78,73,68,0,0,5
-1,131210067021015.000000000000000,Block 1015, Block Group 1, Census Tract 67.02, Fulton County, Georgia,79,0,79,77,0,77,0,2
-1,131210070021005.000000000000000,Block 1005, Block Group 1, Census Tract 70.02, Fulton County, Georgia,79,8,71,70,1,69,0,1
-1,131210077081000.000000000000000,Block 1000, Block Group 1, Census Tract 77.08, Fulton County, Georgia,79,7,72,70,0,69,1,2
-1,131210078073007.000000000000000,Block 3007, Block Group 3, Census Tract 78.07, Fulton County, Georgia,79,8,71,68,3,65,0,3
-1,131210082021004.000000000000000,Block 1004, Block Group 1, Census Tract 82.02, Fulton County, Georgia,79,3,76,75,2,73,0,1
-1,131210082022001.000000000000000,Block 2001, Block Group 2, Census Tract 82.02, Fulton County, Georgia,79,6,73,66,0,66,0,7
-1,131210084001017.000000000000000,Block 1017, Block Group 1, Census Tract 84, Fulton County, Georgia,79,0,79,74,0,74,0,5
-1,131210084002006.000000000000000,Block 2006, Block Group 2, Census Tract 84, Fulton County, Georgia,79,2,77,77,0,74,0,0
-1,131210090022017.000000000000000,Block 2017, Block Group 2, Census Tract 90.02, Fulton County, Georgia,79,0,79,78,78,0,0,1
-1,131210093011006.000000000000000,Block 1006, Block Group 1, Census Tract 93.01, Fulton County, Georgia,79,9,70,68,68,0,0,2
-1,131210093011013.000000000000000,Block 1013, Block Group 1, Census Tract 93.01, Fulton County, Georgia,79,0,79,73,73,0,0,6
-1,131210097003014.000000000000000,Block 3014, Block Group 3, Census Tract 97, Fulton County, Georgia,79,7,72,71,68,0,1,1
-1,131210098032003.000000000000000,Block 2003, Block Group 2, Census Tract 98.03, Fulton County, Georgia,79,7,72,71,71,0,0,1
-1,131210101271005.000000000000000,Block 1005, Block Group 1, Census Tract 101.27, Fulton County, Georgia,79,7,72,63,30,2,0,9
-1,131210101331009.000000000000000,Block 1009, Block Group 1, Census Tract 101.33, Fulton County, Georgia,79,7,72,69,24,4,3,3
-1,131210101353002.000000000000000,Block 3002, Block Group 3, Census Tract 101.35, Fulton County, Georgia,79,24,55,44,21,21,2,11
-1,131210102111013.000000000000000,Block 1013, Block Group 1, Census Tract 102.11, Fulton County, Georgia,79,1,78,77,71,0,0,1
-1,131210103093015.000000000000000,Block 3015, Block Group 3, Census Tract 103.09, Fulton County, Georgia,79,1,78,77,1,75,1,1
-1,131210103101012.000000000000000,Block 1012, Block Group 1, Census Tract 103.10, Fulton County, Georgia,79,5,74,68,0,68,0,6
-1,131210105171005.000000000000000,Block 1005, Block Group 1, Census Tract 105.17, Fulton County, Georgia,79,1,78,78,0,75,3,0
-1,131210105323002.000000000000000,Block 3002, Block Group 3, Census Tract 105.32, Fulton County, Georgia,79,3,76,76,6,70,0,0
-1,131210105342008.000000000000000,Block 2008, Block Group 2, Census Tract 105.34, Fulton County, Georgia,79,0,79,76,7,67,2,3
-1,131210106031004.000000000000000,Block 1004, Block Group 1, Census Tract 106.03, Fulton County, Georgia,79,6,73,73,0,72,0,0
-1,131210112023029.000000000000000,Block 3029, Block Group 3, Census Tract 112.02, Fulton County, Georgia,79,34,45,44,5,38,0,1
-1,131210113081009.000000000000000,Block 1009, Block Group 1, Census Tract 113.08, Fulton County, Georgia,79,0,79,77,0,77,0,2
-1,131210114231008.000000000000000,Block 1008, Block Group 1, Census Tract 114.23, Fulton County, Georgia,79,20,59,58,51,5,0,1
-1,131210114232003.000000000000000,Block 2003, Block Group 2, Census Tract 114.23, Fulton County, Georgia,79,7,72,69,59,9,1,3
-1,131210114301002.000000000000000,Block 1002, Block Group 1, Census Tract 114.30, Fulton County, Georgia,79,56,23,17,7,8,0,6
-1,131210114352003.000000000000000,Block 2003, Block Group 2, Census Tract 114.35, Fulton County, Georgia,79,14,65,49,46,2,0,16
-1,131210114391004.000000000000000,Block 1004, Block Group 1, Census Tract 114.39, Fulton County, Georgia,79,4,75,71,68,1,0,4
-1,131210115073008.000000000000000,Block 3008, Block Group 3, Census Tract 115.07, Fulton County, Georgia,79,6,73,69,65,4,0,4
-1,131210116551015.000000000000000,Block 1015, Block Group 1, Census Tract 116.55, Fulton County, Georgia,79,0,79,72,70,0,0,7
-1,131210116551017.000000000000000,Block 1017, Block Group 1, Census Tract 116.55, Fulton County, Georgia,79,3,76,73,63,6,0,3
-1,131210120002008.000000000000000,Block 2008, Block Group 2, Census Tract 120, Fulton County, Georgia,79,1,78,73,0,71,0,5
-1,131210011022000.000000000000000,Block 2000, Block Group 2, Census Tract 11.02, Fulton County, Georgia,78,10,68,59,51,2,0,9
-1,131210012032005.000000000000000,Block 2005, Block Group 2, Census Tract 12.03, Fulton County, Georgia,78,6,72,69,55,7,0,3
-1,131210013011010.000000000000000,Block 1010, Block Group 1, Census Tract 13.01, Fulton County, Georgia,78,0,78,74,65,8,1,4
-1,131210024002008.000000000000000,Block 2008, Block Group 2, Census Tract 24, Fulton County, Georgia,78,5,73,73,0,72,1,0
-1,131210042003019.000000000000000,Block 3019, Block Group 3, Census Tract 42, Fulton County, Georgia,78,4,74,73,6,67,0,1
-1,131210052001013.000000000000000,Block 1013, Block Group 1, Census Tract 52, Fulton County, Georgia,78,1,77,70,64,6,0,7
-1,131210066021000.000000000000000,Block 1000, Block Group 1, Census Tract 66.02, Fulton County, Georgia,78,2,76,76,0,73,3,0
-1,131210069001003.000000000000000,Block 1003, Block Group 1, Census Tract 69, Fulton County, Georgia,78,10,68,62,51,11,0,6
-1,131210070014006.000000000000000,Block 4006, Block Group 4, Census Tract 70.01, Fulton County, Georgia,78,0,78,71,2,69,0,7
-1,131210075003013.000000000000000,Block 3013, Block Group 3, Census Tract 75, Fulton County, Georgia,78,10,68,68,5,57,0,0
-1,131210077033014.000000000000000,Block 3014, Block Group 3, Census Tract 77.03, Fulton County, Georgia,78,0,78,75,1,73,1,3
-1,131210077053010.000000000000000,Block 3010, Block Group 3, Census Tract 77.05, Fulton County, Georgia,78,2,76,75,0,74,0,1
-1,131210078062009.000000000000000,Block 2009, Block Group 2, Census Tract 78.06, Fulton County, Georgia,78,10,68,61,0,61,0,7
-1,131210078071005.000000000000000,Block 1005, Block Group 1, Census Tract 78.07, Fulton County, Georgia,78,9,69,68,3,60,5,1
-1,131210078102007.000000000000000,Block 2007, Block Group 2, Census Tract 78.10, Fulton County, Georgia,78,3,75,72,1,70,0,3
-1,131210088021010.000000000000000,Block 1010, Block Group 1, Census Tract 88.02, Fulton County, Georgia,78,6,72,70,45,19,0,2
-1,131210091051005.000000000000000,Block 1005, Block Group 1, Census Tract 91.05, Fulton County, Georgia,78,3,75,71,71,0,0,4
-1,131210095012008.000000000000000,Block 2008, Block Group 2, Census Tract 95.01, Fulton County, Georgia,78,0,78,75,73,0,1,3
-1,131210097001001.000000000000000,Block 1001, Block Group 1, Census Tract 97, Fulton County, Georgia,78,1,77,69,61,7,0,8
-1,131210100061002.000000000000000,Block 1002, Block Group 1, Census Tract 100.06, Fulton County, Georgia,78,12,66,52,35,9,0,14
-1,131210101081001.000000000000000,Block 1001, Block Group 1, Census Tract 101.08, Fulton County, Georgia,78,5,73,67,58,4,0,6
-1,131210101321002.000000000000000,Block 1002, Block Group 1, Census Tract 101.32, Fulton County, Georgia,78,14,64,61,49,8,0,3
-1,131210102113005.000000000000000,Block 3005, Block Group 3, Census Tract 102.11, Fulton County, Georgia,78,3,75,70,57,8,0,5
-1,131210103083005.000000000000000,Block 3005, Block Group 3, Census Tract 103.08, Fulton County, Georgia,78,8,70,69,0,68,1,1
-1,131210105342011.000000000000000,Block 2011, Block Group 2, Census Tract 105.34, Fulton County, Georgia,78,2,76,73,4,69,0,3
-1,131210105342014.000000000000000,Block 2014, Block Group 2, Census Tract 105.34, Fulton County, Georgia,78,2,76,75,6,68,1,1
-1,131210105401035.000000000000000,Block 1035, Block Group 1, Census Tract 105.40, Fulton County, Georgia,78,15,63,60,7,53,0,3
-1,131210114192005.000000000000000,Block 2005, Block Group 2, Census Tract 114.19, Fulton County, Georgia,78,12,66,58,49,6,0,8
-1,131210114452009.000000000000000,Block 2009, Block Group 2, Census Tract 114.45, Fulton County, Georgia,78,4,74,69,63,1,0,5
-1,131210115051001.000000000000000,Block 1001, Block Group 1, Census Tract 115.05, Fulton County, Georgia,78,13,65,62,57,1,3,3
-1,131210115051003.000000000000000,Block 1003, Block Group 1, Census Tract 115.05, Fulton County, Georgia,78,1,77,72,65,7,0,5
-1,131210115111007.000000000000000,Block 1007, Block Group 1, Census Tract 115.11, Fulton County, Georgia,78,7,71,70,37,0,0,1
-1,131210116301005.000000000000000,Block 1005, Block Group 1, Census Tract 116.30, Fulton County, Georgia,78,13,65,60,40,2,1,5
-1,131210116482002.000000000000000,Block 2002, Block Group 2, Census Tract 116.48, Fulton County, Georgia,78,10,68,66,0,5,0,2
-1,131210005022025.000000000000000,Block 2025, Block Group 2, Census Tract 5.02, Fulton County, Georgia,77,2,75,75,73,2,0,0
-1,131210014001002.000000000000000,Block 1002, Block Group 1, Census Tract 14, Fulton County, Georgia,77,1,76,72,64,8,0,4
-1,131210030001002.000000000000000,Block 1002, Block Group 1, Census Tract 30, Fulton County, Georgia,77,8,69,69,58,5,1,0
-1,131210055011020.000000000000000,Block 1020, Block Group 1, Census Tract 55.01, Fulton County, Georgia,77,4,73,72,22,50,0,1
-1,131210073022001.000000000000000,Block 2001, Block Group 2, Census Tract 73.02, Fulton County, Georgia,77,5,72,71,2,69,0,1
-1,131210077033009.000000000000000,Block 3009, Block Group 3, Census Tract 77.03, Fulton County, Georgia,77,4,73,72,0,68,2,1
-1,131210078064009.000000000000000,Block 4009, Block Group 4, Census Tract 78.06, Fulton County, Georgia,77,0,77,76,0,76,0,1
-1,131210079001004.000000000000000,Block 1004, Block Group 1, Census Tract 79, Fulton County, Georgia,77,0,77,74,0,74,0,3
-1,131210080005006.000000000000000,Block 5006, Block Group 5, Census Tract 80, Fulton County, Georgia,77,2,75,75,0,73,0,0
-1,131210093022006.000000000000000,Block 2006, Block Group 2, Census Tract 93.02, Fulton County, Georgia,77,9,68,58,50,3,0,10
-1,131210094052002.000000000000000,Block 2002, Block Group 2, Census Tract 94.05, Fulton County, Georgia,77,7,70,60,40,5,3,10
-1,131210098031009.000000000000000,Block 1009, Block Group 1, Census Tract 98.03, Fulton County, Georgia,77,3,74,73,71,2,0,1
-1,131210099003006.000000000000000,Block 3006, Block Group 3, Census Tract 99, Fulton County, Georgia,77,0,77,71,67,0,0,6
-1,131210102172005.000000000000000,Block 2005, Block Group 2, Census Tract 102.17, Fulton County, Georgia,77,4,73,70,63,5,0,3
-1,131210103072023.000000000000000,Block 2023, Block Group 2, Census Tract 103.07, Fulton County, Georgia,77,8,69,69,2,66,1,0
-1,131210103103013.000000000000000,Block 3013, Block Group 3, Census Tract 103.10, Fulton County, Georgia,77,2,75,71,2,69,0,4
-1,131210104011021.000000000000000,Block 1021, Block Group 1, Census Tract 104.01, Fulton County, Georgia,77,4,73,73,18,51,0,0
-1,131210105243002.000000000000000,Block 3002, Block Group 3, Census Tract 105.24, Fulton County, Georgia,77,7,70,65,2,63,0,5
-1,131210106031000.000000000000000,Block 1000, Block Group 1, Census Tract 106.03, Fulton County, Georgia,77,2,75,72,3,68,1,3
-1,131210113071011.000000000000000,Block 1011, Block Group 1, Census Tract 113.07, Fulton County, Georgia,77,3,74,72,1,68,2,2
-1,131210113073004.000000000000000,Block 3004, Block Group 3, Census Tract 113.07, Fulton County, Georgia,77,2,75,72,1,69,2,3
-1,131210114223003.000000000000000,Block 3003, Block Group 3, Census Tract 114.22, Fulton County, Georgia,77,6,71,67,66,1,0,4
-1,131210114342006.000000000000000,Block 2006, Block Group 2, Census Tract 114.34, Fulton County, Georgia,77,4,73,70,62,6,0,3
-1,131210114372009.000000000000000,Block 2009, Block Group 2, Census Tract 114.37, Fulton County, Georgia,77,14,63,58,58,0,0,5
-1,131210114383001.000000000000000,Block 3001, Block Group 3, Census Tract 114.38, Fulton County, Georgia,77,5,72,70,47,3,3,2
-1,131210116542005.000000000000000,Block 2005, Block Group 2, Census Tract 116.54, Fulton County, Georgia,77,2,75,71,29,0,6,4
-1,131210123002032.000000000000000,Block 2032, Block Group 2, Census Tract 123, Fulton County, Georgia,77,12,65,65,5,60,0,0
-1,131210002022004.000000000000000,Block 2004, Block Group 2, Census Tract 2.02, Fulton County, Georgia,76,3,73,70,68,0,0,3
-1,131210010022021.000000000000000,Block 2021, Block Group 2, Census Tract 10.02, Fulton County, Georgia,76,8,68,64,56,0,0,4
-1,131210012041006.000000000000000,Block 1006, Block Group 1, Census Tract 12.04, Fulton County, Georgia,76,9,67,62,54,2,1,5
-1,131210018011001.000000000000000,Block 1001, Block Group 1, Census Tract 18.01, Fulton County, Georgia,76,2,74,72,8,59,2,2
-1,131210024001009.000000000000000,Block 1009, Block Group 1, Census Tract 24, Fulton County, Georgia,76,11,65,60,3,53,2,5
-1,131210025002015.000000000000000,Block 2015, Block Group 2, Census Tract 25, Fulton County, Georgia,76,0,76,72,1,70,0,4
-1,131210029001004.000000000000000,Block 1004, Block Group 1, Census Tract 29, Fulton County, Georgia,76,1,75,71,53,14,0,4
-1,131210032001006.000000000000000,Block 1006, Block Group 1, Census Tract 32, Fulton County, Georgia,76,5,71,68,57,8,0,3
-1,131210041001007.000000000000000,Block 1007, Block Group 1, Census Tract 41, Fulton County, Georgia,76,5,71,63,12,49,2,8
-1,131210041002010.000000000000000,Block 2010, Block Group 2, Census Tract 41, Fulton County, Georgia,76,4,72,69,6,63,0,3
-1,131210043003000.000000000000000,Block 3000, Block Group 3, Census Tract 43, Fulton County, Georgia,76,0,76,73,27,46,0,3
-1,131210060003009.000000000000000,Block 3009, Block Group 3, Census Tract 60, Fulton County, Georgia,76,0,76,72,7,65,0,4
-1,131210061003027.000000000000000,Block 3027, Block Group 3, Census Tract 61, Fulton County, Georgia,76,1,75,74,4,70,0,1
-1,131210062002003.000000000000000,Block 2003, Block Group 2, Census Tract 62, Fulton County, Georgia,76,3,73,73,10,63,0,0
-1,131210065004004.000000000000000,Block 4004, Block Group 4, Census Tract 65, Fulton County, Georgia,76,4,72,71,17,50,0,1
-1,131210065004012.000000000000000,Block 4012, Block Group 4, Census Tract 65, Fulton County, Georgia,76,2,74,73,28,45,0,1
-1,131210067022000.000000000000000,Block 2000, Block Group 2, Census Tract 67.02, Fulton County, Georgia,76,0,76,75,25,49,0,1
-1,131210073011003.000000000000000,Block 1003, Block Group 1, Census Tract 73.01, Fulton County, Georgia,76,1,75,75,0,74,1,0
-1,131210076023006.000000000000000,Block 3006, Block Group 3, Census Tract 76.02, Fulton County, Georgia,76,2,74,72,2,67,0,2
-1,131210077051004.000000000000000,Block 1004, Block Group 1, Census Tract 77.05, Fulton County, Georgia,76,2,74,69,4,65,0,5
-1,131210077112010.000000000000000,Block 2010, Block Group 2, Census Tract 77.11, Fulton County, Georgia,76,4,72,72,0,72,0,0
-1,131210083011013.000000000000000,Block 1013, Block Group 1, Census Tract 83.01, Fulton County, Georgia,76,0,76,71,3,68,0,5
-1,131210083022001.000000000000000,Block 2001, Block Group 2, Census Tract 83.02, Fulton County, Georgia,76,0,76,76,0,74,2,0
-1,131210084001008.000000000000000,Block 1008, Block Group 1, Census Tract 84, Fulton County, Georgia,76,0,76,70,0,70,0,6
-1,131210085003013.000000000000000,Block 3013, Block Group 3, Census Tract 85, Fulton County, Georgia,76,2,74,72,0,72,0,2
-1,131210085003035.000000000000000,Block 3035, Block Group 3, Census Tract 85, Fulton County, Georgia,76,2,74,74,1,73,0,0
-1,131210090021015.000000000000000,Block 1015, Block Group 1, Census Tract 90.02, Fulton County, Georgia,76,0,76,72,72,0,0,4
-1,131210098041013.000000000000000,Block 1013, Block Group 1, Census Tract 98.04, Fulton County, Georgia,76,0,76,76,74,1,0,0
-1,131210102111001.000000000000000,Block 1001, Block Group 1, Census Tract 102.11, Fulton County, Georgia,76,2,74,72,67,0,0,2
-1,131210103142001.000000000000000,Block 2001, Block Group 2, Census Tract 103.14, Fulton County, Georgia,76,10,66,66,13,52,1,0
-1,131210104012013.000000000000000,Block 2013, Block Group 2, Census Tract 104.01, Fulton County, Georgia,76,3,73,65,4,61,0,8
-1,131210104013047.000000000000000,Block 3047, Block Group 3, Census Tract 104.01, Fulton County, Georgia,76,6,70,68,7,61,0,2
-1,131210105181008.000000000000000,Block 1008, Block Group 1, Census Tract 105.18, Fulton County, Georgia,76,1,75,75,0,70,2,0
-1,131210105202008.000000000000000,Block 2008, Block Group 2, Census Tract 105.20, Fulton County, Georgia,76,0,76,73,8,65,0,3
-1,131210105311006.000000000000000,Block 1006, Block Group 1, Census Tract 105.31, Fulton County, Georgia,76,6,70,68,0,67,1,2
-1,131210106043004.000000000000000,Block 3004, Block Group 3, Census Tract 106.04, Fulton County, Georgia,76,3,73,71,0,71,0,2
-1,131210112021010.000000000000000,Block 1010, Block Group 1, Census Tract 112.02, Fulton County, Georgia,76,2,74,71,22,49,0,3
-1,131210112041008.000000000000000,Block 1008, Block Group 1, Census Tract 112.04, Fulton County, Georgia,76,0,76,71,26,45,0,5
-1,131210114232005.000000000000000,Block 2005, Block Group 2, Census Tract 114.23, Fulton County, Georgia,76,12,64,61,54,3,0,3
-1,131210114261006.000000000000000,Block 1006, Block Group 1, Census Tract 114.26, Fulton County, Georgia,76,13,63,63,37,3,2,0
-1,131210114322001.000000000000000,Block 2001, Block Group 2, Census Tract 114.32, Fulton County, Georgia,76,5,71,67,27,33,0,4
-1,131210114331002.000000000000000,Block 1002, Block Group 1, Census Tract 114.33, Fulton County, Georgia,76,15,61,52,40,0,8,9
-1,131210114353008.000000000000000,Block 3008, Block Group 3, Census Tract 114.35, Fulton County, Georgia,76,7,69,63,56,7,0,6
-1,131210115081006.000000000000000,Block 1006, Block Group 1, Census Tract 115.08, Fulton County, Georgia,76,3,73,73,57,9,0,0
-1,131210115082000.000000000000000,Block 2000, Block Group 2, Census Tract 115.08, Fulton County, Georgia,76,2,74,70,46,20,0,4
-1,131210115122015.000000000000000,Block 2015, Block Group 2, Census Tract 115.12, Fulton County, Georgia,76,1,75,68,64,4,0,7
-1,131210116493013.000000000000000,Block 3013, Block Group 3, Census Tract 116.49, Fulton County, Georgia,76,15,61,56,39,6,5,5
-1,131210001001000.000000000000000,Block 1000, Block Group 1, Census Tract 1, Fulton County, Georgia,75,0,75,74,67,2,5,1
-1,131210004001001.000000000000000,Block 1001, Block Group 1, Census Tract 4, Fulton County, Georgia,75,4,71,68,62,6,0,3
-1,131210006013012.000000000000000,Block 3012, Block Group 3, Census Tract 6.01, Fulton County, Georgia,75,2,73,67,23,8,0,6
-1,131210007001019.000000000000000,Block 1019, Block Group 1, Census Tract 7, Fulton County, Georgia,75,3,72,69,55,6,2,3
-1,131210013022001.000000000000000,Block 2001, Block Group 2, Census Tract 13.02, Fulton County, Georgia,75,11,64,62,42,15,0,2
-1,131210024001015.000000000000000,Block 1015, Block Group 1, Census Tract 24, Fulton County, Georgia,75,0,75,70,0,69,0,5
-1,131210032001002.000000000000000,Block 1002, Block Group 1, Census Tract 32, Fulton County, Georgia,75,2,73,69,48,18,0,4
-1,131210055012011.000000000000000,Block 2011, Block Group 2, Census Tract 55.01, Fulton County, Georgia,75,3,72,69,28,37,3,3
-1,131210060002000.000000000000000,Block 2000, Block Group 2, Census Tract 60, Fulton County, Georgia,75,4,71,68,16,52,0,3
-1,131210061002010.000000000000000,Block 2010, Block Group 2, Census Tract 61, Fulton County, Georgia,75,0,75,72,11,61,0,3
-1,131210065001009.000000000000000,Block 1009, Block Group 1, Census Tract 65, Fulton County, Georgia,75,0,75,73,18,55,0,2
-1,131210066012006.000000000000000,Block 2006, Block Group 2, Census Tract 66.01, Fulton County, Georgia,75,1,74,67,24,42,0,7
-1,131210066012008.000000000000000,Block 2008, Block Group 2, Census Tract 66.01, Fulton County, Georgia,75,3,72,72,8,64,0,0
-1,131210069001001.000000000000000,Block 1001, Block Group 1, Census Tract 69, Fulton County, Georgia,75,4,71,69,60,9,0,2
-1,131210069003018.000000000000000,Block 3018, Block Group 3, Census Tract 69, Fulton County, Georgia,75,10,65,62,32,30,0,3
-1,131210070014011.000000000000000,Block 4011, Block Group 4, Census Tract 70.01, Fulton County, Georgia,75,2,73,72,1,67,2,1
-1,131210070014017.000000000000000,Block 4017, Block Group 4, Census Tract 70.01, Fulton County, Georgia,75,3,72,70,10,60,0,2
-1,131210080003002.000000000000000,Block 3002, Block Group 3, Census Tract 80, Fulton County, Georgia,75,0,75,74,0,67,7,1
-1,131210084001014.000000000000000,Block 1014, Block Group 1, Census Tract 84, Fulton County, Georgia,75,2,73,71,6,65,0,2
-1,131210085001010.000000000000000,Block 1010, Block Group 1, Census Tract 85, Fulton County, Georgia,75,2,73,73,0,73,0,0
-1,131210087012006.000000000000000,Block 2006, Block Group 2, Census Tract 87.01, Fulton County, Georgia,75,1,74,66,8,57,1,8
-1,131210089091000.000000000000000,Block 1000, Block Group 1, Census Tract 89.09, Fulton County, Georgia,75,7,68,68,64,3,0,0
-1,131210093021004.000000000000000,Block 1004, Block Group 1, Census Tract 93.02, Fulton County, Georgia,75,5,70,70,70,0,0,0
-1,131210095011009.000000000000000,Block 1009, Block Group 1, Census Tract 95.01, Fulton County, Georgia,75,0,75,75,72,1,1,0
-1,131210096043007.000000000000000,Block 3007, Block Group 3, Census Tract 96.04, Fulton County, Georgia,75,3,72,68,63,0,0,4
-1,131210102042006.000000000000000,Block 2006, Block Group 2, Census Tract 102.04, Fulton County, Georgia,75,0,75,68,52,4,1,7
-1,131210103061010.000000000000000,Block 1010, Block Group 1, Census Tract 103.06, Fulton County, Georgia,75,2,73,71,3,68,0,2
-1,131210103092016.000000000000000,Block 2016, Block Group 2, Census Tract 103.09, Fulton County, Georgia,75,3,72,71,0,71,0,1
-1,131210103103005.000000000000000,Block 3005, Block Group 3, Census Tract 103.10, Fulton County, Georgia,75,0,75,75,0,75,0,0
-1,131210103131013.000000000000000,Block 1013, Block Group 1, Census Tract 103.13, Fulton County, Georgia,75,0,75,73,0,73,0,2
-1,131210105211002.000000000000000,Block 1002, Block Group 1, Census Tract 105.21, Fulton County, Georgia,75,2,73,72,6,64,0,1
-1,131210105272002.000000000000000,Block 2002, Block Group 2, Census Tract 105.27, Fulton County, Georgia,75,18,57,52,0,50,1,5
-1,131210105293024.000000000000000,Block 3024, Block Group 3, Census Tract 105.29, Fulton County, Georgia,75,1,74,71,1,68,1,3
-1,131210105371018.000000000000000,Block 1018, Block Group 1, Census Tract 105.37, Fulton County, Georgia,75,7,68,63,0,63,0,5
-1,131210105391013.000000000000000,Block 1013, Block Group 1, Census Tract 105.39, Fulton County, Georgia,75,3,72,72,2,70,0,0
-1,131210108012020.000000000000000,Block 2020, Block Group 2, Census Tract 108.01, Fulton County, Georgia,75,16,59,56,34,22,0,3
-1,131210113012006.000000000000000,Block 2006, Block Group 2, Census Tract 113.01, Fulton County, Georgia,75,10,65,65,5,59,0,0
-1,131210113072012.000000000000000,Block 2012, Block Group 2, Census Tract 113.07, Fulton County, Georgia,75,13,62,56,2,54,0,6
-1,131210113103003.000000000000000,Block 3003, Block Group 3, Census Tract 113.10, Fulton County, Georgia,75,1,74,73,12,61,0,1
-1,131210114243000.000000000000000,Block 3000, Block Group 3, Census Tract 114.24, Fulton County, Georgia,75,4,71,41,34,6,0,30
-1,131210114341014.000000000000000,Block 1014, Block Group 1, Census Tract 114.34, Fulton County, Georgia,75,4,71,63,53,7,0,8
-1,131210114341016.000000000000000,Block 1016, Block Group 1, Census Tract 114.34, Fulton County, Georgia,75,15,60,54,45,5,0,6
-1,131210114353003.000000000000000,Block 3003, Block Group 3, Census Tract 114.35, Fulton County, Georgia,75,5,70,66,51,11,3,4
-1,131210115092014.000000000000000,Block 2014, Block Group 2, Census Tract 115.09, Fulton County, Georgia,75,5,70,70,68,0,0,0
-1,131210115102015.000000000000000,Block 2015, Block Group 2, Census Tract 115.10, Fulton County, Georgia,75,2,73,70,25,0,0,3
-1,131210116312002.000000000000000,Block 2002, Block Group 2, Census Tract 116.31, Fulton County, Georgia,75,12,63,51,38,8,0,12
-1,131210116441005.000000000000000,Block 1005, Block Group 1, Census Tract 116.44, Fulton County, Georgia,75,16,59,55,24,26,0,4
-1,131210116462018.000000000000000,Block 2018, Block Group 2, Census Tract 116.46, Fulton County, Georgia,75,1,74,70,45,18,0,4
-1,131210001004015.000000000000000,Block 4015, Block Group 4, Census Tract 1, Fulton County, Georgia,74,1,73,71,59,0,0,2
-1,131210013022002.000000000000000,Block 2002, Block Group 2, Census Tract 13.02, Fulton County, Georgia,74,12,62,61,48,8,0,1
-1,131210017022001.000000000000000,Block 2001, Block Group 2, Census Tract 17.02, Fulton County, Georgia,74,5,69,63,35,27,1,6
-1,131210039002009.000000000000000,Block 2009, Block Group 2, Census Tract 39, Fulton County, Georgia,74,0,74,74,3,71,0,0
-1,131210050001014.000000000000000,Block 1014, Block Group 1, Census Tract 50, Fulton County, Georgia,74,10,64,60,44,12,0,4
-1,131210060001005.000000000000000,Block 1005, Block Group 1, Census Tract 60, Fulton County, Georgia,74,3,71,70,0,67,3,1
-1,131210061001011.000000000000000,Block 1011, Block Group 1, Census Tract 61, Fulton County, Georgia,74,1,73,69,4,65,0,4
-1,131210070011006.000000000000000,Block 1006, Block Group 1, Census Tract 70.01, Fulton County, Georgia,74,12,62,58,0,58,0,4
-1,131210070012017.000000000000000,Block 2017, Block Group 2, Census Tract 70.01, Fulton County, Georgia,74,18,56,56,7,49,0,0
-1,131210070022008.000000000000000,Block 2008, Block Group 2, Census Tract 70.02, Fulton County, Georgia,74,0,74,74,3,69,2,0
-1,131210075003002.000000000000000,Block 3002, Block Group 3, Census Tract 75, Fulton County, Georgia,74,5,69,66,1,64,0,3
-1,131210077053006.000000000000000,Block 3006, Block Group 3, Census Tract 77.05, Fulton County, Georgia,74,3,71,69,1,68,0,2
-1,131210078094007.000000000000000,Block 4007, Block Group 4, Census Tract 78.09, Fulton County, Georgia,74,4,70,67,2,65,0,3
-1,131210082041005.000000000000000,Block 1005, Block Group 1, Census Tract 82.04, Fulton County, Georgia,74,1,73,63,3,60,0,10
-1,131210086021000.000000000000000,Block 1000, Block Group 1, Census Tract 86.02, Fulton County, Georgia,74,8,66,61,0,61,0,5
-1,131210094101008.000000000000000,Block 1008, Block Group 1, Census Tract 94.10, Fulton County, Georgia,74,5,69,66,44,1,1,3
-1,131210095011011.000000000000000,Block 1011, Block Group 1, Census Tract 95.01, Fulton County, Georgia,74,1,73,73,71,0,0,0
-1,131210096061016.000000000000000,Block 1016, Block Group 1, Census Tract 96.06, Fulton County, Georgia,74,5,69,68,60,2,0,1
-1,131210101061004.000000000000000,Block 1004, Block Group 1, Census Tract 101.06, Fulton County, Georgia,74,10,64,49,22,20,1,15
-1,131210101311004.000000000000000,Block 1004, Block Group 1, Census Tract 101.31, Fulton County, Georgia,74,9,65,60,34,7,0,5
-1,131210102171006.000000000000000,Block 1006, Block Group 1, Census Tract 102.17, Fulton County, Georgia,74,8,66,61,52,8,1,5
-1,131210103151007.000000000000000,Block 1007, Block Group 1, Census Tract 103.15, Fulton County, Georgia,74,1,73,66,2,64,0,7
-1,131210105083018.000000000000000,Block 3018, Block Group 3, Census Tract 105.08, Fulton County, Georgia,74,2,72,70,5,65,0,2
-1,131210105083020.000000000000000,Block 3020, Block Group 3, Census Tract 105.08, Fulton County, Georgia,74,1,73,70,0,70,0,3
-1,131210105222032.000000000000000,Block 2032, Block Group 2, Census Tract 105.22, Fulton County, Georgia,74,1,73,68,0,68,0,5
-1,131210106042003.000000000000000,Block 2003, Block Group 2, Census Tract 106.04, Fulton County, Georgia,74,2,72,67,0,67,0,5
-1,131210112025007.000000000000000,Block 5007, Block Group 5, Census Tract 112.02, Fulton County, Georgia,74,9,65,64,0,57,1,1
-1,131210113014010.000000000000000,Block 4010, Block Group 4, Census Tract 113.01, Fulton County, Georgia,74,22,52,52,5,47,0,0
-1,131210113071004.000000000000000,Block 1004, Block Group 1, Census Tract 113.07, Fulton County, Georgia,74,4,70,66,7,58,0,4
-1,131210114261009.000000000000000,Block 1009, Block Group 1, Census Tract 114.26, Fulton County, Georgia,74,30,44,42,39,0,0,2
-1,131210114422017.000000000000000,Block 2017, Block Group 2, Census Tract 114.42, Fulton County, Georgia,74,6,68,67,36,23,1,1
-1,131210115101009.000000000000000,Block 1009, Block Group 1, Census Tract 115.10, Fulton County, Georgia,74,2,72,69,60,5,2,3
-1,131210116412001.000000000000000,Block 2001, Block Group 2, Census Tract 116.41, Fulton County, Georgia,74,8,66,59,48,7,0,7
-1,131210116474004.000000000000000,Block 4004, Block Group 4, Census Tract 116.47, Fulton County, Georgia,74,20,54,53,13,38,0,1
-1,131210116493022.000000000000000,Block 3022, Block Group 3, Census Tract 116.49, Fulton County, Georgia,74,3,71,67,48,3,0,4
-1,131210116501017.000000000000000,Block 1017, Block Group 1, Census Tract 116.50, Fulton County, Georgia,74,8,66,63,1,12,6,3
-1,131210116582004.000000000000000,Block 2004, Block Group 2, Census Tract 116.58, Fulton County, Georgia,74,13,61,55,20,10,0,6
-1,131210005022032.000000000000000,Block 2032, Block Group 2, Census Tract 5.02, Fulton County, Georgia,73,5,68,68,66,0,0,0
-1,131210018021006.000000000000000,Block 1006, Block Group 1, Census Tract 18.02, Fulton County, Georgia,73,9,64,63,32,19,0,1
-1,131210025001012.000000000000000,Block 1012, Block Group 1, Census Tract 25, Fulton County, Georgia,73,3,70,70,1,69,0,0
-1,131210029002001.000000000000000,Block 2001, Block Group 2, Census Tract 29, Fulton County, Georgia,73,1,72,67,61,6,0,5
-1,131210031001015.000000000000000,Block 1015, Block Group 1, Census Tract 31, Fulton County, Georgia,73,8,65,63,57,0,0,2
-1,131210032001005.000000000000000,Block 1005, Block Group 1, Census Tract 32, Fulton County, Georgia,73,0,73,71,48,20,2,2
-1,131210040002008.000000000000000,Block 2008, Block Group 2, Census Tract 40, Fulton County, Georgia,73,0,73,69,4,65,0,4
-1,131210052001014.000000000000000,Block 1014, Block Group 1, Census Tract 52, Fulton County, Georgia,73,10,63,58,46,6,6,5
-1,131210058001036.000000000000000,Block 1036, Block Group 1, Census Tract 58, Fulton County, Georgia,73,0,73,70,13,56,1,3
-1,131210060002009.000000000000000,Block 2009, Block Group 2, Census Tract 60, Fulton County, Georgia,73,1,72,63,16,47,0,9
-1,131210060003001.000000000000000,Block 3001, Block Group 3, Census Tract 60, Fulton County, Georgia,73,1,72,71,7,64,0,1
-1,131210060003006.000000000000000,Block 3006, Block Group 3, Census Tract 60, Fulton County, Georgia,73,1,72,62,4,57,1,10
-1,131210067011009.000000000000000,Block 1009, Block Group 1, Census Tract 67.01, Fulton County, Georgia,73,4,69,67,0,64,2,2
-1,131210071002005.000000000000000,Block 2005, Block Group 2, Census Tract 71, Fulton County, Georgia,73,0,73,69,9,60,0,4
-1,131210074001012.000000000000000,Block 1012, Block Group 1, Census Tract 74, Fulton County, Georgia,73,27,46,45,4,40,0,1
-1,131210074002013.000000000000000,Block 2013, Block Group 2, Census Tract 74, Fulton County, Georgia,73,18,55,54,9,45,0,1
-1,131210080004020.000000000000000,Block 4020, Block Group 4, Census Tract 80, Fulton County, Georgia,73,0,73,73,6,67,0,0
-1,131210083012000.000000000000000,Block 2000, Block Group 2, Census Tract 83.01, Fulton County, Georgia,73,2,71,71,3,68,0,0
-1,131210091031002.000000000000000,Block 1002, Block Group 1, Census Tract 91.03, Fulton County, Georgia,73,6,67,60,52,1,0,7
-1,131210092022020.000000000000000,Block 2020, Block Group 2, Census Tract 92.02, Fulton County, Georgia,73,6,67,63,55,4,0,4
-1,131210094101004.000000000000000,Block 1004, Block Group 1, Census Tract 94.10, Fulton County, Georgia,73,5,68,60,37,16,1,8
-1,131210095011012.000000000000000,Block 1012, Block Group 1, Census Tract 95.01, Fulton County, Georgia,73,0,73,69,68,1,0,4
-1,131210098041001.000000000000000,Block 1001, Block Group 1, Census Tract 98.04, Fulton County, Georgia,73,5,68,64,63,0,1,4
-1,131210100071003.000000000000000,Block 1003, Block Group 1, Census Tract 100.07, Fulton County, Georgia,73,3,70,68,60,1,0,2
-1,131210101071005.000000000000000,Block 1005, Block Group 1, Census Tract 101.07, Fulton County, Georgia,73,5,68,64,55,7,0,4
-1,131210105202004.000000000000000,Block 2004, Block Group 2, Census Tract 105.20, Fulton County, Georgia,73,5,68,68,0,68,0,0
-1,131210105223008.000000000000000,Block 3008, Block Group 3, Census Tract 105.22, Fulton County, Georgia,73,4,69,66,0,64,0,3
-1,131210105243001.000000000000000,Block 3001, Block Group 3, Census Tract 105.24, Fulton County, Georgia,73,7,66,58,4,54,0,8
-1,131210105261003.000000000000000,Block 1003, Block Group 1, Census Tract 105.26, Fulton County, Georgia,73,6,67,67,4,63,0,0
-1,131210105261029.000000000000000,Block 1029, Block Group 1, Census Tract 105.26, Fulton County, Georgia,73,4,69,67,4,60,3,2
-1,131210105264007.000000000000000,Block 4007, Block Group 4, Census Tract 105.26, Fulton County, Georgia,73,2,71,70,0,70,0,1
-1,131210105291014.000000000000000,Block 1014, Block Group 1, Census Tract 105.29, Fulton County, Georgia,73,5,68,64,1,63,0,4
-1,131210105382017.000000000000000,Block 2017, Block Group 2, Census Tract 105.38, Fulton County, Georgia,73,6,67,64,0,60,4,3
-1,131210105391012.000000000000000,Block 1012, Block Group 1, Census Tract 105.39, Fulton County, Georgia,73,1,72,71,1,65,5,1
-1,131210105401020.000000000000000,Block 1020, Block Group 1, Census Tract 105.40, Fulton County, Georgia,73,2,71,69,10,59,0,2
-1,131210105401037.000000000000000,Block 1037, Block Group 1, Census Tract 105.40, Fulton County, Georgia,73,4,69,68,1,66,1,1
-1,131210106043007.000000000000000,Block 3007, Block Group 3, Census Tract 106.04, Fulton County, Georgia,73,6,67,65,0,65,0,2
-1,131210108013016.000000000000000,Block 3016, Block Group 3, Census Tract 108.01, Fulton County, Georgia,73,4,69,61,27,33,0,8
-1,131210108022010.000000000000000,Block 2010, Block Group 2, Census Tract 108.02, Fulton County, Georgia,73,28,45,43,18,22,0,2
-1,131210112022000.000000000000000,Block 2000, Block Group 2, Census Tract 112.02, Fulton County, Georgia,73,18,55,53,9,43,1,2
-1,131210113011000.000000000000000,Block 1000, Block Group 1, Census Tract 113.01, Fulton County, Georgia,73,8,65,62,4,58,0,3
-1,131210113014007.000000000000000,Block 4007, Block Group 4, Census Tract 113.01, Fulton County, Georgia,73,16,57,56,4,51,1,1
-1,131210113103004.000000000000000,Block 3004, Block Group 3, Census Tract 113.10, Fulton County, Georgia,73,5,68,52,0,51,1,16
-1,131210114172013.000000000000000,Block 2013, Block Group 2, Census Tract 114.17, Fulton County, Georgia,73,6,67,63,59,3,0,4
-1,131210114173002.000000000000000,Block 3002, Block Group 3, Census Tract 114.17, Fulton County, Georgia,73,6,67,66,55,4,0,1
-1,131210114302001.000000000000000,Block 2001, Block Group 2, Census Tract 114.30, Fulton County, Georgia,73,35,38,33,15,17,0,5
-1,131210114303001.000000000000000,Block 3001, Block Group 3, Census Tract 114.30, Fulton County, Georgia,73,9,64,63,22,31,5,1
-1,131210114421003.000000000000000,Block 1003, Block Group 1, Census Tract 114.42, Fulton County, Georgia,73,14,59,53,27,20,2,6
-1,131210115122030.000000000000000,Block 2030, Block Group 2, Census Tract 115.12, Fulton County, Georgia,73,3,70,68,58,9,1,2
-1,131210116122003.000000000000000,Block 2003, Block Group 2, Census Tract 116.12, Fulton County, Georgia,73,0,73,72,27,2,0,1
-1,131210116242003.000000000000000,Block 2003, Block Group 2, Census Tract 116.24, Fulton County, Georgia,73,1,72,58,31,4,0,14
-1,131210116291010.000000000000000,Block 1010, Block Group 1, Census Tract 116.29, Fulton County, Georgia,73,5,68,66,50,5,0,2
-1,131210116411003.000000000000000,Block 1003, Block Group 1, Census Tract 116.41, Fulton County, Georgia,73,5,68,65,62,0,3,3
-1,131210116512013.000000000000000,Block 2013, Block Group 2, Census Tract 116.51, Fulton County, Georgia,73,11,62,57,11,4,0,5
-1,131210119011035.000000000000000,Block 1035, Block Group 1, Census Tract 119.01, Fulton County, Georgia,73,2,71,67,17,40,0,4
-1,131210001002006.000000000000000,Block 2006, Block Group 2, Census Tract 1, Fulton County, Georgia,72,2,70,64,64,0,0,6
-1,131210012041010.000000000000000,Block 1010, Block Group 1, Census Tract 12.04, Fulton County, Georgia,72,2,70,67,56,8,1,3
-1,131210013022010.000000000000000,Block 2010, Block Group 2, Census Tract 13.02, Fulton County, Georgia,72,5,67,64,59,0,0,3
-1,131210041003000.000000000000000,Block 3000, Block Group 3, Census Tract 41, Fulton County, Georgia,72,4,68,68,5,60,0,0
-1,131210050002021.000000000000000,Block 2021, Block Group 2, Census Tract 50, Fulton County, Georgia,72,0,72,64,59,0,0,8
-1,131210062001015.000000000000000,Block 1015, Block Group 1, Census Tract 62, Fulton County, Georgia,72,2,70,68,4,64,0,2
-1,131210065002016.000000000000000,Block 2016, Block Group 2, Census Tract 65, Fulton County, Georgia,72,6,66,63,7,56,0,3
-1,131210067022010.000000000000000,Block 2010, Block Group 2, Census Tract 67.02, Fulton County, Georgia,72,0,72,71,6,64,1,1
-1,131210077032013.000000000000000,Block 2013, Block Group 2, Census Tract 77.03, Fulton County, Georgia,72,3,69,68,0,68,0,1
-1,131210077103003.000000000000000,Block 3003, Block Group 3, Census Tract 77.10, Fulton County, Georgia,72,2,70,65,0,64,0,5
-1,131210085003036.000000000000000,Block 3036, Block Group 3, Census Tract 85, Fulton County, Georgia,72,0,72,72,2,68,1,0
-1,131210086014007.000000000000000,Block 4007, Block Group 4, Census Tract 86.01, Fulton County, Georgia,72,0,72,70,4,66,0,2
-1,131210089091014.000000000000000,Block 1014, Block Group 1, Census Tract 89.09, Fulton County, Georgia,72,11,61,58,45,6,0,3
-1,131210090021010.000000000000000,Block 1010, Block Group 1, Census Tract 90.02, Fulton County, Georgia,72,0,72,72,68,2,2,0
-1,131210095041002.000000000000000,Block 1002, Block Group 1, Census Tract 95.04, Fulton County, Georgia,72,5,67,60,51,7,0,7
-1,131210097001013.000000000000000,Block 1013, Block Group 1, Census Tract 97, Fulton County, Georgia,72,7,65,64,43,6,0,1
-1,131210100051020.000000000000000,Block 1020, Block Group 1, Census Tract 100.05, Fulton County, Georgia,72,4,68,68,65,0,0,0
-1,131210101083001.000000000000000,Block 3001, Block Group 3, Census Tract 101.08, Fulton County, Georgia,72,7,65,59,48,8,2,6
-1,131210102042005.000000000000000,Block 2005, Block Group 2, Census Tract 102.04, Fulton County, Georgia,72,7,65,61,51,2,0,4
-1,131210103083016.000000000000000,Block 3016, Block Group 3, Census Tract 103.08, Fulton County, Georgia,72,3,69,65,0,63,2,4
-1,131210105081002.000000000000000,Block 1002, Block Group 1, Census Tract 105.08, Fulton County, Georgia,72,0,72,72,2,70,0,0
-1,131210105173001.000000000000000,Block 3001, Block Group 3, Census Tract 105.17, Fulton County, Georgia,72,5,67,67,3,64,0,0
-1,131210105182005.000000000000000,Block 2005, Block Group 2, Census Tract 105.18, Fulton County, Georgia,72,2,70,66,0,61,5,4
-1,131210105231027.000000000000000,Block 1027, Block Group 1, Census Tract 105.23, Fulton County, Georgia,72,1,71,70,2,68,0,1
-1,131210105272008.000000000000000,Block 2008, Block Group 2, Census Tract 105.27, Fulton County, Georgia,72,14,58,51,4,44,0,7
-1,131210105273020.000000000000000,Block 3020, Block Group 3, Census Tract 105.27, Fulton County, Georgia,72,10,62,61,7,47,7,1
-1,131210105293025.000000000000000,Block 3025, Block Group 3, Census Tract 105.29, Fulton County, Georgia,72,0,72,72,0,72,0,0
-1,131210105301013.000000000000000,Block 1013, Block Group 1, Census Tract 105.30, Fulton County, Georgia,72,3,69,69,0,69,0,0
-1,131210105321001.000000000000000,Block 1001, Block Group 1, Census Tract 105.32, Fulton County, Georgia,72,0,72,67,0,60,7,5
-1,131210112023001.000000000000000,Block 3001, Block Group 3, Census Tract 112.02, Fulton County, Georgia,72,3,69,69,13,53,3,0
-1,131210112026003.000000000000000,Block 6003, Block Group 6, Census Tract 112.02, Fulton County, Georgia,72,16,56,54,0,52,0,2
-1,131210112031014.000000000000000,Block 1014, Block Group 1, Census Tract 112.03, Fulton County, Georgia,72,16,56,56,10,45,1,0
-1,131210114164003.000000000000000,Block 4003, Block Group 4, Census Tract 114.16, Fulton County, Georgia,72,8,64,59,50,6,3,5
-1,131210114303002.000000000000000,Block 3002, Block Group 3, Census Tract 114.30, Fulton County, Georgia,72,9,63,59,21,32,5,4
-1,131210114371004.000000000000000,Block 1004, Block Group 1, Census Tract 114.37, Fulton County, Georgia,72,15,57,54,49,5,0,3
-1,131210115082013.000000000000000,Block 2013, Block Group 2, Census Tract 115.08, Fulton County, Georgia,72,5,67,66,57,4,4,1
-1,131210116242001.000000000000000,Block 2001, Block Group 2, Census Tract 116.24, Fulton County, Georgia,72,5,67,61,40,10,0,6
-1,131210116342004.000000000000000,Block 2004, Block Group 2, Census Tract 116.34, Fulton County, Georgia,72,12,60,54,41,3,4,6
-1,131210116602008.000000000000000,Block 2008, Block Group 2, Census Tract 116.60, Fulton County, Georgia,72,1,71,68,62,0,0,3
-1,131210119022003.000000000000000,Block 2003, Block Group 2, Census Tract 119.02, Fulton County, Georgia,72,10,62,59,46,11,0,3
-1,131210010011006.000000000000000,Block 1006, Block Group 1, Census Tract 10.01, Fulton County, Georgia,71,13,58,55,34,11,0,3
-1,131210017022012.000000000000000,Block 2012, Block Group 2, Census Tract 17.02, Fulton County, Georgia,71,5,66,66,41,18,0,0
-1,131210024002010.000000000000000,Block 2010, Block Group 2, Census Tract 24, Fulton County, Georgia,71,0,71,68,2,66,0,3
-1,131210040001011.000000000000000,Block 1011, Block Group 1, Census Tract 40, Fulton County, Georgia,71,3,68,67,6,61,0,1
-1,131210041002001.000000000000000,Block 2001, Block Group 2, Census Tract 41, Fulton County, Georgia,71,1,70,68,15,53,0,2
-1,131210053003007.000000000000000,Block 3007, Block Group 3, Census Tract 53, Fulton County, Georgia,71,7,64,63,36,21,0,1
-1,131210060001002.000000000000000,Block 1002, Block Group 1, Census Tract 60, Fulton County, Georgia,71,0,71,68,4,64,0,3
-1,131210061002014.000000000000000,Block 2014, Block Group 2, Census Tract 61, Fulton County, Georgia,71,1,70,67,0,65,0,3
-1,131210063001029.000000000000000,Block 1029, Block Group 1, Census Tract 63, Fulton County, Georgia,71,0,71,65,1,64,0,6
-1,131210065004006.000000000000000,Block 4006, Block Group 4, Census Tract 65, Fulton County, Georgia,71,0,71,70,32,38,0,1
-1,131210070012018.000000000000000,Block 2018, Block Group 2, Census Tract 70.01, Fulton County, Georgia,71,4,67,64,2,61,1,3
-1,131210070023010.000000000000000,Block 3010, Block Group 3, Census Tract 70.02, Fulton County, Georgia,71,1,70,64,3,61,0,6
-1,131210071002011.000000000000000,Block 2011, Block Group 2, Census Tract 71, Fulton County, Georgia,71,6,65,65,1,63,0,0
-1,131210075003012.000000000000000,Block 3012, Block Group 3, Census Tract 75, Fulton County, Georgia,71,3,68,64,4,59,0,4
-1,131210077033019.000000000000000,Block 3019, Block Group 3, Census Tract 77.03, Fulton County, Georgia,71,0,71,67,0,64,0,4
-1,131210078064008.000000000000000,Block 4008, Block Group 4, Census Tract 78.06, Fulton County, Georgia,71,2,69,68,8,60,0,1
-1,131210080001006.000000000000000,Block 1006, Block Group 1, Census Tract 80, Fulton County, Georgia,71,7,64,61,6,53,0,3
-1,131210082042005.000000000000000,Block 2005, Block Group 2, Census Tract 82.04, Fulton County, Georgia,71,2,69,69,1,67,1,0
-1,131210082043006.000000000000000,Block 3006, Block Group 3, Census Tract 82.04, Fulton County, Georgia,71,3,68,65,0,64,1,3
-1,131210083011010.000000000000000,Block 1010, Block Group 1, Census Tract 83.01, Fulton County, Georgia,71,0,71,71,0,71,0,0
-1,131210089081003.000000000000000,Block 1003, Block Group 1, Census Tract 89.08, Fulton County, Georgia,71,13,58,56,41,14,0,2
-1,131210090011005.000000000000000,Block 1005, Block Group 1, Census Tract 90.01, Fulton County, Georgia,71,10,61,56,54,2,0,5
-1,131210091041003.000000000000000,Block 1003, Block Group 1, Census Tract 91.04, Fulton County, Georgia,71,2,69,57,51,0,2,12
-1,131210095013003.000000000000000,Block 3003, Block Group 3, Census Tract 95.01, Fulton County, Georgia,71,0,71,69,67,0,0,2
-1,131210098041000.000000000000000,Block 1000, Block Group 1, Census Tract 98.04, Fulton County, Georgia,71,2,69,66,64,2,0,3
-1,131210098041002.000000000000000,Block 1002, Block Group 1, Census Tract 98.04, Fulton County, Georgia,71,0,71,66,64,0,2,5
-1,131210098042007.000000000000000,Block 2007, Block Group 2, Census Tract 98.04, Fulton County, Georgia,71,6,65,59,57,2,0,6
-1,131210102042017.000000000000000,Block 2017, Block Group 2, Census Tract 102.04, Fulton County, Georgia,71,5,66,62,53,4,0,4
-1,131210102162011.000000000000000,Block 2011, Block Group 2, Census Tract 102.16, Fulton County, Georgia,71,4,67,63,50,8,0,4
-1,131210103052007.000000000000000,Block 2007, Block Group 2, Census Tract 103.05, Fulton County, Georgia,71,3,68,67,0,67,0,1
-1,131210103151013.000000000000000,Block 1013, Block Group 1, Census Tract 103.15, Fulton County, Georgia,71,1,70,68,3,65,0,2
-1,131210105203004.000000000000000,Block 3004, Block Group 3, Census Tract 105.20, Fulton County, Georgia,71,0,71,70,13,57,0,1
-1,131210105281013.000000000000000,Block 1013, Block Group 1, Census Tract 105.28, Fulton County, Georgia,71,14,57,57,6,51,0,0
-1,131210105301010.000000000000000,Block 1010, Block Group 1, Census Tract 105.30, Fulton County, Georgia,71,2,69,69,5,64,0,0
-1,131210105392025.000000000000000,Block 2025, Block Group 2, Census Tract 105.39, Fulton County, Georgia,71,3,68,68,2,57,2,0
-1,131210108022008.000000000000000,Block 2008, Block Group 2, Census Tract 108.02, Fulton County, Georgia,71,28,43,34,16,18,0,9
-1,131210111001025.000000000000000,Block 1025, Block Group 1, Census Tract 111, Fulton County, Georgia,71,14,57,57,23,30,0,0
-1,131210112026017.000000000000000,Block 6017, Block Group 6, Census Tract 112.02, Fulton County, Georgia,71,12,59,59,12,47,0,0
-1,131210112032017.000000000000000,Block 2017, Block Group 2, Census Tract 112.03, Fulton County, Georgia,71,4,67,67,9,58,0,0
-1,131210113061017.000000000000000,Block 1017, Block Group 1, Census Tract 113.06, Fulton County, Georgia,71,1,70,61,0,61,0,9
-1,131210113102007.000000000000000,Block 2007, Block Group 2, Census Tract 113.10, Fulton County, Georgia,71,3,68,68,6,62,0,0
-1,131210114211005.000000000000000,Block 1005, Block Group 1, Census Tract 114.21, Fulton County, Georgia,71,30,41,40,25,15,0,1
-1,131210114294003.000000000000000,Block 4003, Block Group 4, Census Tract 114.29, Fulton County, Georgia,71,3,68,64,62,0,0,4
-1,131210116353003.000000000000000,Block 3003, Block Group 3, Census Tract 116.35, Fulton County, Georgia,71,0,71,69,14,20,0,2
-1,131210116431004.000000000000000,Block 1004, Block Group 1, Census Tract 116.43, Fulton County, Georgia,71,14,57,55,10,27,0,2
-1,131210116432002.000000000000000,Block 2002, Block Group 2, Census Tract 116.43, Fulton County, Georgia,71,3,68,64,12,0,2,4
-1,131210116433005.000000000000000,Block 3005, Block Group 3, Census Tract 116.43, Fulton County, Georgia,71,8,63,56,40,13,0,7
-1,131210116571004.000000000000000,Block 1004, Block Group 1, Census Tract 116.57, Fulton County, Georgia,71,20,51,45,19,9,2,6
-1,131210015012000.000000000000000,Block 2000, Block Group 2, Census Tract 15.01, Fulton County, Georgia,70,4,66,65,63,2,0,1
-1,131210030002007.000000000000000,Block 2007, Block Group 2, Census Tract 30, Fulton County, Georgia,70,4,66,60,45,4,0,6
-1,131210032001001.000000000000000,Block 1001, Block Group 1, Census Tract 32, Fulton County, Georgia,70,5,65,65,49,16,0,0
-1,131210035001016.000000000000000,Block 1016, Block Group 1, Census Tract 35, Fulton County, Georgia,70,7,63,57,5,52,0,6
-1,131210040003002.000000000000000,Block 3002, Block Group 3, Census Tract 40, Fulton County, Georgia,70,7,63,63,7,53,3,0
-1,131210040003007.000000000000000,Block 3007, Block Group 3, Census Tract 40, Fulton County, Georgia,70,0,70,68,10,58,0,2
-1,131210058001043.000000000000000,Block 1043, Block Group 1, Census Tract 58, Fulton County, Georgia,70,3,67,64,21,42,0,3
-1,131210062001009.000000000000000,Block 1009, Block Group 1, Census Tract 62, Fulton County, Georgia,70,4,66,65,10,55,0,1
-1,131210066012011.000000000000000,Block 2011, Block Group 2, Census Tract 66.01, Fulton County, Georgia,70,0,70,68,11,54,0,2
-1,131210072002006.000000000000000,Block 2006, Block Group 2, Census Tract 72, Fulton County, Georgia,70,0,70,67,3,63,0,3
-1,131210077071001.000000000000000,Block 1001, Block Group 1, Census Tract 77.07, Fulton County, Georgia,70,0,70,70,7,58,4,0
-1,131210078061016.000000000000000,Block 1016, Block Group 1, Census Tract 78.06, Fulton County, Georgia,70,9,61,60,5,55,0,1
-1,131210078064005.000000000000000,Block 4005, Block Group 4, Census Tract 78.06, Fulton County, Georgia,70,2,68,67,0,67,0,1
-1,131210079002010.000000000000000,Block 2010, Block Group 2, Census Tract 79, Fulton County, Georgia,70,7,63,62,6,55,0,1
-1,131210082031008.000000000000000,Block 1008, Block Group 1, Census Tract 82.03, Fulton County, Georgia,70,6,64,64,1,63,0,0
-1,131210089062003.000000000000000,Block 2003, Block Group 2, Census Tract 89.06, Fulton County, Georgia,70,1,69,64,61,3,0,5
-1,131210091051001.000000000000000,Block 1001, Block Group 1, Census Tract 91.05, Fulton County, Georgia,70,1,69,62,62,0,0,7
-1,131210093012008.000000000000000,Block 2008, Block Group 2, Census Tract 93.01, Fulton County, Georgia,70,6,64,61,58,2,0,3
-1,131210101211006.000000000000000,Block 1006, Block Group 1, Census Tract 101.21, Fulton County, Georgia,70,4,66,63,55,0,0,3
-1,131210101321001.000000000000000,Block 1001, Block Group 1, Census Tract 101.32, Fulton County, Georgia,70,26,44,42,40,0,2,2
-1,131210101362006.000000000000000,Block 2006, Block Group 2, Census Tract 101.36, Fulton County, Georgia,70,2,68,65,59,0,0,3
-1,131210101362007.000000000000000,Block 2007, Block Group 2, Census Tract 101.36, Fulton County, Georgia,70,4,66,63,59,4,0,3
-1,131210103052010.000000000000000,Block 2010, Block Group 2, Census Tract 103.05, Fulton County, Georgia,70,0,70,67,7,60,0,3
-1,131210103061013.000000000000000,Block 1013, Block Group 1, Census Tract 103.06, Fulton County, Georgia,70,0,70,70,0,69,1,0
-1,131210105182001.000000000000000,Block 2001, Block Group 2, Census Tract 105.18, Fulton County, Georgia,70,15,55,55,4,51,0,0
-1,131210105221007.000000000000000,Block 1007, Block Group 1, Census Tract 105.22, Fulton County, Georgia,70,5,65,58,2,55,1,7
-1,131210105382002.000000000000000,Block 2002, Block Group 2, Census Tract 105.38, Fulton County, Georgia,70,4,66,63,21,42,0,3
-1,131210105382015.000000000000000,Block 2015, Block Group 2, Census Tract 105.38, Fulton County, Georgia,70,1,69,68,0,67,0,1
-1,131210106011005.000000000000000,Block 1005, Block Group 1, Census Tract 106.01, Fulton County, Georgia,70,5,65,62,45,15,2,3
-1,131210113081012.000000000000000,Block 1012, Block Group 1, Census Tract 113.08, Fulton County, Georgia,70,0,70,65,0,65,0,5
-1,131210114191014.000000000000000,Block 1014, Block Group 1, Census Tract 114.19, Fulton County, Georgia,70,16,54,45,43,2,0,9
-1,131210114432004.000000000000000,Block 2004, Block Group 2, Census Tract 114.43, Fulton County, Georgia,70,11,59,51,21,1,0,8
-1,131210116182001.000000000000000,Block 2001, Block Group 2, Census Tract 116.18, Fulton County, Georgia,70,2,68,65,0,6,0,3
-1,131210116391015.000000000000000,Block 1015, Block Group 1, Census Tract 116.39, Fulton County, Georgia,70,2,68,65,45,6,1,3
-1,131210016001003.000000000000000,Block 1003, Block Group 1, Census Tract 16, Fulton County, Georgia,69,12,57,50,43,7,0,7
-1,131210024001004.000000000000000,Block 1004, Block Group 1, Census Tract 24, Fulton County, Georgia,69,2,67,67,6,59,1,0
-1,131210030001016.000000000000000,Block 1016, Block Group 1, Census Tract 30, Fulton County, Georgia,69,2,67,67,63,0,0,0
-1,131210036002006.000000000000000,Block 2006, Block Group 2, Census Tract 36, Fulton County, Georgia,69,3,66,65,9,55,1,1
-1,131210052004007.000000000000000,Block 4007, Block Group 4, Census Tract 52, Fulton County, Georgia,69,5,64,61,33,26,0,3
-1,131210053002010.000000000000000,Block 2010, Block Group 2, Census Tract 53, Fulton County, Georgia,69,0,69,67,57,10,0,2
-1,131210055011019.000000000000000,Block 1019, Block Group 1, Census Tract 55.01, Fulton County, Georgia,69,4,65,63,40,20,1,2
-1,131210055011021.000000000000000,Block 1021, Block Group 1, Census Tract 55.01, Fulton County, Georgia,69,0,69,64,12,52,0,5
-1,131210058001034.000000000000000,Block 1034, Block Group 1, Census Tract 58, Fulton County, Georgia,69,1,68,67,4,55,5,1
-1,131210060002003.000000000000000,Block 2003, Block Group 2, Census Tract 60, Fulton County, Georgia,69,6,63,60,21,39,0,3
-1,131210062001000.000000000000000,Block 1000, Block Group 1, Census Tract 62, Fulton County, Georgia,69,3,66,66,26,40,0,0
-1,131210064001013.000000000000000,Block 1013, Block Group 1, Census Tract 64, Fulton County, Georgia,69,18,51,49,22,25,0,2
-1,131210065004011.000000000000000,Block 4011, Block Group 4, Census Tract 65, Fulton County, Georgia,69,2,67,61,28,33,0,6
-1,131210072003009.000000000000000,Block 3009, Block Group 3, Census Tract 72, Fulton County, Georgia,69,1,68,68,0,68,0,0
-1,131210073011015.000000000000000,Block 1015, Block Group 1, Census Tract 73.01, Fulton County, Georgia,69,0,69,69,4,65,0,0
-1,131210076031003.000000000000000,Block 1003, Block Group 1, Census Tract 76.03, Fulton County, Georgia,69,4,65,62,0,62,0,3
-1,131210077102002.000000000000000,Block 2002, Block Group 2, Census Tract 77.10, Fulton County, Georgia,69,7,62,53,0,53,0,9
-1,131210078062006.000000000000000,Block 2006, Block Group 2, Census Tract 78.06, Fulton County, Georgia,69,5,64,60,0,60,0,4
-1,131210078081000.000000000000000,Block 1000, Block Group 1, Census Tract 78.08, Fulton County, Georgia,69,5,64,62,3,59,0,2
-1,131210078094006.000000000000000,Block 4006, Block Group 4, Census Tract 78.09, Fulton County, Georgia,69,4,65,63,2,60,1,2
-1,131210082021000.000000000000000,Block 1000, Block Group 1, Census Tract 82.02, Fulton County, Georgia,69,0,69,68,0,68,0,1
-1,131210084003006.000000000000000,Block 3006, Block Group 3, Census Tract 84, Fulton County, Georgia,69,4,65,65,0,65,0,0
-1,131210085003010.000000000000000,Block 3010, Block Group 3, Census Tract 85, Fulton County, Georgia,69,0,69,65,8,57,0,4
-1,131210095014002.000000000000000,Block 4002, Block Group 4, Census Tract 95.01, Fulton County, Georgia,69,7,62,56,54,0,2,6
-1,131210097003010.000000000000000,Block 3010, Block Group 3, Census Tract 97, Fulton County, Georgia,69,0,69,67,65,2,0,2
-1,131210101083003.000000000000000,Block 3003, Block Group 3, Census Tract 101.08, Fulton County, Georgia,69,19,50,45,27,13,0,5
-1,131210101252000.000000000000000,Block 2000, Block Group 2, Census Tract 101.25, Fulton County, Georgia,69,11,58,47,27,15,0,11
-1,131210101332015.000000000000000,Block 2015, Block Group 2, Census Tract 101.33, Fulton County, Georgia,69,12,57,46,24,14,3,11
-1,131210101362000.000000000000000,Block 2000, Block Group 2, Census Tract 101.36, Fulton County, Georgia,69,5,64,58,47,6,0,6
-1,131210102181002.000000000000000,Block 1002, Block Group 1, Census Tract 102.18, Fulton County, Georgia,69,12,57,50,32,14,0,7
-1,131210103051012.000000000000000,Block 1012, Block Group 1, Census Tract 103.05, Fulton County, Georgia,69,0,69,64,0,63,1,5
-1,131210103061007.000000000000000,Block 1007, Block Group 1, Census Tract 103.06, Fulton County, Georgia,69,4,65,61,0,60,0,4
-1,131210103092017.000000000000000,Block 2017, Block Group 2, Census Tract 103.09, Fulton County, Georgia,69,2,67,64,0,64,0,3
-1,131210103103004.000000000000000,Block 3004, Block Group 3, Census Tract 103.10, Fulton County, Georgia,69,1,68,68,0,68,0,0
-1,131210104021022.000000000000000,Block 1022, Block Group 1, Census Tract 104.02, Fulton County, Georgia,69,2,67,67,60,4,3,0
-1,131210105081006.000000000000000,Block 1006, Block Group 1, Census Tract 105.08, Fulton County, Georgia,69,1,68,67,0,66,0,1
-1,131210105312008.000000000000000,Block 2008, Block Group 2, Census Tract 105.31, Fulton County, Georgia,69,4,65,60,3,56,1,5
-1,131210105371001.000000000000000,Block 1001, Block Group 1, Census Tract 105.37, Fulton County, Georgia,69,2,67,64,0,58,1,3
-1,131210108013000.000000000000000,Block 3000, Block Group 3, Census Tract 108.01, Fulton County, Georgia,69,10,59,58,6,50,0,1
-1,131210110003028.000000000000000,Block 3028, Block Group 3, Census Tract 110, Fulton County, Georgia,69,13,56,54,5,49,0,2
-1,131210113102009.000000000000000,Block 2009, Block Group 2, Census Tract 113.10, Fulton County, Georgia,69,23,46,46,6,40,0,0
-1,131210113104005.000000000000000,Block 4005, Block Group 4, Census Tract 113.10, Fulton County, Georgia,69,20,49,48,5,43,0,1
-1,131210114194023.000000000000000,Block 4023, Block Group 4, Census Tract 114.19, Fulton County, Georgia,69,4,65,64,49,11,0,1
-1,131210114383003.000000000000000,Block 3003, Block Group 3, Census Tract 114.38, Fulton County, Georgia,69,4,65,57,42,5,0,8
-1,131210114412003.000000000000000,Block 2003, Block Group 2, Census Tract 114.41, Fulton County, Georgia,69,1,68,54,53,1,0,14
-1,131210114422011.000000000000000,Block 2011, Block Group 2, Census Tract 114.42, Fulton County, Georgia,69,5,64,63,36,13,0,1
-1,131210115071001.000000000000000,Block 1001, Block Group 1, Census Tract 115.07, Fulton County, Georgia,69,5,64,64,62,0,0,0
-1,131210115151005.000000000000000,Block 1005, Block Group 1, Census Tract 115.15, Fulton County, Georgia,69,14,55,55,49,3,0,0
-1,131210116353018.000000000000000,Block 3018, Block Group 3, Census Tract 116.35, Fulton County, Georgia,69,2,67,66,20,0,0,1
-1,131210116441009.000000000000000,Block 1009, Block Group 1, Census Tract 116.44, Fulton County, Georgia,69,4,65,59,10,14,0,6
-1,131210116512015.000000000000000,Block 2015, Block Group 2, Census Tract 116.51, Fulton County, Georgia,69,8,61,47,11,12,0,14
-1,131210116582008.000000000000000,Block 2008, Block Group 2, Census Tract 116.58, Fulton County, Georgia,69,24,45,45,22,4,4,0
-1,131210116601007.000000000000000,Block 1007, Block Group 1, Census Tract 116.60, Fulton County, Georgia,69,3,66,64,42,4,0,2
-1,131210119021002.000000000000000,Block 1002, Block Group 1, Census Tract 119.02, Fulton County, Georgia,69,1,68,64,13,48,2,4
-1,131210005021003.000000000000000,Block 1003, Block Group 1, Census Tract 5.02, Fulton County, Georgia,68,6,62,61,57,4,0,1
-1,131210005021007.000000000000000,Block 1007, Block Group 1, Census Tract 5.02, Fulton County, Georgia,68,3,65,65,49,7,0,0
-1,131210019022007.000000000000000,Block 2007, Block Group 2, Census Tract 19.02, Fulton County, Georgia,68,3,65,60,25,30,1,5
-1,131210023002003.000000000000000,Block 2003, Block Group 2, Census Tract 23, Fulton County, Georgia,68,4,64,64,0,64,0,0
-1,131210029002006.000000000000000,Block 2006, Block Group 2, Census Tract 29, Fulton County, Georgia,68,4,64,56,44,10,0,8
-1,131210040001016.000000000000000,Block 1016, Block Group 1, Census Tract 40, Fulton County, Georgia,68,1,67,64,3,61,0,3
-1,131210052001015.000000000000000,Block 1015, Block Group 1, Census Tract 52, Fulton County, Georgia,68,5,63,60,57,2,0,3
-1,131210060003002.000000000000000,Block 3002, Block Group 3, Census Tract 60, Fulton County, Georgia,68,0,68,67,19,44,1,1
-1,131210062002001.000000000000000,Block 2001, Block Group 2, Census Tract 62, Fulton County, Georgia,68,5,63,63,0,63,0,0
-1,131210063001020.000000000000000,Block 1020, Block Group 1, Census Tract 63, Fulton County, Georgia,68,0,68,67,4,63,0,1
-1,131210065001007.000000000000000,Block 1007, Block Group 1, Census Tract 65, Fulton County, Georgia,68,4,64,61,11,49,0,3
-1,131210066011005.000000000000000,Block 1005, Block Group 1, Census Tract 66.01, Fulton County, Georgia,68,3,65,64,15,43,6,1
-1,131210070012015.000000000000000,Block 2015, Block Group 2, Census Tract 70.01, Fulton County, Georgia,68,8,60,59,4,54,1,1
-1,131210077032004.000000000000000,Block 2004, Block Group 2, Census Tract 77.03, Fulton County, Georgia,68,1,67,65,0,64,1,2
-1,131210077071002.000000000000000,Block 1002, Block Group 1, Census Tract 77.07, Fulton County, Georgia,68,0,68,63,0,63,0,5
-1,131210078103007.000000000000000,Block 3007, Block Group 3, Census Tract 78.10, Fulton County, Georgia,68,3,65,63,0,63,0,2
-1,131210079002005.000000000000000,Block 2005, Block Group 2, Census Tract 79, Fulton County, Georgia,68,2,66,63,0,63,0,3
-1,131210081033007.000000000000000,Block 3007, Block Group 3, Census Tract 81.03, Fulton County, Georgia,68,3,65,63,0,60,3,2
-1,131210082043001.000000000000000,Block 3001, Block Group 3, Census Tract 82.04, Fulton County, Georgia,68,1,67,65,0,65,0,2
-1,131210082043010.000000000000000,Block 3010, Block Group 3, Census Tract 82.04, Fulton County, Georgia,68,1,67,67,5,62,0,0
-1,131210085001002.000000000000000,Block 1002, Block Group 1, Census Tract 85, Fulton County, Georgia,68,0,68,67,6,61,0,1
-1,131210085002000.000000000000000,Block 2000, Block Group 2, Census Tract 85, Fulton County, Georgia,68,2,66,66,6,60,0,0
-1,131210089052001.000000000000000,Block 2001, Block Group 2, Census Tract 89.05, Fulton County, Georgia,68,11,57,45,28,17,0,12
-1,131210092022022.000000000000000,Block 2022, Block Group 2, Census Tract 92.02, Fulton County, Georgia,68,7,61,56,47,4,2,5
-1,131210092032002.000000000000000,Block 2002, Block Group 2, Census Tract 92.03, Fulton County, Georgia,68,5,63,63,56,0,0,0
-1,131210096043004.000000000000000,Block 3004, Block Group 3, Census Tract 96.04, Fulton County, Georgia,68,5,63,55,55,0,0,8
-1,131210096061020.000000000000000,Block 1020, Block Group 1, Census Tract 96.06, Fulton County, Georgia,68,4,64,62,56,6,0,2
-1,131210097002011.000000000000000,Block 2011, Block Group 2, Census Tract 97, Fulton County, Georgia,68,7,61,60,59,1,0,1
-1,131210101061003.000000000000000,Block 1003, Block Group 1, Census Tract 101.06, Fulton County, Georgia,68,24,44,39,25,8,4,5
-1,131210102221003.000000000000000,Block 1003, Block Group 1, Census Tract 102.22, Fulton County, Georgia,68,0,68,64,55,5,0,4
-1,131210103073003.000000000000000,Block 3003, Block Group 3, Census Tract 103.07, Fulton County, Georgia,68,3,65,61,0,61,0,4
-1,131210103091036.000000000000000,Block 1036, Block Group 1, Census Tract 103.09, Fulton County, Georgia,68,2,66,64,8,56,0,2
-1,131210103111002.000000000000000,Block 1002, Block Group 1, Census Tract 103.11, Fulton County, Georgia,68,10,58,54,1,50,3,4
-1,131210103121001.000000000000000,Block 1001, Block Group 1, Census Tract 103.12, Fulton County, Georgia,68,4,64,61,2,58,0,3
-1,131210105261031.000000000000000,Block 1031, Block Group 1, Census Tract 105.26, Fulton County, Georgia,68,2,66,65,0,65,0,1
-1,131210108022003.000000000000000,Block 2003, Block Group 2, Census Tract 108.02, Fulton County, Georgia,68,24,44,44,12,31,0,0
-1,131210108024001.000000000000000,Block 4001, Block Group 4, Census Tract 108.02, Fulton County, Georgia,68,54,14,14,6,8,0,0
-1,131210111001031.000000000000000,Block 1031, Block Group 1, Census Tract 111, Fulton County, Georgia,68,5,63,55,31,23,0,8
-1,131210111003013.000000000000000,Block 3013, Block Group 3, Census Tract 111, Fulton County, Georgia,68,9,59,59,28,31,0,0
-1,131210112021002.000000000000000,Block 1002, Block Group 1, Census Tract 112.02, Fulton County, Georgia,68,5,63,60,14,37,6,3
-1,131210112031002.000000000000000,Block 1002, Block Group 1, Census Tract 112.03, Fulton County, Georgia,68,9,59,55,4,51,0,4
-1,131210114212000.000000000000000,Block 2000, Block Group 2, Census Tract 114.21, Fulton County, Georgia,68,34,34,24,11,8,2,10
-1,131210114231006.000000000000000,Block 1006, Block Group 1, Census Tract 114.23, Fulton County, Georgia,68,11,57,55,41,10,3,2
-1,131210116241002.000000000000000,Block 1002, Block Group 1, Census Tract 116.24, Fulton County, Georgia,68,12,56,49,20,0,0,7
-1,131210116321007.000000000000000,Block 1007, Block Group 1, Census Tract 116.32, Fulton County, Georgia,68,6,62,61,10,12,0,1
-1,131210002012007.000000000000000,Block 2007, Block Group 2, Census Tract 2.01, Fulton County, Georgia,67,2,65,63,60,3,0,2
-1,131210005022022.000000000000000,Block 2022, Block Group 2, Census Tract 5.02, Fulton County, Georgia,67,1,66,64,63,1,0,2
-1,131210012041001.000000000000000,Block 1001, Block Group 1, Census Tract 12.04, Fulton County, Georgia,67,7,60,58,57,1,0,2
-1,131210015021009.000000000000000,Block 1009, Block Group 1, Census Tract 15.02, Fulton County, Georgia,67,4,63,57,44,0,0,6
-1,131210016001006.000000000000000,Block 1006, Block Group 1, Census Tract 16, Fulton County, Georgia,67,4,63,63,59,4,0,0
-1,131210025003003.000000000000000,Block 3003, Block Group 3, Census Tract 25, Fulton County, Georgia,67,0,67,65,1,64,0,2
-1,131210031001001.000000000000000,Block 1001, Block Group 1, Census Tract 31, Fulton County, Georgia,67,1,66,62,49,12,1,4
-1,131210053002026.000000000000000,Block 2026, Block Group 2, Census Tract 53, Fulton County, Georgia,67,2,65,63,52,6,3,2
-1,131210057002004.000000000000000,Block 2004, Block Group 2, Census Tract 57, Fulton County, Georgia,67,0,67,64,3,61,0,3
-1,131210060002001.000000000000000,Block 2001, Block Group 2, Census Tract 60, Fulton County, Georgia,67,0,67,65,11,54,0,2
-1,131210060002006.000000000000000,Block 2006, Block Group 2, Census Tract 60, Fulton County, Georgia,67,4,63,60,10,50,0,3
-1,131210061003003.000000000000000,Block 3003, Block Group 3, Census Tract 61, Fulton County, Georgia,67,3,64,64,12,50,0,0
-1,131210065002002.000000000000000,Block 2002, Block Group 2, Census Tract 65, Fulton County, Georgia,67,2,65,63,25,35,3,2
-1,131210071002016.000000000000000,Block 2016, Block Group 2, Census Tract 71, Fulton County, Georgia,67,2,65,65,8,55,2,0
-1,131210073021001.000000000000000,Block 1001, Block Group 1, Census Tract 73.02, Fulton County, Georgia,67,0,67,66,1,65,0,1
-1,131210077032005.000000000000000,Block 2005, Block Group 2, Census Tract 77.03, Fulton County, Georgia,67,5,62,61,0,61,0,1
-1,131210079001006.000000000000000,Block 1006, Block Group 1, Census Tract 79, Fulton County, Georgia,67,0,67,66,6,60,0,1
-1,131210079002002.000000000000000,Block 2002, Block Group 2, Census Tract 79, Fulton County, Georgia,67,1,66,63,2,59,2,3
-1,131210079003014.000000000000000,Block 3014, Block Group 3, Census Tract 79, Fulton County, Georgia,67,4,63,61,0,60,1,2
-1,131210082042006.000000000000000,Block 2006, Block Group 2, Census Tract 82.04, Fulton County, Georgia,67,0,67,65,0,62,1,2
-1,131210087022006.000000000000000,Block 2006, Block Group 2, Census Tract 87.02, Fulton County, Georgia,67,0,67,67,13,54,0,0
-1,131210088021027.000000000000000,Block 1027, Block Group 1, Census Tract 88.02, Fulton County, Georgia,67,4,63,61,43,16,1,2
-1,131210089053004.000000000000000,Block 3004, Block Group 3, Census Tract 89.05, Fulton County, Georgia,67,1,66,65,57,8,0,1
-1,131210092031009.000000000000000,Block 1009, Block Group 1, Census Tract 92.03, Fulton County, Georgia,67,0,67,59,48,4,0,8
-1,131210092031015.000000000000000,Block 1015, Block Group 1, Census Tract 92.03, Fulton County, Georgia,67,12,55,46,32,8,0,9
-1,131210095042000.000000000000000,Block 2000, Block Group 2, Census Tract 95.04, Fulton County, Georgia,67,7,60,59,51,0,0,1
-1,131210100052001.000000000000000,Block 2001, Block Group 2, Census Tract 100.05, Fulton County, Georgia,67,3,64,62,56,2,0,2
-1,131210101152019.000000000000000,Block 2019, Block Group 2, Census Tract 101.15, Fulton County, Georgia,67,6,61,58,58,0,0,3
-1,131210101252008.000000000000000,Block 2008, Block Group 2, Census Tract 101.25, Fulton County, Georgia,67,12,55,46,34,11,1,9
-1,131210102114003.000000000000000,Block 4003, Block Group 4, Census Tract 102.11, Fulton County, Georgia,67,2,65,60,55,1,1,5
-1,131210103081011.000000000000000,Block 1011, Block Group 1, Census Tract 103.08, Fulton County, Georgia,67,0,67,66,0,66,0,1
-1,131210103093008.000000000000000,Block 3008, Block Group 3, Census Tract 103.09, Fulton County, Georgia,67,8,59,57,0,57,0,2
-1,131210103121002.000000000000000,Block 1002, Block Group 1, Census Tract 103.12, Fulton County, Georgia,67,3,64,64,0,60,1,0
-1,131210103122021.000000000000000,Block 2021, Block Group 2, Census Tract 103.12, Fulton County, Georgia,67,5,62,61,2,58,1,1
-1,131210104011019.000000000000000,Block 1019, Block Group 1, Census Tract 104.01, Fulton County, Georgia,67,12,55,52,44,5,1,3
-1,131210105081012.000000000000000,Block 1012, Block Group 1, Census Tract 105.08, Fulton County, Georgia,67,2,65,65,0,65,0,0
-1,131210105173004.000000000000000,Block 3004, Block Group 3, Census Tract 105.17, Fulton County, Georgia,67,9,58,58,8,50,0,0
-1,131210105292008.000000000000000,Block 2008, Block Group 2, Census Tract 105.29, Fulton County, Georgia,67,2,65,60,1,58,0,5
-1,131210105302017.000000000000000,Block 2017, Block Group 2, Census Tract 105.30, Fulton County, Georgia,67,1,66,65,1,64,0,1
-1,131210105391006.000000000000000,Block 1006, Block Group 1, Census Tract 105.39, Fulton County, Georgia,67,1,66,64,0,64,0,2
-1,131210108012023.000000000000000,Block 2023, Block Group 2, Census Tract 108.01, Fulton County, Georgia,67,5,62,57,31,26,0,5
-1,131210108023002.000000000000000,Block 3002, Block Group 3, Census Tract 108.02, Fulton County, Georgia,67,38,29,26,19,7,0,3
-1,131210114322005.000000000000000,Block 2005, Block Group 2, Census Tract 114.32, Fulton County, Georgia,67,17,50,43,27,15,0,7
-1,131210114352008.000000000000000,Block 2008, Block Group 2, Census Tract 114.35, Fulton County, Georgia,67,12,55,51,40,8,0,4
-1,131210115101007.000000000000000,Block 1007, Block Group 1, Census Tract 115.10, Fulton County, Georgia,67,4,63,61,57,0,0,2
-1,131210115111004.000000000000000,Block 1004, Block Group 1, Census Tract 115.11, Fulton County, Georgia,67,7,60,53,47,3,0,7
-1,131210116181002.000000000000000,Block 1002, Block Group 1, Census Tract 116.18, Fulton County, Georgia,67,1,66,58,11,5,0,8
-1,131210116462005.000000000000000,Block 2005, Block Group 2, Census Tract 116.46, Fulton County, Georgia,67,32,35,29,26,3,0,6
-1,131210116503007.000000000000000,Block 3007, Block Group 3, Census Tract 116.50, Fulton County, Georgia,67,13,54,51,40,10,0,3
-1,131210123004018.000000000000000,Block 4018, Block Group 4, Census Tract 123, Fulton County, Georgia,67,6,61,61,10,50,0,0
-1,131210001001004.000000000000000,Block 1004, Block Group 1, Census Tract 1, Fulton County, Georgia,66,2,64,63,59,1,0,1
-1,131210002021004.000000000000000,Block 1004, Block Group 1, Census Tract 2.02, Fulton County, Georgia,66,2,64,55,55,0,0,9
-1,131210012032000.000000000000000,Block 2000, Block Group 2, Census Tract 12.03, Fulton County, Georgia,66,7,59,53,39,8,0,6
-1,131210013012007.000000000000000,Block 2007, Block Group 2, Census Tract 13.01, Fulton County, Georgia,66,1,65,60,48,8,0,5
-1,131210015021001.000000000000000,Block 1001, Block Group 1, Census Tract 15.02, Fulton County, Georgia,66,9,57,52,50,2,0,5
-1,131210015021008.000000000000000,Block 1008, Block Group 1, Census Tract 15.02, Fulton County, Georgia,66,60,6,5,5,0,0,1
-1,131210017011002.000000000000000,Block 1002, Block Group 1, Census Tract 17.01, Fulton County, Georgia,66,4,62,46,12,32,0,16
-1,131210024002014.000000000000000,Block 2014, Block Group 2, Census Tract 24, Fulton County, Georgia,66,0,66,60,5,55,0,6
-1,131210029002005.000000000000000,Block 2005, Block Group 2, Census Tract 29, Fulton County, Georgia,66,9,57,52,47,5,0,5
-1,131210032002001.000000000000000,Block 2001, Block Group 2, Census Tract 32, Fulton County, Georgia,66,2,64,56,56,0,0,8
-1,131210041002005.000000000000000,Block 2005, Block Group 2, Census Tract 41, Fulton County, Georgia,66,3,63,62,6,54,0,1
-1,131210049001002.000000000000000,Block 1002, Block Group 1, Census Tract 49, Fulton County, Georgia,66,3,63,63,11,48,0,0
-1,131210049001012.000000000000000,Block 1012, Block Group 1, Census Tract 49, Fulton County, Georgia,66,2,64,63,15,48,0,1
-1,131210052001012.000000000000000,Block 1012, Block Group 1, Census Tract 52, Fulton County, Georgia,66,6,60,56,49,6,0,4
-1,131210053002031.000000000000000,Block 2031, Block Group 2, Census Tract 53, Fulton County, Georgia,66,4,62,59,47,12,0,3
-1,131210058001031.000000000000000,Block 1031, Block Group 1, Census Tract 58, Fulton County, Georgia,66,1,65,60,36,20,0,5
-1,131210060002010.000000000000000,Block 2010, Block Group 2, Census Tract 60, Fulton County, Georgia,66,3,63,61,19,42,0,2
-1,131210060003010.000000000000000,Block 3010, Block Group 3, Census Tract 60, Fulton County, Georgia,66,2,64,63,3,56,4,1
-1,131210067021000.000000000000000,Block 1000, Block Group 1, Census Tract 67.02, Fulton County, Georgia,66,0,66,62,17,45,0,4
-1,131210069001013.000000000000000,Block 1013, Block Group 1, Census Tract 69, Fulton County, Georgia,66,16,50,47,32,13,0,3
-1,131210070012002.000000000000000,Block 2002, Block Group 2, Census Tract 70.01, Fulton County, Georgia,66,8,58,58,6,52,0,0
-1,131210073011007.000000000000000,Block 1007, Block Group 1, Census Tract 73.01, Fulton County, Georgia,66,1,65,65,0,65,0,0
-1,131210074003003.000000000000000,Block 3003, Block Group 3, Census Tract 74, Fulton County, Georgia,66,4,62,54,6,47,0,8
-1,131210075001009.000000000000000,Block 1009, Block Group 1, Census Tract 75, Fulton County, Georgia,66,1,65,65,14,46,5,0
-1,131210077082000.000000000000000,Block 2000, Block Group 2, Census Tract 77.08, Fulton County, Georgia,66,1,65,57,10,44,3,8
-1,131210079001007.000000000000000,Block 1007, Block Group 1, Census Tract 79, Fulton County, Georgia,66,0,66,60,0,60,0,6
-1,131210083021009.000000000000000,Block 1009, Block Group 1, Census Tract 83.02, Fulton County, Georgia,66,2,64,60,0,58,2,4
-1,131210086022013.000000000000000,Block 2013, Block Group 2, Census Tract 86.02, Fulton County, Georgia,66,2,64,62,0,59,1,2
-1,131210088011031.000000000000000,Block 1031, Block Group 1, Census Tract 88.01, Fulton County, Georgia,66,6,60,56,38,16,0,4
-1,131210095011015.000000000000000,Block 1015, Block Group 1, Census Tract 95.01, Fulton County, Georgia,66,0,66,65,62,0,0,1
-1,131210095041010.000000000000000,Block 1010, Block Group 1, Census Tract 95.04, Fulton County, Georgia,66,7,59,56,46,10,0,3
-1,131210096043010.000000000000000,Block 3010, Block Group 3, Census Tract 96.04, Fulton County, Georgia,66,8,58,51,51,0,0,7
-1,131210098041017.000000000000000,Block 1017, Block Group 1, Census Tract 98.04, Fulton County, Georgia,66,7,59,59,55,3,0,0
-1,131210101172006.000000000000000,Block 2006, Block Group 2, Census Tract 101.17, Fulton County, Georgia,66,6,60,53,20,25,1,7
-1,131210101201003.000000000000000,Block 1003, Block Group 1, Census Tract 101.20, Fulton County, Georgia,66,8,58,53,38,14,0,5
-1,131210101304001.000000000000000,Block 4001, Block Group 4, Census Tract 101.30, Fulton County, Georgia,66,2,64,55,51,1,0,9
-1,131210101341006.000000000000000,Block 1006, Block Group 1, Census Tract 101.34, Fulton County, Georgia,66,25,41,36,17,15,3,5
-1,131210103051013.000000000000000,Block 1013, Block Group 1, Census Tract 103.05, Fulton County, Georgia,66,1,65,63,0,63,0,2
-1,131210103103011.000000000000000,Block 3011, Block Group 3, Census Tract 103.10, Fulton County, Georgia,66,0,66,66,0,66,0,0
-1,131210103123004.000000000000000,Block 3004, Block Group 3, Census Tract 103.12, Fulton County, Georgia,66,0,66,64,2,60,1,2
-1,131210105083005.000000000000000,Block 3005, Block Group 3, Census Tract 105.08, Fulton County, Georgia,66,5,61,60,0,60,0,1
-1,131210105083008.000000000000000,Block 3008, Block Group 3, Census Tract 105.08, Fulton County, Georgia,66,6,60,57,2,55,0,3
-1,131210105272004.000000000000000,Block 2004, Block Group 2, Census Tract 105.27, Fulton County, Georgia,66,5,61,61,0,60,0,0
-1,131210105272005.000000000000000,Block 2005, Block Group 2, Census Tract 105.27, Fulton County, Georgia,66,9,57,40,0,37,0,17
-1,131210105362012.000000000000000,Block 2012, Block Group 2, Census Tract 105.36, Fulton County, Georgia,66,9,57,55,5,50,0,2
-1,131210105392029.000000000000000,Block 2029, Block Group 2, Census Tract 105.39, Fulton County, Georgia,66,3,63,62,1,60,0,1
-1,131210105401024.000000000000000,Block 1024, Block Group 1, Census Tract 105.40, Fulton County, Georgia,66,7,59,57,0,56,1,2
-1,131210112021008.000000000000000,Block 1008, Block Group 1, Census Tract 112.02, Fulton County, Georgia,66,2,64,64,31,31,0,0
-1,131210114282012.000000000000000,Block 2012, Block Group 2, Census Tract 114.28, Fulton County, Georgia,66,5,61,54,49,0,0,7
-1,131210114452005.000000000000000,Block 2005, Block Group 2, Census Tract 114.45, Fulton County, Georgia,66,5,61,58,53,5,0,3
-1,131210116402031.000000000000000,Block 2031, Block Group 2, Census Tract 116.40, Fulton County, Georgia,66,3,63,62,58,4,0,1
-1,131210118021019.000000000000000,Block 1019, Block Group 1, Census Tract 118.02, Fulton County, Georgia,66,0,66,66,1,62,0,0
-1,131210012041012.000000000000000,Block 1012, Block Group 1, Census Tract 12.04, Fulton County, Georgia,65,3,62,57,54,0,0,5
-1,131210013011005.000000000000000,Block 1005, Block Group 1, Census Tract 13.01, Fulton County, Georgia,65,4,61,51,46,1,0,10
-1,131210021003000.000000000000000,Block 3000, Block Group 3, Census Tract 21, Fulton County, Georgia,65,2,63,59,20,26,0,4
-1,131210029001017.000000000000000,Block 1017, Block Group 1, Census Tract 29, Fulton County, Georgia,65,9,56,54,38,13,0,2
-1,131210029002008.000000000000000,Block 2008, Block Group 2, Census Tract 29, Fulton County, Georgia,65,3,62,57,43,9,1,5
-1,131210031001021.000000000000000,Block 1021, Block Group 1, Census Tract 31, Fulton County, Georgia,65,8,57,53,28,24,0,4
-1,131210032002008.000000000000000,Block 2008, Block Group 2, Census Tract 32, Fulton County, Georgia,65,8,57,54,53,1,0,3
-1,131210052002003.000000000000000,Block 2003, Block Group 2, Census Tract 52, Fulton County, Georgia,65,4,61,58,57,1,0,3
-1,131210053002015.000000000000000,Block 2015, Block Group 2, Census Tract 53, Fulton County, Georgia,65,0,65,60,57,3,0,5
-1,131210061003002.000000000000000,Block 3002, Block Group 3, Census Tract 61, Fulton County, Georgia,65,0,65,65,11,54,0,0
-1,131210061003020.000000000000000,Block 3020, Block Group 3, Census Tract 61, Fulton County, Georgia,65,1,64,60,3,50,5,4
-1,131210065002014.000000000000000,Block 2014, Block Group 2, Census Tract 65, Fulton County, Georgia,65,0,65,64,3,59,0,1
-1,131210065002015.000000000000000,Block 2015, Block Group 2, Census Tract 65, Fulton County, Georgia,65,3,62,61,5,55,0,1
-1,131210070014013.000000000000000,Block 4013, Block Group 4, Census Tract 70.01, Fulton County, Georgia,65,14,51,51,0,51,0,0
-1,131210071002006.000000000000000,Block 2006, Block Group 2, Census Tract 71, Fulton County, Georgia,65,8,57,57,3,52,0,0
-1,131210074001013.000000000000000,Block 1013, Block Group 1, Census Tract 74, Fulton County, Georgia,65,14,51,44,0,43,0,7
-1,131210075003008.000000000000000,Block 3008, Block Group 3, Census Tract 75, Fulton County, Georgia,65,18,47,46,6,39,0,1
-1,131210081043015.000000000000000,Block 3015, Block Group 3, Census Tract 81.04, Fulton County, Georgia,65,2,63,62,5,57,0,1
-1,131210083021013.000000000000000,Block 1013, Block Group 1, Census Tract 83.02, Fulton County, Georgia,65,1,64,63,1,62,0,1
-1,131210089032002.000000000000000,Block 2002, Block Group 2, Census Tract 89.03, Fulton County, Georgia,65,10,55,43,17,13,5,12
-1,131210091041004.000000000000000,Block 1004, Block Group 1, Census Tract 91.04, Fulton County, Georgia,65,11,54,54,48,6,0,0
-1,131210093011014.000000000000000,Block 1014, Block Group 1, Census Tract 93.01, Fulton County, Georgia,65,5,60,58,58,0,0,2
-1,131210095011006.000000000000000,Block 1006, Block Group 1, Census Tract 95.01, Fulton County, Georgia,65,0,65,64,64,0,0,1
-1,131210095012014.000000000000000,Block 2014, Block Group 2, Census Tract 95.01, Fulton County, Georgia,65,5,60,58,58,0,0,2
-1,131210096043009.000000000000000,Block 3009, Block Group 3, Census Tract 96.04, Fulton County, Georgia,65,5,60,47,46,1,0,13
-1,131210096061022.000000000000000,Block 1022, Block Group 1, Census Tract 96.06, Fulton County, Georgia,65,5,60,57,56,1,0,3
-1,131210097002002.000000000000000,Block 2002, Block Group 2, Census Tract 97, Fulton County, Georgia,65,15,50,48,46,0,2,2
-1,131210098041003.000000000000000,Block 1003, Block Group 1, Census Tract 98.04, Fulton County, Georgia,65,4,61,61,59,0,0,0
-1,131210099004001.000000000000000,Block 4001, Block Group 4, Census Tract 99, Fulton County, Georgia,65,6,59,54,45,4,0,5
-1,131210100041013.000000000000000,Block 1013, Block Group 1, Census Tract 100.04, Fulton County, Georgia,65,2,63,53,49,0,0,10
-1,131210100051006.000000000000000,Block 1006, Block Group 1, Census Tract 100.05, Fulton County, Georgia,65,3,62,62,55,6,0,0
-1,131210102162012.000000000000000,Block 2012, Block Group 2, Census Tract 102.16, Fulton County, Georgia,65,2,63,61,58,0,0,2
-1,131210103082003.000000000000000,Block 2003, Block Group 2, Census Tract 103.08, Fulton County, Georgia,65,4,61,60,0,60,0,1
-1,131210103093010.000000000000000,Block 3010, Block Group 3, Census Tract 103.09, Fulton County, Georgia,65,3,62,59,0,58,1,3
-1,131210105352008.000000000000000,Block 2008, Block Group 2, Census Tract 105.35, Fulton County, Georgia,65,15,50,50,11,37,0,0
-1,131210106014001.000000000000000,Block 4001, Block Group 4, Census Tract 106.01, Fulton County, Georgia,65,5,60,55,20,31,0,5
-1,131210106014004.000000000000000,Block 4004, Block Group 4, Census Tract 106.01, Fulton County, Georgia,65,0,65,63,26,36,1,2
-1,131210110002016.000000000000000,Block 2016, Block Group 2, Census Tract 110, Fulton County, Georgia,65,6,59,59,0,59,0,0
-1,131210112022012.000000000000000,Block 2012, Block Group 2, Census Tract 112.02, Fulton County, Georgia,65,27,38,38,18,20,0,0
-1,131210113011004.000000000000000,Block 1004, Block Group 1, Census Tract 113.01, Fulton County, Georgia,65,1,64,63,2,60,0,1
-1,131210114191015.000000000000000,Block 1015, Block Group 1, Census Tract 114.19, Fulton County, Georgia,65,2,63,61,51,6,0,2
-1,131210114361002.000000000000000,Block 1002, Block Group 1, Census Tract 114.36, Fulton County, Georgia,65,4,61,46,42,2,1,15
-1,131210115131008.000000000000000,Block 1008, Block Group 1, Census Tract 115.13, Fulton County, Georgia,65,11,54,44,35,6,0,10
-1,131210115141011.000000000000000,Block 1011, Block Group 1, Census Tract 115.14, Fulton County, Georgia,65,0,65,65,65,0,0,0
-1,131210116122005.000000000000000,Block 2005, Block Group 2, Census Tract 116.12, Fulton County, Georgia,65,6,59,56,49,1,0,3
-1,131210116372024.000000000000000,Block 2024, Block Group 2, Census Tract 116.37, Fulton County, Georgia,65,4,61,56,38,3,2,5
-1,131210116453001.000000000000000,Block 3001, Block Group 3, Census Tract 116.45, Fulton County, Georgia,65,7,58,51,11,4,0,7
-1,131210116611002.000000000000000,Block 1002, Block Group 1, Census Tract 116.61, Fulton County, Georgia,65,2,63,60,37,14,1,3
-1,131210123002040.000000000000000,Block 2040, Block Group 2, Census Tract 123, Fulton County, Georgia,65,2,63,63,33,30,0,0
-1,131210001001008.000000000000000,Block 1008, Block Group 1, Census Tract 1, Fulton County, Georgia,64,1,63,59,55,0,0,4
-1,131210001003009.000000000000000,Block 3009, Block Group 3, Census Tract 1, Fulton County, Georgia,64,2,62,60,60,0,0,2
-1,131210005021004.000000000000000,Block 1004, Block Group 1, Census Tract 5.02, Fulton County, Georgia,64,1,63,61,58,0,0,2
-1,131210040001007.000000000000000,Block 1007, Block Group 1, Census Tract 40, Fulton County, Georgia,64,2,62,62,0,62,0,0
-1,131210041001002.000000000000000,Block 1002, Block Group 1, Census Tract 41, Fulton County, Georgia,64,0,64,63,4,57,2,1
-1,131210052002000.000000000000000,Block 2000, Block Group 2, Census Tract 52, Fulton County, Georgia,64,0,64,62,57,2,0,2
-1,131210055012009.000000000000000,Block 2009, Block Group 2, Census Tract 55.01, Fulton County, Georgia,64,3,61,60,18,38,0,1
-1,131210057001007.000000000000000,Block 1007, Block Group 1, Census Tract 57, Fulton County, Georgia,64,0,64,62,5,57,0,2
-1,131210058001046.000000000000000,Block 1046, Block Group 1, Census Tract 58, Fulton County, Georgia,64,3,61,57,24,33,0,4
-1,131210065002004.000000000000000,Block 2004, Block Group 2, Census Tract 65, Fulton County, Georgia,64,4,60,54,4,49,0,6
-1,131210068021003.000000000000000,Block 1003, Block Group 1, Census Tract 68.02, Fulton County, Georgia,64,5,59,58,0,57,0,1
-1,131210070023006.000000000000000,Block 3006, Block Group 3, Census Tract 70.02, Fulton County, Georgia,64,5,59,58,9,49,0,1
-1,131210073011012.000000000000000,Block 1012, Block Group 1, Census Tract 73.01, Fulton County, Georgia,64,4,60,59,2,52,5,1
-1,131210075003014.000000000000000,Block 3014, Block Group 3, Census Tract 75, Fulton County, Georgia,64,3,61,60,4,53,2,1
-1,131210077082005.000000000000000,Block 2005, Block Group 2, Census Tract 77.08, Fulton County, Georgia,64,8,56,56,2,53,1,0
-1,131210077103006.000000000000000,Block 3006, Block Group 3, Census Tract 77.10, Fulton County, Georgia,64,4,60,51,4,45,2,9
-1,131210090021014.000000000000000,Block 1014, Block Group 1, Census Tract 90.02, Fulton County, Georgia,64,7,57,56,52,2,1,1
-1,131210093012012.000000000000000,Block 2012, Block Group 2, Census Tract 93.01, Fulton County, Georgia,64,4,60,51,48,0,0,9
-1,131210095012004.000000000000000,Block 2004, Block Group 2, Census Tract 95.01, Fulton County, Georgia,64,1,63,62,62,0,0,1
-1,131210095013000.000000000000000,Block 3000, Block Group 3, Census Tract 95.01, Fulton County, Georgia,64,2,62,62,62,0,0,0
-1,131210096044000.000000000000000,Block 4000, Block Group 4, Census Tract 96.04, Fulton County, Georgia,64,6,58,53,44,3,0,5
-1,131210096061021.000000000000000,Block 1021, Block Group 1, Census Tract 96.06, Fulton County, Georgia,64,1,63,57,56,0,1,6
-1,131210098041010.000000000000000,Block 1010, Block Group 1, Census Tract 98.04, Fulton County, Georgia,64,4,60,59,41,12,0,1
-1,131210098041014.000000000000000,Block 1014, Block Group 1, Census Tract 98.04, Fulton County, Georgia,64,0,64,64,62,2,0,0
-1,131210100031005.000000000000000,Block 1005, Block Group 1, Census Tract 100.03, Fulton County, Georgia,64,7,57,55,51,4,0,2
-1,131210100041011.000000000000000,Block 1011, Block Group 1, Census Tract 100.04, Fulton County, Georgia,64,2,62,58,55,3,0,4
-1,131210101062010.000000000000000,Block 2010, Block Group 2, Census Tract 101.06, Fulton County, Georgia,64,4,60,56,51,4,0,4
-1,131210101291002.000000000000000,Block 1002, Block Group 1, Census Tract 101.29, Fulton County, Georgia,64,12,52,42,34,0,0,10
-1,131210101332003.000000000000000,Block 2003, Block Group 2, Census Tract 101.33, Fulton County, Georgia,64,6,58,57,52,0,0,1
-1,131210101332019.000000000000000,Block 2019, Block Group 2, Census Tract 101.33, Fulton County, Georgia,64,10,54,51,50,0,0,3
-1,131210101341005.000000000000000,Block 1005, Block Group 1, Census Tract 101.34, Fulton County, Georgia,64,20,44,38,12,25,0,6
-1,131210101342002.000000000000000,Block 2002, Block Group 2, Census Tract 101.34, Fulton County, Georgia,64,15,49,47,18,17,1,2
-1,131210103082002.000000000000000,Block 2002, Block Group 2, Census Tract 103.08, Fulton County, Georgia,64,7,57,57,0,57,0,0
-1,131210103132008.000000000000000,Block 2008, Block Group 2, Census Tract 103.13, Fulton County, Georgia,64,1,63,60,0,60,0,3
-1,131210104011031.000000000000000,Block 1031, Block Group 1, Census Tract 104.01, Fulton County, Georgia,64,15,49,46,17,29,0,3
-1,131210104023053.000000000000000,Block 3053, Block Group 3, Census Tract 104.02, Fulton County, Georgia,64,0,64,61,53,8,0,3
-1,131210105081001.000000000000000,Block 1001, Block Group 1, Census Tract 105.08, Fulton County, Georgia,64,2,62,60,0,60,0,2
-1,131210105231031.000000000000000,Block 1031, Block Group 1, Census Tract 105.23, Fulton County, Georgia,64,3,61,58,3,53,1,3
-1,131210105274010.000000000000000,Block 4010, Block Group 4, Census Tract 105.27, Fulton County, Georgia,64,33,31,27,2,22,3,4
-1,131210105323004.000000000000000,Block 3004, Block Group 3, Census Tract 105.32, Fulton County, Georgia,64,3,61,61,6,47,7,0
-1,131210105371010.000000000000000,Block 1010, Block Group 1, Census Tract 105.37, Fulton County, Georgia,64,7,57,52,0,52,0,5
-1,131210105391004.000000000000000,Block 1004, Block Group 1, Census Tract 105.39, Fulton County, Georgia,64,0,64,61,1,60,0,3
-1,131210105401009.000000000000000,Block 1009, Block Group 1, Census Tract 105.40, Fulton County, Georgia,64,4,60,60,0,59,1,0
-1,131210113013003.000000000000000,Block 3003, Block Group 3, Census Tract 113.01, Fulton County, Georgia,64,11,53,49,0,49,0,4
-1,131210114163006.000000000000000,Block 3006, Block Group 3, Census Tract 114.16, Fulton County, Georgia,64,0,64,62,59,0,0,2
-1,131210114171001.000000000000000,Block 1001, Block Group 1, Census Tract 114.17, Fulton County, Georgia,64,6,58,53,51,1,1,5
-1,131210114373001.000000000000000,Block 3001, Block Group 3, Census Tract 114.37, Fulton County, Georgia,64,15,49,46,41,5,0,3
-1,131210115082026.000000000000000,Block 2026, Block Group 2, Census Tract 115.08, Fulton County, Georgia,64,1,63,51,49,1,0,12
-1,131210115111003.000000000000000,Block 1003, Block Group 1, Census Tract 115.11, Fulton County, Georgia,64,12,52,46,32,8,1,6
-1,131210116351002.000000000000000,Block 1002, Block Group 1, Census Tract 116.35, Fulton County, Georgia,64,13,51,48,19,1,0,3
-1,131210116561007.000000000000000,Block 1007, Block Group 1, Census Tract 116.56, Fulton County, Georgia,64,9,55,49,16,12,2,6
-1,131210116601011.000000000000000,Block 1011, Block Group 1, Census Tract 116.60, Fulton County, Georgia,64,4,60,58,37,11,0,2
-1,131210005012018.000000000000000,Block 2018, Block Group 2, Census Tract 5.01, Fulton County, Georgia,63,10,53,50,4,44,2,3
-1,131210015021002.000000000000000,Block 1002, Block Group 1, Census Tract 15.02, Fulton County, Georgia,63,3,60,56,51,0,4,4
-1,131210017011010.000000000000000,Block 1010, Block Group 1, Census Tract 17.01, Fulton County, Georgia,63,7,56,51,28,19,0,5
-1,131210030003002.000000000000000,Block 3002, Block Group 3, Census Tract 30, Fulton County, Georgia,63,6,57,51,48,3,0,6
-1,131210041003015.000000000000000,Block 3015, Block Group 3, Census Tract 41, Fulton County, Georgia,63,7,56,55,13,40,0,1
-1,131210052001010.000000000000000,Block 1010, Block Group 1, Census Tract 52, Fulton County, Georgia,63,4,59,58,51,7,0,1
-1,131210053001010.000000000000000,Block 1010, Block Group 1, Census Tract 53, Fulton County, Georgia,63,7,56,51,42,7,0,5
-1,131210055012010.000000000000000,Block 2010, Block Group 2, Census Tract 55.01, Fulton County, Georgia,63,9,54,53,38,12,0,1
-1,131210063001021.000000000000000,Block 1021, Block Group 1, Census Tract 63, Fulton County, Georgia,63,1,62,61,14,47,0,1
-1,131210065004001.000000000000000,Block 4001, Block Group 4, Census Tract 65, Fulton County, Georgia,63,0,63,57,14,38,0,6
-1,131210066012007.000000000000000,Block 2007, Block Group 2, Census Tract 66.01, Fulton County, Georgia,63,3,60,58,8,48,0,2
-1,131210073011010.000000000000000,Block 1010, Block Group 1, Census Tract 73.01, Fulton County, Georgia,63,3,60,60,3,54,2,0
-1,131210073014003.000000000000000,Block 4003, Block Group 4, Census Tract 73.01, Fulton County, Georgia,63,7,56,55,1,51,3,1
-1,131210073021004.000000000000000,Block 1004, Block Group 1, Census Tract 73.02, Fulton County, Georgia,63,3,60,54,1,53,0,6
-1,131210073022015.000000000000000,Block 2015, Block Group 2, Census Tract 73.02, Fulton County, Georgia,63,4,59,53,0,51,0,6
-1,131210076022002.000000000000000,Block 2002, Block Group 2, Census Tract 76.02, Fulton County, Georgia,63,2,61,60,5,54,1,1
-1,131210076023005.000000000000000,Block 3005, Block Group 3, Census Tract 76.02, Fulton County, Georgia,63,1,62,61,4,54,0,1
-1,131210077093009.000000000000000,Block 3009, Block Group 3, Census Tract 77.09, Fulton County, Georgia,63,4,59,59,1,58,0,0
-1,131210078052008.000000000000000,Block 2008, Block Group 2, Census Tract 78.05, Fulton County, Georgia,63,4,59,58,0,58,0,1
-1,131210078061013.000000000000000,Block 1013, Block Group 1, Census Tract 78.06, Fulton County, Georgia,63,0,63,61,0,61,0,2
-1,131210078091006.000000000000000,Block 1006, Block Group 1, Census Tract 78.09, Fulton County, Georgia,63,3,60,60,0,60,0,0
-1,131210079003005.000000000000000,Block 3005, Block Group 3, Census Tract 79, Fulton County, Georgia,63,6,57,55,0,55,0,2
-1,131210081043011.000000000000000,Block 3011, Block Group 3, Census Tract 81.04, Fulton County, Georgia,63,7,56,55,11,43,0,1
-1,131210084001004.000000000000000,Block 1004, Block Group 1, Census Tract 84, Fulton County, Georgia,63,0,63,63,5,58,0,0
-1,131210084001016.000000000000000,Block 1016, Block Group 1, Census Tract 84, Fulton County, Georgia,63,0,63,62,0,60,0,1
-1,131210085003020.000000000000000,Block 3020, Block Group 3, Census Tract 85, Fulton County, Georgia,63,6,57,57,1,56,0,0
-1,131210087011011.000000000000000,Block 1011, Block Group 1, Census Tract 87.01, Fulton County, Georgia,63,12,51,51,3,48,0,0
-1,131210089062009.000000000000000,Block 2009, Block Group 2, Census Tract 89.06, Fulton County, Georgia,63,5,58,50,48,1,1,8
-1,131210093011009.000000000000000,Block 1009, Block Group 1, Census Tract 93.01, Fulton County, Georgia,63,0,63,63,54,4,5,0
-1,131210095012007.000000000000000,Block 2007, Block Group 2, Census Tract 95.01, Fulton County, Georgia,63,0,63,59,54,0,1,4
-1,131210097001011.000000000000000,Block 1011, Block Group 1, Census Tract 97, Fulton County, Georgia,63,2,61,54,47,0,0,7
-1,131210098022004.000000000000000,Block 2004, Block Group 2, Census Tract 98.02, Fulton County, Georgia,63,4,59,59,52,3,0,0
-1,131210100041000.000000000000000,Block 1000, Block Group 1, Census Tract 100.04, Fulton County, Georgia,63,0,63,61,53,0,2,2
-1,131210100041006.000000000000000,Block 1006, Block Group 1, Census Tract 100.04, Fulton County, Georgia,63,1,62,55,46,6,0,7
-1,131210101151008.000000000000000,Block 1008, Block Group 1, Census Tract 101.15, Fulton County, Georgia,63,10,53,42,34,3,0,11
-1,131210101311009.000000000000000,Block 1009, Block Group 1, Census Tract 101.31, Fulton County, Georgia,63,7,56,50,50,0,0,6
-1,131210101332018.000000000000000,Block 2018, Block Group 2, Census Tract 101.33, Fulton County, Georgia,63,1,62,53,32,10,7,9
-1,131210102043002.000000000000000,Block 3002, Block Group 3, Census Tract 102.04, Fulton County, Georgia,63,1,62,61,55,0,5,1
-1,131210102141001.000000000000000,Block 1001, Block Group 1, Census Tract 102.14, Fulton County, Georgia,63,18,45,37,15,13,3,8
-1,131210102152005.000000000000000,Block 2005, Block Group 2, Census Tract 102.15, Fulton County, Georgia,63,13,50,42,35,3,0,8
-1,131210102201002.000000000000000,Block 1002, Block Group 1, Census Tract 102.20, Fulton County, Georgia,63,3,60,52,51,0,1,8
-1,131210103063008.000000000000000,Block 3008, Block Group 3, Census Tract 103.06, Fulton County, Georgia,63,0,63,63,1,62,0,0
-1,131210103121003.000000000000000,Block 1003, Block Group 1, Census Tract 103.12, Fulton County, Georgia,63,3,60,57,0,57,0,3
-1,131210105182011.000000000000000,Block 2011, Block Group 2, Census Tract 105.18, Fulton County, Georgia,63,5,58,57,1,52,4,1
-1,131210105211011.000000000000000,Block 1011, Block Group 1, Census Tract 105.21, Fulton County, Georgia,63,0,63,63,0,62,0,0
-1,131210105292007.000000000000000,Block 2007, Block Group 2, Census Tract 105.29, Fulton County, Georgia,63,6,57,57,2,54,1,0
-1,131210105343002.000000000000000,Block 3002, Block Group 3, Census Tract 105.34, Fulton County, Georgia,63,15,48,47,0,43,0,1
-1,131210105371009.000000000000000,Block 1009, Block Group 1, Census Tract 105.37, Fulton County, Georgia,63,1,62,57,1,53,2,5
-1,131210106043003.000000000000000,Block 3003, Block Group 3, Census Tract 106.04, Fulton County, Georgia,63,18,45,36,1,32,3,9
-1,131210110002007.000000000000000,Block 2007, Block Group 2, Census Tract 110, Fulton County, Georgia,63,13,50,47,3,44,0,3
-1,131210112025005.000000000000000,Block 5005, Block Group 5, Census Tract 112.02, Fulton County, Georgia,63,11,52,52,6,43,0,0
-1,131210113012003.000000000000000,Block 2003, Block Group 2, Census Tract 113.01, Fulton County, Georgia,63,28,35,35,0,35,0,0
-1,131210113013006.000000000000000,Block 3006, Block Group 3, Census Tract 113.01, Fulton County, Georgia,63,5,58,56,14,42,0,2
-1,131210113072003.000000000000000,Block 2003, Block Group 2, Census Tract 113.07, Fulton County, Georgia,63,6,57,54,0,51,0,3
-1,131210114194004.000000000000000,Block 4004, Block Group 4, Census Tract 114.19, Fulton County, Georgia,63,0,63,56,51,0,0,7
-1,131210114411002.000000000000000,Block 1002, Block Group 1, Census Tract 114.41, Fulton County, Georgia,63,6,57,54,44,7,0,3
-1,131210115081007.000000000000000,Block 1007, Block Group 1, Census Tract 115.08, Fulton County, Georgia,63,4,59,58,50,0,0,1
-1,131210115121007.000000000000000,Block 1007, Block Group 1, Census Tract 115.12, Fulton County, Georgia,63,9,54,48,45,1,2,6
-1,131210115132001.000000000000000,Block 2001, Block Group 2, Census Tract 115.13, Fulton County, Georgia,63,13,50,50,40,4,4,0
-1,131210116353015.000000000000000,Block 3015, Block Group 3, Census Tract 116.35, Fulton County, Georgia,63,1,62,62,45,0,0,0
-1,131210116493015.000000000000000,Block 3015, Block Group 3, Census Tract 116.49, Fulton County, Georgia,63,4,59,49,5,3,0,10
-1,131210120001008.000000000000000,Block 1008, Block Group 1, Census Tract 120, Fulton County, Georgia,63,3,60,53,12,41,0,7
-1,131210005021005.000000000000000,Block 1005, Block Group 1, Census Tract 5.02, Fulton County, Georgia,62,0,62,57,49,5,0,5
-1,131210005021010.000000000000000,Block 1010, Block Group 1, Census Tract 5.02, Fulton County, Georgia,62,6,56,52,37,10,0,4
-1,131210005022027.000000000000000,Block 2027, Block Group 2, Census Tract 5.02, Fulton County, Georgia,62,2,60,60,60,0,0,0
-1,131210006012003.000000000000000,Block 2003, Block Group 2, Census Tract 6.01, Fulton County, Georgia,62,4,58,58,21,6,0,0
-1,131210016001005.000000000000000,Block 1005, Block Group 1, Census Tract 16, Fulton County, Georgia,62,12,50,49,39,10,0,1
-1,131210017011004.000000000000000,Block 1004, Block Group 1, Census Tract 17.01, Fulton County, Georgia,62,4,58,54,11,43,0,4
-1,131210039002004.000000000000000,Block 2004, Block Group 2, Census Tract 39, Fulton County, Georgia,62,0,62,59,1,58,0,3
-1,131210053002013.000000000000000,Block 2013, Block Group 2, Census Tract 53, Fulton County, Georgia,62,1,61,61,30,31,0,0
-1,131210064001004.000000000000000,Block 1004, Block Group 1, Census Tract 64, Fulton County, Georgia,62,11,51,50,6,43,0,1
-1,131210065002018.000000000000000,Block 2018, Block Group 2, Census Tract 65, Fulton County, Georgia,62,1,61,61,11,50,0,0
-1,131210069002013.000000000000000,Block 2013, Block Group 2, Census Tract 69, Fulton County, Georgia,62,10,52,51,14,37,0,1
-1,131210071001018.000000000000000,Block 1018, Block Group 1, Census Tract 71, Fulton County, Georgia,62,3,59,59,2,54,3,0
-1,131210074002011.000000000000000,Block 2011, Block Group 2, Census Tract 74, Fulton County, Georgia,62,6,56,50,2,47,0,6
-1,131210077033005.000000000000000,Block 3005, Block Group 3, Census Tract 77.03, Fulton County, Georgia,62,0,62,58,3,55,0,4
-1,131210078062002.000000000000000,Block 2002, Block Group 2, Census Tract 78.06, Fulton County, Georgia,62,0,62,62,0,61,0,0
-1,131210078064010.000000000000000,Block 4010, Block Group 4, Census Tract 78.06, Fulton County, Georgia,62,11,51,50,0,50,0,1
-1,131210079003018.000000000000000,Block 3018, Block Group 3, Census Tract 79, Fulton County, Georgia,62,0,62,62,0,61,0,0
-1,131210085002018.000000000000000,Block 2018, Block Group 2, Census Tract 85, Fulton County, Georgia,62,2,60,56,8,48,0,4
-1,131210088022017.000000000000000,Block 2017, Block Group 2, Census Tract 88.02, Fulton County, Georgia,62,1,61,57,32,25,0,4
-1,131210092032004.000000000000000,Block 2004, Block Group 2, Census Tract 92.03, Fulton County, Georgia,62,12,50,47,38,4,0,3
-1,131210095011007.000000000000000,Block 1007, Block Group 1, Census Tract 95.01, Fulton County, Georgia,62,2,60,60,60,0,0,0
-1,131210097001007.000000000000000,Block 1007, Block Group 1, Census Tract 97, Fulton County, Georgia,62,1,61,60,59,1,0,1
-1,131210097001008.000000000000000,Block 1008, Block Group 1, Census Tract 97, Fulton County, Georgia,62,2,60,60,55,4,0,0
-1,131210097003012.000000000000000,Block 3012, Block Group 3, Census Tract 97, Fulton County, Georgia,62,3,59,58,53,4,1,1
-1,131210098021017.000000000000000,Block 1017, Block Group 1, Census Tract 98.02, Fulton County, Georgia,62,0,62,60,58,1,0,2
-1,131210098021021.000000000000000,Block 1021, Block Group 1, Census Tract 98.02, Fulton County, Georgia,62,3,59,57,53,3,0,2
-1,131210100052016.000000000000000,Block 2016, Block Group 2, Census Tract 100.05, Fulton County, Georgia,62,5,57,53,53,0,0,4
-1,131210101311007.000000000000000,Block 1007, Block Group 1, Census Tract 101.31, Fulton County, Georgia,62,0,62,62,58,0,0,0
-1,131210103053005.000000000000000,Block 3005, Block Group 3, Census Tract 103.05, Fulton County, Georgia,62,9,53,50,2,48,0,3
-1,131210103101013.000000000000000,Block 1013, Block Group 1, Census Tract 103.10, Fulton County, Georgia,62,8,54,48,0,47,0,6
-1,131210103153002.000000000000000,Block 3002, Block Group 3, Census Tract 103.15, Fulton County, Georgia,62,7,55,54,0,50,0,1
-1,131210104013036.000000000000000,Block 3036, Block Group 3, Census Tract 104.01, Fulton County, Georgia,62,6,56,56,3,53,0,0
-1,131210105202001.000000000000000,Block 2001, Block Group 2, Census Tract 105.20, Fulton County, Georgia,62,1,61,61,0,56,1,0
-1,131210105203012.000000000000000,Block 3012, Block Group 3, Census Tract 105.20, Fulton County, Georgia,62,0,62,62,31,30,0,0
-1,131210105261007.000000000000000,Block 1007, Block Group 1, Census Tract 105.26, Fulton County, Georgia,62,4,58,57,0,51,3,1
-1,131210105263004.000000000000000,Block 3004, Block Group 3, Census Tract 105.26, Fulton County, Georgia,62,2,60,58,0,56,0,2
-1,131210105342027.000000000000000,Block 2027, Block Group 2, Census Tract 105.34, Fulton County, Georgia,62,0,62,60,0,60,0,2
-1,131210105361001.000000000000000,Block 1001, Block Group 1, Census Tract 105.36, Fulton County, Georgia,62,0,62,58,0,56,2,4
-1,131210105391011.000000000000000,Block 1011, Block Group 1, Census Tract 105.39, Fulton County, Georgia,62,2,60,60,1,59,0,0
-1,131210105401030.000000000000000,Block 1030, Block Group 1, Census Tract 105.40, Fulton County, Georgia,62,5,57,55,10,41,3,2
-1,131210105401032.000000000000000,Block 1032, Block Group 1, Census Tract 105.40, Fulton County, Georgia,62,24,38,38,2,35,1,0
-1,131210110003011.000000000000000,Block 3011, Block Group 3, Census Tract 110, Fulton County, Georgia,62,1,61,61,10,51,0,0
-1,131210111002023.000000000000000,Block 2023, Block Group 2, Census Tract 111, Fulton County, Georgia,62,0,62,62,7,54,0,0
-1,131210112021011.000000000000000,Block 1011, Block Group 1, Census Tract 112.02, Fulton County, Georgia,62,3,59,56,39,15,2,3
-1,131210112031020.000000000000000,Block 1020, Block Group 1, Census Tract 112.03, Fulton County, Georgia,62,13,49,46,12,34,0,3
-1,131210113016005.000000000000000,Block 6005, Block Group 6, Census Tract 113.01, Fulton County, Georgia,62,6,56,56,15,41,0,0
-1,131210113103000.000000000000000,Block 3000, Block Group 3, Census Tract 113.10, Fulton County, Georgia,62,0,62,61,7,54,0,1
-1,131210114163013.000000000000000,Block 3013, Block Group 3, Census Tract 114.16, Fulton County, Georgia,62,2,60,56,50,1,0,4
-1,131210114234005.000000000000000,Block 4005, Block Group 4, Census Tract 114.23, Fulton County, Georgia,62,19,43,40,35,4,1,3
-1,131210115151006.000000000000000,Block 1006, Block Group 1, Census Tract 115.15, Fulton County, Georgia,62,6,56,53,52,1,0,3
-1,131210116121000.000000000000000,Block 1000, Block Group 1, Census Tract 116.12, Fulton County, Georgia,62,2,60,57,45,2,2,3
-1,131210116181005.000000000000000,Block 1005, Block Group 1, Census Tract 116.18, Fulton County, Georgia,62,14,48,33,17,7,1,15
-1,131210116402020.000000000000000,Block 2020, Block Group 2, Census Tract 116.40, Fulton County, Georgia,62,19,43,42,37,0,1,1
-1,131210116412006.000000000000000,Block 2006, Block Group 2, Census Tract 116.41, Fulton County, Georgia,62,8,54,53,47,2,0,1
-1,131210116441010.000000000000000,Block 1010, Block Group 1, Census Tract 116.44, Fulton County, Georgia,62,6,56,49,5,29,4,7
-1,131210116453004.000000000000000,Block 3004, Block Group 3, Census Tract 116.45, Fulton County, Georgia,62,2,60,54,16,12,0,6
-1,131210120003039.000000000000000,Block 3039, Block Group 3, Census Tract 120, Fulton County, Georgia,62,1,61,59,0,59,0,2
-1,131210006013003.000000000000000,Block 3003, Block Group 3, Census Tract 6.01, Fulton County, Georgia,61,6,55,54,39,1,0,1
-1,131210012041009.000000000000000,Block 1009, Block Group 1, Census Tract 12.04, Fulton County, Georgia,61,3,58,49,39,4,0,9
-1,131210013011009.000000000000000,Block 1009, Block Group 1, Census Tract 13.01, Fulton County, Georgia,61,4,57,54,45,6,0,3
-1,131210013011012.000000000000000,Block 1012, Block Group 1, Census Tract 13.01, Fulton County, Georgia,61,2,59,59,54,0,0,0
-1,131210024001001.000000000000000,Block 1001, Block Group 1, Census Tract 24, Fulton County, Georgia,61,8,53,50,2,48,0,3
-1,131210024001016.000000000000000,Block 1016, Block Group 1, Census Tract 24, Fulton County, Georgia,61,4,57,57,7,49,0,0
-1,131210026001012.000000000000000,Block 1012, Block Group 1, Census Tract 26, Fulton County, Georgia,61,0,61,61,0,58,3,0
-1,131210032001007.000000000000000,Block 1007, Block Group 1, Census Tract 32, Fulton County, Georgia,61,4,57,57,52,4,1,0
-1,131210049001001.000000000000000,Block 1001, Block Group 1, Census Tract 49, Fulton County, Georgia,61,3,58,45,14,28,0,13
-1,131210049001004.000000000000000,Block 1004, Block Group 1, Census Tract 49, Fulton County, Georgia,61,1,60,58,25,30,1,2
-1,131210049002014.000000000000000,Block 2014, Block Group 2, Census Tract 49, Fulton County, Georgia,61,1,60,54,36,17,0,6
-1,131210049002025.000000000000000,Block 2025, Block Group 2, Census Tract 49, Fulton County, Georgia,61,1,60,58,56,0,0,2
-1,131210053003005.000000000000000,Block 3005, Block Group 3, Census Tract 53, Fulton County, Georgia,61,1,60,60,52,8,0,0
-1,131210070012011.000000000000000,Block 2011, Block Group 2, Census Tract 70.01, Fulton County, Georgia,61,3,58,57,0,57,0,1
-1,131210070014015.000000000000000,Block 4015, Block Group 4, Census Tract 70.01, Fulton County, Georgia,61,4,57,57,1,56,0,0
-1,131210071001020.000000000000000,Block 1020, Block Group 1, Census Tract 71, Fulton County, Georgia,61,19,42,40,0,40,0,2
-1,131210073022004.000000000000000,Block 2004, Block Group 2, Census Tract 73.02, Fulton County, Georgia,61,1,60,59,0,57,2,1
-1,131210077032011.000000000000000,Block 2011, Block Group 2, Census Tract 77.03, Fulton County, Georgia,61,0,61,60,0,58,2,1
-1,131210084002003.000000000000000,Block 2003, Block Group 2, Census Tract 84, Fulton County, Georgia,61,3,58,58,4,54,0,0
-1,131210087012008.000000000000000,Block 2008, Block Group 2, Census Tract 87.01, Fulton County, Georgia,61,8,53,52,20,21,0,1
-1,131210089072004.000000000000000,Block 2004, Block Group 2, Census Tract 89.07, Fulton County, Georgia,61,2,59,54,19,22,0,5
-1,131210089082001.000000000000000,Block 2001, Block Group 2, Census Tract 89.08, Fulton County, Georgia,61,5,56,53,50,0,1,3
-1,131210097002016.000000000000000,Block 2016, Block Group 2, Census Tract 97, Fulton County, Georgia,61,1,60,60,56,0,0,0
-1,131210100041002.000000000000000,Block 1002, Block Group 1, Census Tract 100.04, Fulton County, Georgia,61,1,60,51,41,2,0,9
-1,131210103051009.000000000000000,Block 1009, Block Group 1, Census Tract 103.05, Fulton County, Georgia,61,0,61,56,0,56,0,5
-1,131210103061015.000000000000000,Block 1015, Block Group 1, Census Tract 103.06, Fulton County, Georgia,61,2,59,53,5,48,0,6
-1,131210103103001.000000000000000,Block 3001, Block Group 3, Census Tract 103.10, Fulton County, Georgia,61,1,60,58,0,58,0,2
-1,131210104011032.000000000000000,Block 1032, Block Group 1, Census Tract 104.01, Fulton County, Georgia,61,8,53,48,13,34,1,5
-1,131210104023000.000000000000000,Block 3000, Block Group 3, Census Tract 104.02, Fulton County, Georgia,61,2,59,58,30,28,0,1
-1,131210105083007.000000000000000,Block 3007, Block Group 3, Census Tract 105.08, Fulton County, Georgia,61,0,61,60,7,53,0,1
-1,131210105203013.000000000000000,Block 3013, Block Group 3, Census Tract 105.20, Fulton County, Georgia,61,0,61,57,21,36,0,4
-1,131210105211000.000000000000000,Block 1000, Block Group 1, Census Tract 105.21, Fulton County, Georgia,61,10,51,51,6,43,0,0
-1,131210105211006.000000000000000,Block 1006, Block Group 1, Census Tract 105.21, Fulton County, Georgia,61,6,55,55,1,54,0,0
-1,131210105301008.000000000000000,Block 1008, Block Group 1, Census Tract 105.30, Fulton County, Georgia,61,0,61,61,1,58,0,0
-1,131210105311001.000000000000000,Block 1001, Block Group 1, Census Tract 105.31, Fulton County, Georgia,61,3,58,54,4,47,2,4
-1,131210105311009.000000000000000,Block 1009, Block Group 1, Census Tract 105.31, Fulton County, Georgia,61,6,55,53,1,47,5,2
-1,131210105343003.000000000000000,Block 3003, Block Group 3, Census Tract 105.34, Fulton County, Georgia,61,23,38,34,0,34,0,4
-1,131210105392019.000000000000000,Block 2019, Block Group 2, Census Tract 105.39, Fulton County, Georgia,61,2,59,59,0,59,0,0
-1,131210106032000.000000000000000,Block 2000, Block Group 2, Census Tract 106.03, Fulton County, Georgia,61,4,57,57,2,52,3,0
-1,131210112032002.000000000000000,Block 2002, Block Group 2, Census Tract 112.03, Fulton County, Georgia,61,6,55,51,18,33,0,4
-1,131210112032011.000000000000000,Block 2011, Block Group 2, Census Tract 112.03, Fulton County, Georgia,61,3,58,52,20,32,0,6
-1,131210112032019.000000000000000,Block 2019, Block Group 2, Census Tract 112.03, Fulton County, Georgia,61,8,53,53,20,32,0,0
-1,131210113072007.000000000000000,Block 2007, Block Group 2, Census Tract 113.07, Fulton County, Georgia,61,0,61,55,0,50,5,6
-1,131210113105004.000000000000000,Block 5004, Block Group 5, Census Tract 113.10, Fulton County, Georgia,61,7,54,54,0,54,0,0
-1,131210114232004.000000000000000,Block 2004, Block Group 2, Census Tract 114.23, Fulton County, Georgia,61,7,54,48,46,2,0,6
-1,131210114282006.000000000000000,Block 2006, Block Group 2, Census Tract 114.28, Fulton County, Georgia,61,8,53,46,37,0,0,7
-1,131210114294004.000000000000000,Block 4004, Block Group 4, Census Tract 114.29, Fulton County, Georgia,61,16,45,39,30,0,5,6
-1,131210114363005.000000000000000,Block 3005, Block Group 3, Census Tract 114.36, Fulton County, Georgia,61,3,58,58,54,2,0,0
-1,131210114382016.000000000000000,Block 2016, Block Group 2, Census Tract 114.38, Fulton County, Georgia,61,11,50,45,34,5,2,5
-1,131210114411004.000000000000000,Block 1004, Block Group 1, Census Tract 114.41, Fulton County, Georgia,61,25,36,35,28,6,0,1
-1,131210115053000.000000000000000,Block 3000, Block Group 3, Census Tract 115.05, Fulton County, Georgia,61,6,55,52,35,0,0,3
-1,131210116183011.000000000000000,Block 3011, Block Group 3, Census Tract 116.18, Fulton County, Georgia,61,0,61,59,40,17,0,2
-1,131210116353012.000000000000000,Block 3012, Block Group 3, Census Tract 116.35, Fulton County, Georgia,61,9,52,49,15,7,0,3
-1,131210116372016.000000000000000,Block 2016, Block Group 2, Census Tract 116.37, Fulton County, Georgia,61,4,57,56,31,13,4,1
-1,131210116431007.000000000000000,Block 1007, Block Group 1, Census Tract 116.43, Fulton County, Georgia,61,9,52,50,20,1,0,2
-1,131210116441015.000000000000000,Block 1015, Block Group 1, Census Tract 116.44, Fulton County, Georgia,61,4,57,46,14,10,0,11
-1,131210116443003.000000000000000,Block 3003, Block Group 3, Census Tract 116.44, Fulton County, Georgia,61,7,54,49,20,5,0,5
-1,131210116493017.000000000000000,Block 3017, Block Group 3, Census Tract 116.49, Fulton County, Georgia,61,3,58,57,19,13,1,1
-1,131210116501003.000000000000000,Block 1003, Block Group 1, Census Tract 116.50, Fulton County, Georgia,61,8,53,47,0,4,0,6
-1,131210116581003.000000000000000,Block 1003, Block Group 1, Census Tract 116.58, Fulton County, Georgia,61,6,55,54,32,8,0,1
-1,131210029001016.000000000000000,Block 1016, Block Group 1, Census Tract 29, Fulton County, Georgia,60,2,58,56,28,22,0,2
-1,131210030001001.000000000000000,Block 1001, Block Group 1, Census Tract 30, Fulton County, Georgia,60,1,59,50,41,1,0,9
-1,131210030001022.000000000000000,Block 1022, Block Group 1, Census Tract 30, Fulton County, Georgia,60,0,60,59,55,2,2,1
-1,131210031001002.000000000000000,Block 1002, Block Group 1, Census Tract 31, Fulton County, Georgia,60,0,60,59,47,8,0,1
-1,131210032001008.000000000000000,Block 1008, Block Group 1, Census Tract 32, Fulton County, Georgia,60,8,52,50,47,0,0,2
-1,131210032001010.000000000000000,Block 1010, Block Group 1, Census Tract 32, Fulton County, Georgia,60,7,53,44,28,12,0,9
-1,131210039002003.000000000000000,Block 2003, Block Group 2, Census Tract 39, Fulton County, Georgia,60,4,56,56,2,54,0,0
-1,131210050001012.000000000000000,Block 1012, Block Group 1, Census Tract 50, Fulton County, Georgia,60,3,57,51,42,8,0,6
-1,131210053002016.000000000000000,Block 2016, Block Group 2, Census Tract 53, Fulton County, Georgia,60,2,58,54,44,10,0,4
-1,131210055012014.000000000000000,Block 2014, Block Group 2, Census Tract 55.01, Fulton County, Georgia,60,3,57,56,3,52,1,1
-1,131210065003016.000000000000000,Block 3016, Block Group 3, Census Tract 65, Fulton County, Georgia,60,3,57,55,5,50,0,2
-1,131210065004007.000000000000000,Block 4007, Block Group 4, Census Tract 65, Fulton County, Georgia,60,2,58,58,27,30,1,0
-1,131210069003013.000000000000000,Block 3013, Block Group 3, Census Tract 69, Fulton County, Georgia,60,15,45,37,19,13,0,8
-1,131210074002017.000000000000000,Block 2017, Block Group 2, Census Tract 74, Fulton County, Georgia,60,11,49,47,0,47,0,2
-1,131210077053022.000000000000000,Block 3022, Block Group 3, Census Tract 77.05, Fulton County, Georgia,60,0,60,59,0,59,0,1
-1,131210078052001.000000000000000,Block 2001, Block Group 2, Census Tract 78.05, Fulton County, Georgia,60,0,60,60,0,60,0,0
-1,131210078064006.000000000000000,Block 4006, Block Group 4, Census Tract 78.06, Fulton County, Georgia,60,1,59,53,0,51,0,6
-1,131210078073003.000000000000000,Block 3003, Block Group 3, Census Tract 78.07, Fulton County, Georgia,60,9,51,51,3,46,2,0
-1,131210082042007.000000000000000,Block 2007, Block Group 2, Census Tract 82.04, Fulton County, Georgia,60,2,58,57,0,57,0,1
-1,131210082043012.000000000000000,Block 3012, Block Group 3, Census Tract 82.04, Fulton County, Georgia,60,1,59,58,2,55,0,1
-1,131210083012002.000000000000000,Block 2002, Block Group 2, Census Tract 83.01, Fulton County, Georgia,60,1,59,57,0,57,0,2
-1,131210086013014.000000000000000,Block 3014, Block Group 3, Census Tract 86.01, Fulton County, Georgia,60,0,60,60,0,60,0,0
-1,131210086013017.000000000000000,Block 3017, Block Group 3, Census Tract 86.01, Fulton County, Georgia,60,1,59,59,0,59,0,0
-1,131210090022018.000000000000000,Block 2018, Block Group 2, Census Tract 90.02, Fulton County, Georgia,60,7,53,53,50,1,0,0
-1,131210092032015.000000000000000,Block 2015, Block Group 2, Census Tract 92.03, Fulton County, Georgia,60,5,55,51,50,0,0,4
-1,131210094061001.000000000000000,Block 1001, Block Group 1, Census Tract 94.06, Fulton County, Georgia,60,10,50,49,28,10,0,1
-1,131210096061019.000000000000000,Block 1019, Block Group 1, Census Tract 96.06, Fulton County, Georgia,60,3,57,54,51,0,0,3
-1,131210101062004.000000000000000,Block 2004, Block Group 2, Census Tract 101.06, Fulton County, Georgia,60,3,57,51,44,3,0,6
-1,131210102041004.000000000000000,Block 1004, Block Group 1, Census Tract 102.04, Fulton County, Georgia,60,5,55,54,51,2,0,1
-1,131210102211002.000000000000000,Block 1002, Block Group 1, Census Tract 102.21, Fulton County, Georgia,60,3,57,46,38,5,0,11
-1,131210103153003.000000000000000,Block 3003, Block Group 3, Census Tract 103.15, Fulton County, Georgia,60,0,60,58,3,53,2,2
-1,131210104012014.000000000000000,Block 2014, Block Group 2, Census Tract 104.01, Fulton County, Georgia,60,13,47,45,0,44,1,2
-1,131210105083021.000000000000000,Block 3021, Block Group 3, Census Tract 105.08, Fulton County, Georgia,60,4,56,54,0,54,0,2
-1,131210105171006.000000000000000,Block 1006, Block Group 1, Census Tract 105.17, Fulton County, Georgia,60,2,58,56,1,55,0,2
-1,131210105171014.000000000000000,Block 1014, Block Group 1, Census Tract 105.17, Fulton County, Georgia,60,0,60,57,0,57,0,3
-1,131210105202003.000000000000000,Block 2003, Block Group 2, Census Tract 105.20, Fulton County, Georgia,60,1,59,56,4,52,0,3
-1,131210105342004.000000000000000,Block 2004, Block Group 2, Census Tract 105.34, Fulton County, Georgia,60,2,58,56,0,56,0,2
-1,131210105392028.000000000000000,Block 2028, Block Group 2, Census Tract 105.39, Fulton County, Georgia,60,6,54,52,5,47,0,2
-1,131210105401019.000000000000000,Block 1019, Block Group 1, Census Tract 105.40, Fulton County, Georgia,60,4,56,55,7,45,3,1
-1,131210106011019.000000000000000,Block 1019, Block Group 1, Census Tract 106.01, Fulton County, Georgia,60,6,54,54,7,47,0,0
-1,131210108023004.000000000000000,Block 3004, Block Group 3, Census Tract 108.02, Fulton County, Georgia,60,3,57,52,39,4,0,5
-1,131210108023013.000000000000000,Block 3013, Block Group 3, Census Tract 108.02, Fulton County, Georgia,60,16,44,41,11,27,3,3
-1,131210108023015.000000000000000,Block 3015, Block Group 3, Census Tract 108.02, Fulton County, Georgia,60,10,50,50,36,14,0,0
-1,131210110003012.000000000000000,Block 3012, Block Group 3, Census Tract 110, Fulton County, Georgia,60,7,53,53,2,51,0,0
-1,131210112022007.000000000000000,Block 2007, Block Group 2, Census Tract 112.02, Fulton County, Georgia,60,10,50,49,7,38,0,1
-1,131210114161005.000000000000000,Block 1005, Block Group 1, Census Tract 114.16, Fulton County, Georgia,60,5,55,49,36,3,0,6
-1,131210115081008.000000000000000,Block 1008, Block Group 1, Census Tract 115.08, Fulton County, Georgia,60,0,60,58,54,0,0,2
-1,131210115101030.000000000000000,Block 1030, Block Group 1, Census Tract 115.10, Fulton County, Georgia,60,6,54,53,43,4,0,1
-1,131210115103004.000000000000000,Block 3004, Block Group 3, Census Tract 115.10, Fulton County, Georgia,60,6,54,52,44,4,0,2
-1,131210116423011.000000000000000,Block 3011, Block Group 3, Census Tract 116.42, Fulton County, Georgia,60,5,55,43,40,0,1,12
-1,131210116522001.000000000000000,Block 2001, Block Group 2, Census Tract 116.52, Fulton County, Georgia,60,5,55,43,2,5,0,12
-1,131210001004019.000000000000000,Block 4019, Block Group 4, Census Tract 1, Fulton County, Georgia,59,3,56,52,47,3,1,4
-1,131210012041011.000000000000000,Block 1011, Block Group 1, Census Tract 12.04, Fulton County, Georgia,59,2,57,54,50,4,0,3
-1,131210014001005.000000000000000,Block 1005, Block Group 1, Census Tract 14, Fulton County, Georgia,59,5,54,48,45,0,2,6
-1,131210017021004.000000000000000,Block 1004, Block Group 1, Census Tract 17.02, Fulton County, Georgia,59,6,53,46,34,9,0,7
-1,131210024001005.000000000000000,Block 1005, Block Group 1, Census Tract 24, Fulton County, Georgia,59,4,55,51,2,46,3,4
-1,131210024001006.000000000000000,Block 1006, Block Group 1, Census Tract 24, Fulton County, Georgia,59,0,59,55,6,47,1,4
-1,131210025001011.000000000000000,Block 1011, Block Group 1, Census Tract 25, Fulton County, Georgia,59,4,55,55,2,53,0,0
-1,131210030001004.000000000000000,Block 1004, Block Group 1, Census Tract 30, Fulton County, Georgia,59,5,54,48,37,10,1,6
-1,131210031001011.000000000000000,Block 1011, Block Group 1, Census Tract 31, Fulton County, Georgia,59,1,58,58,52,5,0,0
-1,131210038001009.000000000000000,Block 1009, Block Group 1, Census Tract 38, Fulton County, Georgia,59,3,56,56,0,55,0,0
-1,131210042002010.000000000000000,Block 2010, Block Group 2, Census Tract 42, Fulton County, Georgia,59,1,58,47,11,36,0,11
-1,131210052004005.000000000000000,Block 4005, Block Group 4, Census Tract 52, Fulton County, Georgia,59,1,58,54,33,17,0,4
-1,131210053001011.000000000000000,Block 1011, Block Group 1, Census Tract 53, Fulton County, Georgia,59,5,54,50,36,10,4,4
-1,131210057002010.000000000000000,Block 2010, Block Group 2, Census Tract 57, Fulton County, Georgia,59,3,56,49,0,49,0,7
-1,131210063001026.000000000000000,Block 1026, Block Group 1, Census Tract 63, Fulton County, Georgia,59,0,59,59,13,46,0,0
-1,131210065003009.000000000000000,Block 3009, Block Group 3, Census Tract 65, Fulton County, Georgia,59,1,58,57,15,42,0,1
-1,131210070012016.000000000000000,Block 2016, Block Group 2, Census Tract 70.01, Fulton County, Georgia,59,1,58,57,0,55,0,1
-1,131210072003002.000000000000000,Block 3002, Block Group 3, Census Tract 72, Fulton County, Georgia,59,1,58,58,2,56,0,0
-1,131210077033010.000000000000000,Block 3010, Block Group 3, Census Tract 77.03, Fulton County, Georgia,59,2,57,57,0,55,2,0
-1,131210077053000.000000000000000,Block 3000, Block Group 3, Census Tract 77.05, Fulton County, Georgia,59,3,56,54,4,48,0,2
-1,131210078051023.000000000000000,Block 1023, Block Group 1, Census Tract 78.05, Fulton County, Georgia,59,8,51,49,3,46,0,2
-1,131210078092018.000000000000000,Block 2018, Block Group 2, Census Tract 78.09, Fulton County, Georgia,59,1,58,57,0,57,0,1
-1,131210079003020.000000000000000,Block 3020, Block Group 3, Census Tract 79, Fulton County, Georgia,59,0,59,59,1,57,0,0
-1,131210081043016.000000000000000,Block 3016, Block Group 3, Census Tract 81.04, Fulton County, Georgia,59,0,59,59,10,49,0,0
-1,131210086014013.000000000000000,Block 4013, Block Group 4, Census Tract 86.01, Fulton County, Georgia,59,2,57,55,1,54,0,2
-1,131210087011003.000000000000000,Block 1003, Block Group 1, Census Tract 87.01, Fulton County, Georgia,59,8,51,51,5,46,0,0
-1,131210087021006.000000000000000,Block 1006, Block Group 1, Census Tract 87.02, Fulton County, Georgia,59,8,51,48,19,16,3,3
-1,131210088021020.000000000000000,Block 1020, Block Group 1, Census Tract 88.02, Fulton County, Georgia,59,4,55,51,30,20,1,4
-1,131210088021025.000000000000000,Block 1025, Block Group 1, Census Tract 88.02, Fulton County, Georgia,59,4,55,50,46,4,0,5
-1,131210089052009.000000000000000,Block 2009, Block Group 2, Census Tract 89.05, Fulton County, Georgia,59,5,54,51,28,15,0,3
-1,131210092021003.000000000000000,Block 1003, Block Group 1, Census Tract 92.02, Fulton County, Georgia,59,5,54,46,41,3,2,8
-1,131210095013008.000000000000000,Block 3008, Block Group 3, Census Tract 95.01, Fulton County, Georgia,59,0,59,57,56,0,0,2
-1,131210098041007.000000000000000,Block 1007, Block Group 1, Census Tract 98.04, Fulton County, Georgia,59,0,59,56,54,0,2,3
-1,131210100052010.000000000000000,Block 2010, Block Group 2, Census Tract 100.05, Fulton County, Georgia,59,9,50,48,42,5,1,2
-1,131210101273007.000000000000000,Block 3007, Block Group 3, Census Tract 101.27, Fulton County, Georgia,59,8,51,51,23,8,0,0
-1,131210102042001.000000000000000,Block 2001, Block Group 2, Census Tract 102.04, Fulton County, Georgia,59,7,52,44,29,11,0,8
-1,131210102162010.000000000000000,Block 2010, Block Group 2, Census Tract 102.16, Fulton County, Georgia,59,2,57,55,54,1,0,2
-1,131210102233005.000000000000000,Block 3005, Block Group 3, Census Tract 102.23, Fulton County, Georgia,59,8,51,47,28,0,0,4
-1,131210102233013.000000000000000,Block 3013, Block Group 3, Census Tract 102.23, Fulton County, Georgia,59,2,57,53,51,2,0,4
-1,131210103051030.000000000000000,Block 1030, Block Group 1, Census Tract 103.05, Fulton County, Georgia,59,0,59,56,0,56,0,3
-1,131210103081001.000000000000000,Block 1001, Block Group 1, Census Tract 103.08, Fulton County, Georgia,59,3,56,54,3,50,1,2
-1,131210104022038.000000000000000,Block 2038, Block Group 2, Census Tract 104.02, Fulton County, Georgia,59,7,52,52,36,15,1,0
-1,131210105173007.000000000000000,Block 3007, Block Group 3, Census Tract 105.17, Fulton County, Georgia,59,6,53,48,9,34,4,5
-1,131210105223004.000000000000000,Block 3004, Block Group 3, Census Tract 105.22, Fulton County, Georgia,59,3,56,54,2,49,2,2
-1,131210105302014.000000000000000,Block 2014, Block Group 2, Census Tract 105.30, Fulton County, Georgia,59,0,59,59,1,58,0,0
-1,131210105371013.000000000000000,Block 1013, Block Group 1, Census Tract 105.37, Fulton County, Georgia,59,0,59,59,0,59,0,0
-1,131210108012011.000000000000000,Block 2011, Block Group 2, Census Tract 108.01, Fulton County, Georgia,59,4,55,49,31,16,0,6
-1,131210108022014.000000000000000,Block 2014, Block Group 2, Census Tract 108.02, Fulton County, Georgia,59,17,42,41,19,22,0,1
-1,131210110001006.000000000000000,Block 1006, Block Group 1, Census Tract 110, Fulton County, Georgia,59,4,55,54,0,52,2,1
-1,131210112021005.000000000000000,Block 1005, Block Group 1, Census Tract 112.02, Fulton County, Georgia,59,8,51,51,21,27,1,0
-1,131210113011011.000000000000000,Block 1011, Block Group 1, Census Tract 113.01, Fulton County, Georgia,59,14,45,45,2,43,0,0
-1,131210113013007.000000000000000,Block 3007, Block Group 3, Census Tract 113.01, Fulton County, Georgia,59,8,51,49,8,41,0,2
-1,131210113061025.000000000000000,Block 1025, Block Group 1, Census Tract 113.06, Fulton County, Georgia,59,2,57,53,0,53,0,4
-1,131210113073001.000000000000000,Block 3001, Block Group 3, Census Tract 113.07, Fulton County, Georgia,59,2,57,57,1,55,1,0
-1,131210114234002.000000000000000,Block 4002, Block Group 4, Census Tract 114.23, Fulton County, Georgia,59,8,51,45,38,7,0,6
-1,131210114342001.000000000000000,Block 2001, Block Group 2, Census Tract 114.34, Fulton County, Georgia,59,8,51,43,25,14,0,8
-1,131210114381006.000000000000000,Block 1006, Block Group 1, Census Tract 114.38, Fulton County, Georgia,59,18,41,40,24,11,0,1
-1,131210115082019.000000000000000,Block 2019, Block Group 2, Census Tract 115.08, Fulton County, Georgia,59,7,52,47,29,14,0,5
-1,131210115131011.000000000000000,Block 1011, Block Group 1, Census Tract 115.13, Fulton County, Georgia,59,0,59,59,52,4,3,0
-1,131210116443004.000000000000000,Block 3004, Block Group 3, Census Tract 116.44, Fulton County, Georgia,59,11,48,48,22,20,0,0
-1,131210116474009.000000000000000,Block 4009, Block Group 4, Census Tract 116.47, Fulton County, Georgia,59,12,47,42,28,8,1,5
-1,131210116552012.000000000000000,Block 2012, Block Group 2, Census Tract 116.55, Fulton County, Georgia,59,1,58,55,54,0,0,3
-1,131210116581002.000000000000000,Block 1002, Block Group 1, Census Tract 116.58, Fulton County, Georgia,59,7,52,52,49,0,0,0
-1,131210116602011.000000000000000,Block 2011, Block Group 2, Census Tract 116.60, Fulton County, Georgia,59,9,50,45,29,9,0,5
-1,131210119021005.000000000000000,Block 1005, Block Group 1, Census Tract 119.02, Fulton County, Georgia,59,8,51,47,19,28,0,4
-1,131210001002004.000000000000000,Block 2004, Block Group 2, Census Tract 1, Fulton County, Georgia,58,2,56,49,45,0,0,7
-1,131210002011008.000000000000000,Block 1008, Block Group 1, Census Tract 2.01, Fulton County, Georgia,58,6,52,52,48,0,1,0
-1,131210002023000.000000000000000,Block 3000, Block Group 3, Census Tract 2.02, Fulton County, Georgia,58,4,54,52,44,5,0,2
-1,131210002023001.000000000000000,Block 3001, Block Group 3, Census Tract 2.02, Fulton County, Georgia,58,2,56,52,45,0,3,4
-1,131210006013013.000000000000000,Block 3013, Block Group 3, Census Tract 6.01, Fulton County, Georgia,58,2,56,56,35,2,0,0
-1,131210013022013.000000000000000,Block 2013, Block Group 2, Census Tract 13.02, Fulton County, Georgia,58,0,58,56,45,5,0,2
-1,131210030001008.000000000000000,Block 1008, Block Group 1, Census Tract 30, Fulton County, Georgia,58,3,55,47,47,0,0,8
-1,131210031001003.000000000000000,Block 1003, Block Group 1, Census Tract 31, Fulton County, Georgia,58,1,57,52,42,9,1,5
-1,131210035002010.000000000000000,Block 2010, Block Group 2, Census Tract 35, Fulton County, Georgia,58,2,56,51,21,28,0,5
-1,131210052001011.000000000000000,Block 1011, Block Group 1, Census Tract 52, Fulton County, Georgia,58,2,56,51,46,1,0,5
-1,131210061001009.000000000000000,Block 1009, Block Group 1, Census Tract 61, Fulton County, Georgia,58,1,57,54,5,49,0,3
-1,131210061002007.000000000000000,Block 2007, Block Group 2, Census Tract 61, Fulton County, Georgia,58,0,58,57,4,53,0,1
-1,131210062001008.000000000000000,Block 1008, Block Group 1, Census Tract 62, Fulton County, Georgia,58,1,57,57,7,50,0,0
-1,131210069001008.000000000000000,Block 1008, Block Group 1, Census Tract 69, Fulton County, Georgia,58,8,50,50,26,24,0,0
-1,131210069002000.000000000000000,Block 2000, Block Group 2, Census Tract 69, Fulton County, Georgia,58,4,54,48,34,12,2,6
-1,131210073022006.000000000000000,Block 2006, Block Group 2, Census Tract 73.02, Fulton County, Georgia,58,1,57,55,0,55,0,2
-1,131210077101000.000000000000000,Block 1000, Block Group 1, Census Tract 77.10, Fulton County, Georgia,58,0,58,51,0,51,0,7
-1,131210078062007.000000000000000,Block 2007, Block Group 2, Census Tract 78.06, Fulton County, Georgia,58,11,47,47,0,47,0,0
-1,131210078092006.000000000000000,Block 2006, Block Group 2, Census Tract 78.09, Fulton County, Georgia,58,1,57,57,0,57,0,0
-1,131210078092007.000000000000000,Block 2007, Block Group 2, Census Tract 78.09, Fulton County, Georgia,58,7,51,50,3,45,0,1
-1,131210079002014.000000000000000,Block 2014, Block Group 2, Census Tract 79, Fulton County, Georgia,58,2,56,56,0,55,0,0
-1,131210080003006.000000000000000,Block 3006, Block Group 3, Census Tract 80, Fulton County, Georgia,58,0,58,50,6,44,0,8
-1,131210081031004.000000000000000,Block 1004, Block Group 1, Census Tract 81.03, Fulton County, Georgia,58,7,51,47,0,47,0,4
-1,131210082043014.000000000000000,Block 3014, Block Group 3, Census Tract 82.04, Fulton County, Georgia,58,1,57,56,0,56,0,1
-1,131210086013000.000000000000000,Block 3000, Block Group 3, Census Tract 86.01, Fulton County, Georgia,58,2,56,52,0,49,3,4
-1,131210089032001.000000000000000,Block 2001, Block Group 2, Census Tract 89.03, Fulton County, Georgia,58,12,46,43,21,22,0,3
-1,131210089081004.000000000000000,Block 1004, Block Group 1, Census Tract 89.08, Fulton County, Georgia,58,10,48,47,39,4,0,1
-1,131210090011006.000000000000000,Block 1006, Block Group 1, Census Tract 90.01, Fulton County, Georgia,58,14,44,42,40,0,0,2
-1,131210090021003.000000000000000,Block 1003, Block Group 1, Census Tract 90.02, Fulton County, Georgia,58,4,54,53,48,2,0,1
-1,131210097002010.000000000000000,Block 2010, Block Group 2, Census Tract 97, Fulton County, Georgia,58,2,56,56,43,5,0,0
-1,131210101062003.000000000000000,Block 2003, Block Group 2, Census Tract 101.06, Fulton County, Georgia,58,8,50,39,34,4,1,11
-1,131210101362011.000000000000000,Block 2011, Block Group 2, Census Tract 101.36, Fulton County, Georgia,58,0,58,56,51,3,0,2
-1,131210102111009.000000000000000,Block 1009, Block Group 1, Census Tract 102.11, Fulton County, Georgia,58,2,56,55,45,2,0,1
-1,131210105191045.000000000000000,Block 1045, Block Group 1, Census Tract 105.19, Fulton County, Georgia,58,19,39,39,0,39,0,0
-1,131210105202005.000000000000000,Block 2005, Block Group 2, Census Tract 105.20, Fulton County, Georgia,58,3,55,54,0,54,0,1
-1,131210105202016.000000000000000,Block 2016, Block Group 2, Census Tract 105.20, Fulton County, Georgia,58,4,54,54,0,53,1,0
-1,131210105211012.000000000000000,Block 1012, Block Group 1, Census Tract 105.21, Fulton County, Georgia,58,4,54,54,3,50,1,0
-1,131210105341009.000000000000000,Block 1009, Block Group 1, Census Tract 105.34, Fulton County, Georgia,58,7,51,43,5,34,0,8
-1,131210105401041.000000000000000,Block 1041, Block Group 1, Census Tract 105.40, Fulton County, Georgia,58,15,43,41,0,41,0,2
-1,131210106012007.000000000000000,Block 2007, Block Group 2, Census Tract 106.01, Fulton County, Georgia,58,4,54,53,1,52,0,1
-1,131210110001003.000000000000000,Block 1003, Block Group 1, Census Tract 110, Fulton County, Georgia,58,54,4,3,1,2,0,1
-1,131210110002017.000000000000000,Block 2017, Block Group 2, Census Tract 110, Fulton County, Georgia,58,18,40,40,0,40,0,0
-1,131210112022006.000000000000000,Block 2006, Block Group 2, Census Tract 112.02, Fulton County, Georgia,58,8,50,50,12,36,1,0
-1,131210112026001.000000000000000,Block 6001, Block Group 6, Census Tract 112.02, Fulton County, Georgia,58,2,56,51,2,49,0,5
-1,131210113091006.000000000000000,Block 1006, Block Group 1, Census Tract 113.09, Fulton County, Georgia,58,5,53,52,0,52,0,1
-1,131210114362004.000000000000000,Block 2004, Block Group 2, Census Tract 114.36, Fulton County, Georgia,58,2,56,43,32,8,1,13
-1,131210115053002.000000000000000,Block 3002, Block Group 3, Census Tract 115.05, Fulton County, Georgia,58,14,44,40,35,3,0,4
-1,131210115053009.000000000000000,Block 3009, Block Group 3, Census Tract 115.05, Fulton County, Georgia,58,10,48,40,30,8,1,8
-1,131210115092001.000000000000000,Block 2001, Block Group 2, Census Tract 115.09, Fulton County, Georgia,58,2,56,50,49,0,0,6
-1,131210115131002.000000000000000,Block 1002, Block Group 1, Census Tract 115.13, Fulton County, Georgia,58,3,55,53,43,1,0,2
-1,131210116384006.000000000000000,Block 4006, Block Group 4, Census Tract 116.38, Fulton County, Georgia,58,1,57,51,23,8,5,6
-1,131210116493018.000000000000000,Block 3018, Block Group 3, Census Tract 116.49, Fulton County, Georgia,58,10,48,42,9,5,2,6
-1,131210119011013.000000000000000,Block 1013, Block Group 1, Census Tract 119.01, Fulton County, Georgia,58,10,48,44,33,9,2,4
-1,131210006013000.000000000000000,Block 3000, Block Group 3, Census Tract 6.01, Fulton County, Georgia,57,4,53,47,21,11,0,6
-1,131210017022011.000000000000000,Block 2011, Block Group 2, Census Tract 17.02, Fulton County, Georgia,57,17,40,30,23,5,0,10
-1,131210024002006.000000000000000,Block 2006, Block Group 2, Census Tract 24, Fulton County, Georgia,57,0,57,56,3,53,0,1
-1,131210036002011.000000000000000,Block 2011, Block Group 2, Census Tract 36, Fulton County, Georgia,57,5,52,47,5,39,3,5
-1,131210040001004.000000000000000,Block 1004, Block Group 1, Census Tract 40, Fulton County, Georgia,57,0,57,57,1,56,0,0
-1,131210040001012.000000000000000,Block 1012, Block Group 1, Census Tract 40, Fulton County, Georgia,57,0,57,57,2,52,0,0
-1,131210049002006.000000000000000,Block 2006, Block Group 2, Census Tract 49, Fulton County, Georgia,57,2,55,51,40,11,0,4
-1,131210050001009.000000000000000,Block 1009, Block Group 1, Census Tract 50, Fulton County, Georgia,57,5,52,50,45,5,0,2
-1,131210053001003.000000000000000,Block 1003, Block Group 1, Census Tract 53, Fulton County, Georgia,57,3,54,49,43,5,1,5
-1,131210053003004.000000000000000,Block 3004, Block Group 3, Census Tract 53, Fulton County, Georgia,57,1,56,53,29,17,0,3
-1,131210055012007.000000000000000,Block 2007, Block Group 2, Census Tract 55.01, Fulton County, Georgia,57,0,57,57,33,24,0,0
-1,131210061001005.000000000000000,Block 1005, Block Group 1, Census Tract 61, Fulton County, Georgia,57,0,57,56,9,46,1,1
-1,131210065001004.000000000000000,Block 1004, Block Group 1, Census Tract 65, Fulton County, Georgia,57,2,55,53,12,41,0,2
-1,131210071001002.000000000000000,Block 1002, Block Group 1, Census Tract 71, Fulton County, Georgia,57,1,56,54,0,54,0,2
-1,131210077033018.000000000000000,Block 3018, Block Group 3, Census Tract 77.03, Fulton County, Georgia,57,0,57,48,0,47,0,9
-1,131210078061000.000000000000000,Block 1000, Block Group 1, Census Tract 78.06, Fulton County, Georgia,57,3,54,52,3,49,0,2
-1,131210078081008.000000000000000,Block 1008, Block Group 1, Census Tract 78.08, Fulton County, Georgia,57,1,56,50,0,49,0,6
-1,131210081041011.000000000000000,Block 1011, Block Group 1, Census Tract 81.04, Fulton County, Georgia,57,10,47,45,0,45,0,2
-1,131210083011009.000000000000000,Block 1009, Block Group 1, Census Tract 83.01, Fulton County, Georgia,57,0,57,54,0,54,0,3
-1,131210087011012.000000000000000,Block 1012, Block Group 1, Census Tract 87.01, Fulton County, Georgia,57,1,56,52,1,50,0,4
-1,131210088011006.000000000000000,Block 1006, Block Group 1, Census Tract 88.01, Fulton County, Georgia,57,2,55,55,32,17,0,0
-1,131210090021017.000000000000000,Block 1017, Block Group 1, Census Tract 90.02, Fulton County, Georgia,57,0,57,54,53,0,0,3
-1,131210090021018.000000000000000,Block 1018, Block Group 1, Census Tract 90.02, Fulton County, Georgia,57,5,52,49,42,0,0,3
-1,131210094111005.000000000000000,Block 1005, Block Group 1, Census Tract 94.11, Fulton County, Georgia,57,12,45,43,30,4,0,2
-1,131210095011018.000000000000000,Block 1018, Block Group 1, Census Tract 95.01, Fulton County, Georgia,57,1,56,56,54,1,0,0
-1,131210099003005.000000000000000,Block 3005, Block Group 3, Census Tract 99, Fulton County, Georgia,57,1,56,53,52,0,0,3
-1,131210100072004.000000000000000,Block 2004, Block Group 2, Census Tract 100.07, Fulton County, Georgia,57,3,54,41,35,3,0,13
-1,131210101071006.000000000000000,Block 1006, Block Group 1, Census Tract 101.07, Fulton County, Georgia,57,1,56,47,44,0,3,9
-1,131210101083005.000000000000000,Block 3005, Block Group 3, Census Tract 101.08, Fulton County, Georgia,57,9,48,45,27,14,0,3
-1,131210101362008.000000000000000,Block 2008, Block Group 2, Census Tract 101.36, Fulton County, Georgia,57,10,47,47,44,2,0,0
-1,131210101362017.000000000000000,Block 2017, Block Group 2, Census Tract 101.36, Fulton County, Georgia,57,43,14,10,0,10,0,4
-1,131210102123005.000000000000000,Block 3005, Block Group 3, Census Tract 102.12, Fulton County, Georgia,57,3,54,48,48,0,0,6
-1,131210102201010.000000000000000,Block 1010, Block Group 1, Census Tract 102.20, Fulton County, Georgia,57,3,54,52,48,0,4,2
-1,131210103073004.000000000000000,Block 3004, Block Group 3, Census Tract 103.07, Fulton County, Georgia,57,3,54,53,0,51,0,1
-1,131210103102002.000000000000000,Block 2002, Block Group 2, Census Tract 103.10, Fulton County, Georgia,57,4,53,52,0,49,2,1
-1,131210103151000.000000000000000,Block 1000, Block Group 1, Census Tract 103.15, Fulton County, Georgia,57,2,55,53,0,49,4,2
-1,131210103151012.000000000000000,Block 1012, Block Group 1, Census Tract 103.15, Fulton County, Georgia,57,1,56,55,0,55,0,1
-1,131210103152022.000000000000000,Block 2022, Block Group 2, Census Tract 103.15, Fulton County, Georgia,57,4,53,52,1,44,7,1
-1,131210104021021.000000000000000,Block 1021, Block Group 1, Census Tract 104.02, Fulton County, Georgia,57,1,56,56,56,0,0,0
-1,131210105191012.000000000000000,Block 1012, Block Group 1, Census Tract 105.19, Fulton County, Georgia,57,16,41,40,23,16,0,1
-1,131210105271010.000000000000000,Block 1010, Block Group 1, Census Tract 105.27, Fulton County, Georgia,57,4,53,51,0,51,0,2
-1,131210105292005.000000000000000,Block 2005, Block Group 2, Census Tract 105.29, Fulton County, Georgia,57,3,54,54,0,52,0,0
-1,131210105371011.000000000000000,Block 1011, Block Group 1, Census Tract 105.37, Fulton County, Georgia,57,0,57,56,0,56,0,1
-1,131210105391022.000000000000000,Block 1022, Block Group 1, Census Tract 105.39, Fulton County, Georgia,57,8,49,48,0,48,0,1
-1,131210106031001.000000000000000,Block 1001, Block Group 1, Census Tract 106.03, Fulton County, Georgia,57,2,55,54,1,53,0,1
-1,131210112041011.000000000000000,Block 1011, Block Group 1, Census Tract 112.04, Fulton County, Georgia,57,5,52,47,1,46,0,5
-1,131210114213002.000000000000000,Block 3002, Block Group 3, Census Tract 114.21, Fulton County, Georgia,57,6,51,48,25,18,0,3
-1,131210114451009.000000000000000,Block 1009, Block Group 1, Census Tract 114.45, Fulton County, Georgia,57,3,54,50,40,9,0,4
-1,131210116183006.000000000000000,Block 3006, Block Group 3, Census Tract 116.18, Fulton County, Georgia,57,6,51,49,46,0,2,2
-1,131210116372015.000000000000000,Block 2015, Block Group 2, Census Tract 116.37, Fulton County, Georgia,57,7,50,43,36,3,2,7
-1,131210116392005.000000000000000,Block 2005, Block Group 2, Census Tract 116.39, Fulton County, Georgia,57,7,50,46,31,2,1,4
-1,131210116433001.000000000000000,Block 3001, Block Group 3, Census Tract 116.43, Fulton County, Georgia,57,6,51,47,22,11,2,4
-1,131210116453005.000000000000000,Block 3005, Block Group 3, Census Tract 116.45, Fulton County, Georgia,57,11,46,34,20,8,0,12
-1,131210116503005.000000000000000,Block 3005, Block Group 3, Census Tract 116.50, Fulton County, Georgia,57,5,52,46,29,4,1,6
-1,131210116512014.000000000000000,Block 2014, Block Group 2, Census Tract 116.51, Fulton County, Georgia,57,8,49,35,20,4,2,14
-1,131210001004013.000000000000000,Block 4013, Block Group 4, Census Tract 1, Fulton County, Georgia,56,9,47,46,44,2,0,1
-1,131210013011006.000000000000000,Block 1006, Block Group 1, Census Tract 13.01, Fulton County, Georgia,56,6,50,45,40,3,1,5
-1,131210013022011.000000000000000,Block 2011, Block Group 2, Census Tract 13.02, Fulton County, Georgia,56,5,51,46,36,10,0,5
-1,131210016001002.000000000000000,Block 1002, Block Group 1, Census Tract 16, Fulton County, Georgia,56,1,55,53,45,6,0,2
-1,131210019011001.000000000000000,Block 1001, Block Group 1, Census Tract 19.01, Fulton County, Georgia,56,1,55,55,8,45,0,0
-1,131210024001003.000000000000000,Block 1003, Block Group 1, Census Tract 24, Fulton County, Georgia,56,3,53,51,2,49,0,2
-1,131210030001006.000000000000000,Block 1006, Block Group 1, Census Tract 30, Fulton County, Georgia,56,0,56,52,44,5,0,4
-1,131210049001005.000000000000000,Block 1005, Block Group 1, Census Tract 49, Fulton County, Georgia,56,13,43,39,21,18,0,4
-1,131210052003016.000000000000000,Block 3016, Block Group 3, Census Tract 52, Fulton County, Georgia,56,3,53,53,39,11,0,0
-1,131210053001014.000000000000000,Block 1014, Block Group 1, Census Tract 53, Fulton County, Georgia,56,4,52,51,45,4,0,1
-1,131210055012006.000000000000000,Block 2006, Block Group 2, Census Tract 55.01, Fulton County, Georgia,56,0,56,56,22,30,0,0
-1,131210065002021.000000000000000,Block 2021, Block Group 2, Census Tract 65, Fulton County, Georgia,56,7,49,49,3,46,0,0
-1,131210075003018.000000000000000,Block 3018, Block Group 3, Census Tract 75, Fulton County, Georgia,56,11,45,42,5,35,2,3
-1,131210077032006.000000000000000,Block 2006, Block Group 2, Census Tract 77.03, Fulton County, Georgia,56,3,53,51,4,46,1,2
-1,131210077053002.000000000000000,Block 3002, Block Group 3, Census Tract 77.05, Fulton County, Georgia,56,6,50,49,0,49,0,1
-1,131210078051029.000000000000000,Block 1029, Block Group 1, Census Tract 78.05, Fulton County, Georgia,56,4,52,52,2,46,4,0
-1,131210078072005.000000000000000,Block 2005, Block Group 2, Census Tract 78.07, Fulton County, Georgia,56,11,45,45,4,37,2,0
-1,131210078094003.000000000000000,Block 4003, Block Group 4, Census Tract 78.09, Fulton County, Georgia,56,1,55,51,2,48,0,4
-1,131210082041004.000000000000000,Block 1004, Block Group 1, Census Tract 82.04, Fulton County, Georgia,56,5,51,51,0,49,0,0
-1,131210087021011.000000000000000,Block 1011, Block Group 1, Census Tract 87.02, Fulton County, Georgia,56,1,55,52,33,18,0,3
-1,131210088011008.000000000000000,Block 1008, Block Group 1, Census Tract 88.01, Fulton County, Georgia,56,16,40,40,38,2,0,0
-1,131210089051006.000000000000000,Block 1006, Block Group 1, Census Tract 89.05, Fulton County, Georgia,56,8,48,45,38,0,1,3
-1,131210091031007.000000000000000,Block 1007, Block Group 1, Census Tract 91.03, Fulton County, Georgia,56,9,47,37,23,7,0,10
-1,131210091032003.000000000000000,Block 2003, Block Group 2, Census Tract 91.03, Fulton County, Georgia,56,9,47,40,25,4,3,7
-1,131210093012002.000000000000000,Block 2002, Block Group 2, Census Tract 93.01, Fulton County, Georgia,56,0,56,55,53,0,0,1
-1,131210094101002.000000000000000,Block 1002, Block Group 1, Census Tract 94.10, Fulton County, Georgia,56,7,49,42,32,9,0,7
-1,131210095011016.000000000000000,Block 1016, Block Group 1, Census Tract 95.01, Fulton County, Georgia,56,5,51,46,45,0,1,5
-1,131210095012005.000000000000000,Block 2005, Block Group 2, Census Tract 95.01, Fulton County, Georgia,56,0,56,56,53,0,0,0
-1,131210096012002.000000000000000,Block 2002, Block Group 2, Census Tract 96.01, Fulton County, Georgia,56,27,29,22,13,9,0,7
-1,131210096012004.000000000000000,Block 2004, Block Group 2, Census Tract 96.01, Fulton County, Georgia,56,7,49,44,34,5,5,5
-1,131210096012006.000000000000000,Block 2006, Block Group 2, Census Tract 96.01, Fulton County, Georgia,56,7,49,45,44,0,0,4
-1,131210096043006.000000000000000,Block 3006, Block Group 3, Census Tract 96.04, Fulton County, Georgia,56,8,48,39,33,1,0,9
-1,131210097002018.000000000000000,Block 2018, Block Group 2, Census Tract 97, Fulton County, Georgia,56,4,52,49,47,0,0,3
-1,131210098021018.000000000000000,Block 1018, Block Group 1, Census Tract 98.02, Fulton County, Georgia,56,0,56,55,55,0,0,1
-1,131210099001000.000000000000000,Block 1000, Block Group 1, Census Tract 99, Fulton County, Georgia,56,2,54,54,54,0,0,0
-1,131210100051021.000000000000000,Block 1021, Block Group 1, Census Tract 100.05, Fulton County, Georgia,56,0,56,51,41,2,0,5
-1,131210102201009.000000000000000,Block 1009, Block Group 1, Census Tract 102.20, Fulton County, Georgia,56,0,56,54,52,1,0,2
-1,131210103062001.000000000000000,Block 2001, Block Group 2, Census Tract 103.06, Fulton County, Georgia,56,4,52,52,0,48,4,0
-1,131210103131003.000000000000000,Block 1003, Block Group 1, Census Tract 103.13, Fulton County, Georgia,56,1,55,52,0,48,0,3
-1,131210103131006.000000000000000,Block 1006, Block Group 1, Census Tract 103.13, Fulton County, Georgia,56,1,55,54,0,48,1,1
-1,131210104021006.000000000000000,Block 1006, Block Group 1, Census Tract 104.02, Fulton County, Georgia,56,1,55,54,47,7,0,1
-1,131210105172002.000000000000000,Block 2002, Block Group 2, Census Tract 105.17, Fulton County, Georgia,56,2,54,54,2,52,0,0
-1,131210105192005.000000000000000,Block 2005, Block Group 2, Census Tract 105.19, Fulton County, Georgia,56,3,53,48,4,44,0,5
-1,131210105192007.000000000000000,Block 2007, Block Group 2, Census Tract 105.19, Fulton County, Georgia,56,0,56,56,2,49,0,0
-1,131210105223009.000000000000000,Block 3009, Block Group 3, Census Tract 105.22, Fulton County, Georgia,56,0,56,56,0,54,2,0
-1,131210105223013.000000000000000,Block 3013, Block Group 3, Census Tract 105.22, Fulton County, Georgia,56,2,54,54,3,51,0,0
-1,131210105391017.000000000000000,Block 1017, Block Group 1, Census Tract 105.39, Fulton County, Georgia,56,0,56,55,3,49,2,1
-1,131210105401022.000000000000000,Block 1022, Block Group 1, Census Tract 105.40, Fulton County, Georgia,56,10,46,46,0,41,0,0
-1,131210108021015.000000000000000,Block 1015, Block Group 1, Census Tract 108.02, Fulton County, Georgia,56,38,18,15,13,2,0,3
-1,131210108023003.000000000000000,Block 3003, Block Group 3, Census Tract 108.02, Fulton County, Georgia,56,8,48,48,14,30,0,0
-1,131210110003026.000000000000000,Block 3026, Block Group 3, Census Tract 110, Fulton County, Georgia,56,9,47,45,4,41,0,2
-1,131210112031008.000000000000000,Block 1008, Block Group 1, Census Tract 112.03, Fulton County, Georgia,56,1,55,53,14,38,0,2
-1,131210112031010.000000000000000,Block 1010, Block Group 1, Census Tract 112.03, Fulton County, Georgia,56,4,52,52,7,40,1,0
-1,131210112032006.000000000000000,Block 2006, Block Group 2, Census Tract 112.03, Fulton County, Georgia,56,1,55,54,13,41,0,1
-1,131210113102011.000000000000000,Block 2011, Block Group 2, Census Tract 113.10, Fulton County, Georgia,56,2,54,54,9,45,0,0
-1,131210114352002.000000000000000,Block 2002, Block Group 2, Census Tract 114.35, Fulton County, Georgia,56,5,51,45,36,3,0,6
-1,131210115051007.000000000000000,Block 1007, Block Group 1, Census Tract 115.05, Fulton County, Georgia,56,3,53,50,48,1,1,3
-1,131210115091001.000000000000000,Block 1001, Block Group 1, Census Tract 115.09, Fulton County, Georgia,56,0,56,55,54,0,1,1
-1,131210116311003.000000000000000,Block 1003, Block Group 1, Census Tract 116.31, Fulton County, Georgia,56,0,56,56,50,0,0,0
-1,131210116313003.000000000000000,Block 3003, Block Group 3, Census Tract 116.31, Fulton County, Georgia,56,15,41,33,18,8,1,8
-1,131210116402029.000000000000000,Block 2029, Block Group 2, Census Tract 116.40, Fulton County, Georgia,56,1,55,51,47,0,0,4
-1,131210116521029.000000000000000,Block 1029, Block Group 1, Census Tract 116.52, Fulton County, Georgia,56,6,50,46,14,9,0,4
-1,131210116531005.000000000000000,Block 1005, Block Group 1, Census Tract 116.53, Fulton County, Georgia,56,5,51,48,18,6,1,3
-1,131210116581001.000000000000000,Block 1001, Block Group 1, Census Tract 116.58, Fulton County, Georgia,56,7,49,44,3,8,0,5
-1,131210116582003.000000000000000,Block 2003, Block Group 2, Census Tract 116.58, Fulton County, Georgia,56,2,54,49,30,4,0,5
-1,131210120003037.000000000000000,Block 3037, Block Group 3, Census Tract 120, Fulton County, Georgia,56,2,54,47,3,44,0,7
-1,131210123004023.000000000000000,Block 4023, Block Group 4, Census Tract 123, Fulton County, Georgia,56,3,53,52,5,45,0,1
-1,131210001001010.000000000000000,Block 1010, Block Group 1, Census Tract 1, Fulton County, Georgia,55,2,53,53,51,0,2,0
-1,131210001003001.000000000000000,Block 3001, Block Group 3, Census Tract 1, Fulton County, Georgia,55,0,55,55,46,0,0,0
-1,131210001004017.000000000000000,Block 4017, Block Group 4, Census Tract 1, Fulton County, Georgia,55,6,49,42,26,12,2,7
-1,131210001005003.000000000000000,Block 5003, Block Group 5, Census Tract 1, Fulton County, Georgia,55,7,48,45,33,3,0,3
-1,131210005022040.000000000000000,Block 2040, Block Group 2, Census Tract 5.02, Fulton County, Georgia,55,0,55,55,54,1,0,0
-1,131210007001012.000000000000000,Block 1012, Block Group 1, Census Tract 7, Fulton County, Georgia,55,0,55,49,30,19,0,6
-1,131210012032003.000000000000000,Block 2003, Block Group 2, Census Tract 12.03, Fulton County, Georgia,55,2,53,47,35,11,0,6
-1,131210040001003.000000000000000,Block 1003, Block Group 1, Census Tract 40, Fulton County, Georgia,55,2,53,51,0,50,0,2
-1,131210042002008.000000000000000,Block 2008, Block Group 2, Census Tract 42, Fulton County, Georgia,55,2,53,48,4,41,2,5
-1,131210049001014.000000000000000,Block 1014, Block Group 1, Census Tract 49, Fulton County, Georgia,55,2,53,48,11,33,0,5
-1,131210050002018.000000000000000,Block 2018, Block Group 2, Census Tract 50, Fulton County, Georgia,55,1,54,50,41,5,0,4
-1,131210052003009.000000000000000,Block 3009, Block Group 3, Census Tract 52, Fulton County, Georgia,55,1,54,54,34,18,0,0
-1,131210052004013.000000000000000,Block 4013, Block Group 4, Census Tract 52, Fulton County, Georgia,55,5,50,46,31,11,0,4
-1,131210058001041.000000000000000,Block 1041, Block Group 1, Census Tract 58, Fulton County, Georgia,55,4,51,50,9,39,2,1
-1,131210060001007.000000000000000,Block 1007, Block Group 1, Census Tract 60, Fulton County, Georgia,55,3,52,50,15,35,0,2
-1,131210063001013.000000000000000,Block 1013, Block Group 1, Census Tract 63, Fulton County, Georgia,55,1,54,53,7,46,0,1
-1,131210063001027.000000000000000,Block 1027, Block Group 1, Census Tract 63, Fulton County, Georgia,55,1,54,50,1,49,0,4
-1,131210065001002.000000000000000,Block 1002, Block Group 1, Census Tract 65, Fulton County, Georgia,55,6,49,49,20,28,0,0
-1,131210069002012.000000000000000,Block 2012, Block Group 2, Census Tract 69, Fulton County, Georgia,55,3,52,47,10,35,0,5
-1,131210076021005.000000000000000,Block 1005, Block Group 1, Census Tract 76.02, Fulton County, Georgia,55,0,55,54,2,52,0,1
-1,131210077033008.000000000000000,Block 3008, Block Group 3, Census Tract 77.03, Fulton County, Georgia,55,0,55,50,6,44,0,5
-1,131210077053011.000000000000000,Block 3011, Block Group 3, Census Tract 77.05, Fulton County, Georgia,55,1,54,54,0,54,0,0
-1,131210078101007.000000000000000,Block 1007, Block Group 1, Census Tract 78.10, Fulton County, Georgia,55,1,54,50,3,46,1,4
-1,131210079003008.000000000000000,Block 3008, Block Group 3, Census Tract 79, Fulton County, Georgia,55,0,55,49,0,46,3,6
-1,131210080003004.000000000000000,Block 3004, Block Group 3, Census Tract 80, Fulton County, Georgia,55,2,53,49,0,48,1,4
-1,131210080004018.000000000000000,Block 4018, Block Group 4, Census Tract 80, Fulton County, Georgia,55,4,51,49,6,38,5,2
-1,131210081041008.000000000000000,Block 1008, Block Group 1, Census Tract 81.04, Fulton County, Georgia,55,0,55,53,3,50,0,2
-1,131210081041012.000000000000000,Block 1012, Block Group 1, Census Tract 81.04, Fulton County, Georgia,55,0,55,53,5,48,0,2
-1,131210083011008.000000000000000,Block 1008, Block Group 1, Census Tract 83.01, Fulton County, Georgia,55,0,55,53,0,53,0,2
-1,131210088021032.000000000000000,Block 1032, Block Group 1, Census Tract 88.02, Fulton County, Georgia,55,2,53,53,46,3,0,0
-1,131210089062002.000000000000000,Block 2002, Block Group 2, Census Tract 89.06, Fulton County, Georgia,55,5,50,47,47,0,0,3
-1,131210090021005.000000000000000,Block 1005, Block Group 1, Census Tract 90.02, Fulton County, Georgia,55,3,52,47,47,0,0,5
-1,131210091031006.000000000000000,Block 1006, Block Group 1, Census Tract 91.03, Fulton County, Georgia,55,11,44,37,28,3,0,7
-1,131210092011001.000000000000000,Block 1001, Block Group 1, Census Tract 92.01, Fulton County, Georgia,55,11,44,34,25,6,0,10
-1,131210093022000.000000000000000,Block 2000, Block Group 2, Census Tract 93.02, Fulton County, Georgia,55,3,52,52,48,1,1,0
-1,131210095041011.000000000000000,Block 1011, Block Group 1, Census Tract 95.04, Fulton County, Georgia,55,1,54,49,47,0,0,5
-1,131210096043005.000000000000000,Block 3005, Block Group 3, Census Tract 96.04, Fulton County, Georgia,55,2,53,51,49,0,2,2
-1,131210100042003.000000000000000,Block 2003, Block Group 2, Census Tract 100.04, Fulton County, Georgia,55,2,53,52,49,2,0,1
-1,131210100051012.000000000000000,Block 1012, Block Group 1, Census Tract 100.05, Fulton County, Georgia,55,3,52,52,49,2,0,0
-1,131210100051014.000000000000000,Block 1014, Block Group 1, Census Tract 100.05, Fulton County, Georgia,55,4,51,47,46,0,0,4
-1,131210100052015.000000000000000,Block 2015, Block Group 2, Census Tract 100.05, Fulton County, Georgia,55,0,55,51,50,0,0,4
-1,131210101152017.000000000000000,Block 2017, Block Group 2, Census Tract 101.15, Fulton County, Georgia,55,7,48,45,42,1,0,3
-1,131210101273006.000000000000000,Block 3006, Block Group 3, Census Tract 101.27, Fulton County, Georgia,55,1,54,49,18,16,0,5
-1,131210101281002.000000000000000,Block 1002, Block Group 1, Census Tract 101.28, Fulton County, Georgia,55,29,26,18,7,11,0,8
-1,131210101311011.000000000000000,Block 1011, Block Group 1, Census Tract 101.31, Fulton County, Georgia,55,1,54,53,45,2,0,1
-1,131210102043001.000000000000000,Block 3001, Block Group 3, Census Tract 102.04, Fulton County, Georgia,55,2,53,51,51,0,0,2
-1,131210102121004.000000000000000,Block 1004, Block Group 1, Census Tract 102.12, Fulton County, Georgia,55,12,43,43,36,5,0,0
-1,131210102172004.000000000000000,Block 2004, Block Group 2, Census Tract 102.17, Fulton County, Georgia,55,4,51,46,44,0,2,5
-1,131210103051019.000000000000000,Block 1019, Block Group 1, Census Tract 103.05, Fulton County, Georgia,55,1,54,52,0,51,1,2
-1,131210103063021.000000000000000,Block 3021, Block Group 3, Census Tract 103.06, Fulton County, Georgia,55,3,52,50,0,50,0,2
-1,131210103151004.000000000000000,Block 1004, Block Group 1, Census Tract 103.15, Fulton County, Georgia,55,1,54,54,12,36,5,0
-1,131210104023011.000000000000000,Block 3011, Block Group 3, Census Tract 104.02, Fulton County, Georgia,55,2,53,52,48,4,0,1
-1,131210105081003.000000000000000,Block 1003, Block Group 1, Census Tract 105.08, Fulton County, Georgia,55,0,55,51,0,51,0,4
-1,131210105083013.000000000000000,Block 3013, Block Group 3, Census Tract 105.08, Fulton County, Georgia,55,1,54,52,0,52,0,2
-1,131210105192016.000000000000000,Block 2016, Block Group 2, Census Tract 105.19, Fulton County, Georgia,55,3,52,51,0,51,0,1
-1,131210105223002.000000000000000,Block 3002, Block Group 3, Census Tract 105.22, Fulton County, Georgia,55,5,50,49,0,49,0,1
-1,131210105273014.000000000000000,Block 3014, Block Group 3, Census Tract 105.27, Fulton County, Georgia,55,9,46,43,10,30,1,3
-1,131210105301021.000000000000000,Block 1021, Block Group 1, Census Tract 105.30, Fulton County, Georgia,55,0,55,52,0,50,2,3
-1,131210105323011.000000000000000,Block 3011, Block Group 3, Census Tract 105.32, Fulton County, Georgia,55,1,54,52,2,43,7,2
-1,131210105343007.000000000000000,Block 3007, Block Group 3, Census Tract 105.34, Fulton County, Georgia,55,3,52,52,1,49,2,0
-1,131210105381011.000000000000000,Block 1011, Block Group 1, Census Tract 105.38, Fulton County, Georgia,55,3,52,52,0,52,0,0
-1,131210105382020.000000000000000,Block 2020, Block Group 2, Census Tract 105.38, Fulton County, Georgia,55,0,55,54,0,54,0,1
-1,131210106043013.000000000000000,Block 3013, Block Group 3, Census Tract 106.04, Fulton County, Georgia,55,3,52,45,0,42,3,7
-1,131210106043017.000000000000000,Block 3017, Block Group 3, Census Tract 106.04, Fulton County, Georgia,55,1,54,54,4,49,1,0
-1,131210108012009.000000000000000,Block 2009, Block Group 2, Census Tract 108.01, Fulton County, Georgia,55,2,53,51,42,5,4,2
-1,131210110003015.000000000000000,Block 3015, Block Group 3, Census Tract 110, Fulton County, Georgia,55,11,44,44,0,44,0,0
-1,131210113013010.000000000000000,Block 3010, Block Group 3, Census Tract 113.01, Fulton County, Georgia,55,12,43,42,13,28,0,1
-1,131210113014002.000000000000000,Block 4002, Block Group 4, Census Tract 113.01, Fulton County, Georgia,55,10,45,43,10,33,0,2
-1,131210113061010.000000000000000,Block 1010, Block Group 1, Census Tract 113.06, Fulton County, Georgia,55,8,47,39,0,38,0,8
-1,131210114302006.000000000000000,Block 2006, Block Group 2, Census Tract 114.30, Fulton County, Georgia,55,27,28,23,3,17,0,5
-1,131210114311001.000000000000000,Block 1001, Block Group 1, Census Tract 114.31, Fulton County, Georgia,55,39,16,7,5,2,0,9
-1,131210114342007.000000000000000,Block 2007, Block Group 2, Census Tract 114.34, Fulton County, Georgia,55,13,42,35,27,8,0,7
-1,131210114422006.000000000000000,Block 2006, Block Group 2, Census Tract 114.42, Fulton County, Georgia,55,0,55,47,36,9,1,8
-1,131210115121000.000000000000000,Block 1000, Block Group 1, Census Tract 115.12, Fulton County, Georgia,55,0,55,54,41,2,0,1
-1,131210116372006.000000000000000,Block 2006, Block Group 2, Census Tract 116.37, Fulton County, Georgia,55,6,49,47,24,12,2,2
-1,131210116442003.000000000000000,Block 2003, Block Group 2, Census Tract 116.44, Fulton County, Georgia,55,5,50,46,38,6,0,4
-1,131210118021010.000000000000000,Block 1010, Block Group 1, Census Tract 118.02, Fulton County, Georgia,55,0,55,54,5,49,0,1
-1,131210123002034.000000000000000,Block 2034, Block Group 2, Census Tract 123, Fulton County, Georgia,55,14,41,39,14,23,0,2
-1,131210123004029.000000000000000,Block 4029, Block Group 4, Census Tract 123, Fulton County, Georgia,55,1,54,54,7,46,0,0
-1,131210123004030.000000000000000,Block 4030, Block Group 4, Census Tract 123, Fulton County, Georgia,55,2,53,52,12,40,0,1
-1,131210005021008.000000000000000,Block 1008, Block Group 1, Census Tract 5.02, Fulton County, Georgia,54,1,53,52,51,0,0,1
-1,131210014003001.000000000000000,Block 3001, Block Group 3, Census Tract 14, Fulton County, Georgia,54,3,51,48,41,5,0,3
-1,131210035001014.000000000000000,Block 1014, Block Group 1, Census Tract 35, Fulton County, Georgia,54,7,47,45,4,32,0,2
-1,131210035002013.000000000000000,Block 2013, Block Group 2, Census Tract 35, Fulton County, Georgia,54,7,47,42,13,27,0,5
-1,131210039002005.000000000000000,Block 2005, Block Group 2, Census Tract 39, Fulton County, Georgia,54,0,54,52,0,52,0,2
-1,131210041003001.000000000000000,Block 3001, Block Group 3, Census Tract 41, Fulton County, Georgia,54,2,52,45,5,39,0,7
-1,131210044002012.000000000000000,Block 2012, Block Group 2, Census Tract 44, Fulton County, Georgia,54,0,54,54,6,48,0,0
-1,131210049001009.000000000000000,Block 1009, Block Group 1, Census Tract 49, Fulton County, Georgia,54,3,51,51,9,37,0,0
-1,131210049002012.000000000000000,Block 2012, Block Group 2, Census Tract 49, Fulton County, Georgia,54,4,50,37,32,5,0,13
-1,131210050001005.000000000000000,Block 1005, Block Group 1, Census Tract 50, Fulton County, Georgia,54,2,52,49,40,9,0,3
-1,131210052001006.000000000000000,Block 1006, Block Group 1, Census Tract 52, Fulton County, Georgia,54,14,40,38,32,5,0,2
-1,131210053001021.000000000000000,Block 1021, Block Group 1, Census Tract 53, Fulton County, Georgia,54,1,53,52,41,11,0,1
-1,131210060004010.000000000000000,Block 4010, Block Group 4, Census Tract 60, Fulton County, Georgia,54,0,54,53,10,41,0,1
-1,131210064001006.000000000000000,Block 1006, Block Group 1, Census Tract 64, Fulton County, Georgia,54,0,54,53,8,45,0,1
-1,131210069001000.000000000000000,Block 1000, Block Group 1, Census Tract 69, Fulton County, Georgia,54,6,48,43,24,18,0,5
-1,131210072001004.000000000000000,Block 1004, Block Group 1, Census Tract 72, Fulton County, Georgia,54,12,42,41,2,39,0,1
-1,131210073011008.000000000000000,Block 1008, Block Group 1, Census Tract 73.01, Fulton County, Georgia,54,2,52,49,2,47,0,3
-1,131210076023002.000000000000000,Block 3002, Block Group 3, Census Tract 76.02, Fulton County, Georgia,54,0,54,51,0,51,0,3
-1,131210076033022.000000000000000,Block 3022, Block Group 3, Census Tract 76.03, Fulton County, Georgia,54,8,46,43,0,42,0,3
-1,131210077071000.000000000000000,Block 1000, Block Group 1, Census Tract 77.07, Fulton County, Georgia,54,0,54,52,0,47,3,2
-1,131210077082013.000000000000000,Block 2013, Block Group 2, Census Tract 77.08, Fulton County, Georgia,54,4,50,44,2,42,0,6
-1,131210078061010.000000000000000,Block 1010, Block Group 1, Census Tract 78.06, Fulton County, Georgia,54,2,52,52,0,52,0,0
-1,131210078092015.000000000000000,Block 2015, Block Group 2, Census Tract 78.09, Fulton County, Georgia,54,0,54,51,0,50,0,3
-1,131210080004021.000000000000000,Block 4021, Block Group 4, Census Tract 80, Fulton County, Georgia,54,0,54,51,7,43,0,3
-1,131210081041018.000000000000000,Block 1018, Block Group 1, Census Tract 81.04, Fulton County, Georgia,54,3,51,50,1,49,0,1
-1,131210087011020.000000000000000,Block 1020, Block Group 1, Census Tract 87.01, Fulton County, Georgia,54,1,53,50,5,44,1,3
-1,131210087013005.000000000000000,Block 3005, Block Group 3, Census Tract 87.01, Fulton County, Georgia,54,8,46,45,3,40,0,1
-1,131210089062013.000000000000000,Block 2013, Block Group 2, Census Tract 89.06, Fulton County, Georgia,54,6,48,46,32,12,0,2
-1,131210089091006.000000000000000,Block 1006, Block Group 1, Census Tract 89.09, Fulton County, Georgia,54,0,54,50,42,8,0,4
-1,131210092011005.000000000000000,Block 1005, Block Group 1, Census Tract 92.01, Fulton County, Georgia,54,8,46,46,30,12,3,0
-1,131210095041004.000000000000000,Block 1004, Block Group 1, Census Tract 95.04, Fulton County, Georgia,54,1,53,53,52,1,0,0
-1,131210098041016.000000000000000,Block 1016, Block Group 1, Census Tract 98.04, Fulton County, Georgia,54,0,54,54,52,2,0,0
-1,131210099003001.000000000000000,Block 3001, Block Group 3, Census Tract 99, Fulton County, Georgia,54,0,54,54,53,0,0,0
-1,131210102162013.000000000000000,Block 2013, Block Group 2, Census Tract 102.16, Fulton County, Georgia,54,14,40,27,24,0,2,13
-1,131210102211003.000000000000000,Block 1003, Block Group 1, Census Tract 102.21, Fulton County, Georgia,54,3,51,39,31,3,4,12
-1,131210103131001.000000000000000,Block 1001, Block Group 1, Census Tract 103.13, Fulton County, Georgia,54,4,50,50,0,50,0,0
-1,131210103141002.000000000000000,Block 1002, Block Group 1, Census Tract 103.14, Fulton County, Georgia,54,3,51,48,0,47,1,3
-1,131210104023060.000000000000000,Block 3060, Block Group 3, Census Tract 104.02, Fulton County, Georgia,54,2,52,52,47,5,0,0
-1,131210105191019.000000000000000,Block 1019, Block Group 1, Census Tract 105.19, Fulton County, Georgia,54,27,27,27,15,9,0,0
-1,131210105192002.000000000000000,Block 2002, Block Group 2, Census Tract 105.19, Fulton County, Georgia,54,1,53,53,0,53,0,0
-1,131210105272007.000000000000000,Block 2007, Block Group 2, Census Tract 105.27, Fulton County, Georgia,54,6,48,44,1,43,0,4
-1,131210105292021.000000000000000,Block 2021, Block Group 2, Census Tract 105.29, Fulton County, Georgia,54,1,53,53,2,51,0,0
-1,131210105293018.000000000000000,Block 3018, Block Group 3, Census Tract 105.29, Fulton County, Georgia,54,3,51,48,1,47,0,3
-1,131210111001022.000000000000000,Block 1022, Block Group 1, Census Tract 111, Fulton County, Georgia,54,2,52,49,15,26,0,3
-1,131210111002011.000000000000000,Block 2011, Block Group 2, Census Tract 111, Fulton County, Georgia,54,3,51,49,28,20,0,2
-1,131210113011009.000000000000000,Block 1009, Block Group 1, Census Tract 113.01, Fulton County, Georgia,54,8,46,45,6,39,0,1
-1,131210113011010.000000000000000,Block 1010, Block Group 1, Census Tract 113.01, Fulton County, Georgia,54,3,51,50,9,41,0,1
-1,131210113016008.000000000000000,Block 6008, Block Group 6, Census Tract 113.01, Fulton County, Georgia,54,6,48,47,5,42,0,1
-1,131210113072008.000000000000000,Block 2008, Block Group 2, Census Tract 113.07, Fulton County, Georgia,54,3,51,51,0,47,0,0
-1,131210113102004.000000000000000,Block 2004, Block Group 2, Census Tract 113.10, Fulton County, Georgia,54,9,45,45,4,37,4,0
-1,131210114164007.000000000000000,Block 4007, Block Group 4, Census Tract 114.16, Fulton County, Georgia,54,2,52,48,43,3,0,4
-1,131210115073006.000000000000000,Block 3006, Block Group 3, Census Tract 115.07, Fulton County, Georgia,54,6,48,46,37,8,0,2
-1,131210116402034.000000000000000,Block 2034, Block Group 2, Census Tract 116.40, Fulton County, Georgia,54,2,52,51,47,0,0,1
-1,131210116441004.000000000000000,Block 1004, Block Group 1, Census Tract 116.44, Fulton County, Georgia,54,8,46,42,28,14,0,4
-1,131210116441007.000000000000000,Block 1007, Block Group 1, Census Tract 116.44, Fulton County, Georgia,54,11,43,37,2,29,0,6
-1,131210116552004.000000000000000,Block 2004, Block Group 2, Census Tract 116.55, Fulton County, Georgia,54,8,46,46,42,4,0,0
-1,131210119013004.000000000000000,Block 3004, Block Group 3, Census Tract 119.01, Fulton County, Georgia,54,1,53,48,19,26,1,5
-1,131210001005000.000000000000000,Block 5000, Block Group 5, Census Tract 1, Fulton County, Georgia,53,10,43,42,31,7,0,1
-1,131210002012014.000000000000000,Block 2014, Block Group 2, Census Tract 2.01, Fulton County, Georgia,53,0,53,52,47,4,1,1
-1,131210005022029.000000000000000,Block 2029, Block Group 2, Census Tract 5.02, Fulton County, Georgia,53,0,53,52,47,4,0,1
-1,131210006013009.000000000000000,Block 3009, Block Group 3, Census Tract 6.01, Fulton County, Georgia,53,4,49,46,31,4,0,3
-1,131210014002007.000000000000000,Block 2007, Block Group 2, Census Tract 14, Fulton County, Georgia,53,0,53,48,46,0,0,5
-1,131210018011003.000000000000000,Block 1003, Block Group 1, Census Tract 18.01, Fulton County, Georgia,53,10,43,42,7,34,0,1
-1,131210030002002.000000000000000,Block 2002, Block Group 2, Census Tract 30, Fulton County, Georgia,53,4,49,45,35,0,1,4
-1,131210031001012.000000000000000,Block 1012, Block Group 1, Census Tract 31, Fulton County, Georgia,53,3,50,47,29,18,0,3
-1,131210042002007.000000000000000,Block 2007, Block Group 2, Census Tract 42, Fulton County, Georgia,53,1,52,50,3,47,0,2
-1,131210044002017.000000000000000,Block 2017, Block Group 2, Census Tract 44, Fulton County, Georgia,53,1,52,50,2,48,0,2
-1,131210052001002.000000000000000,Block 1002, Block Group 1, Census Tract 52, Fulton County, Georgia,53,2,51,50,46,1,0,1
-1,131210052001016.000000000000000,Block 1016, Block Group 1, Census Tract 52, Fulton County, Georgia,53,13,40,38,36,0,0,2
-1,131210052002012.000000000000000,Block 2012, Block Group 2, Census Tract 52, Fulton County, Georgia,53,7,46,44,40,4,0,2
-1,131210052003013.000000000000000,Block 3013, Block Group 3, Census Tract 52, Fulton County, Georgia,53,0,53,48,47,0,1,5
-1,131210052004006.000000000000000,Block 4006, Block Group 4, Census Tract 52, Fulton County, Georgia,53,5,48,45,29,15,0,3
-1,131210052004009.000000000000000,Block 4009, Block Group 4, Census Tract 52, Fulton County, Georgia,53,6,47,39,24,12,0,8
-1,131210053001009.000000000000000,Block 1009, Block Group 1, Census Tract 53, Fulton County, Georgia,53,3,50,47,42,0,0,3
-1,131210055011012.000000000000000,Block 1012, Block Group 1, Census Tract 55.01, Fulton County, Georgia,53,6,47,38,19,8,1,9
-1,131210055012013.000000000000000,Block 2013, Block Group 2, Census Tract 55.01, Fulton County, Georgia,53,3,50,47,0,46,0,3
-1,131210060002004.000000000000000,Block 2004, Block Group 2, Census Tract 60, Fulton County, Georgia,53,0,53,49,7,41,0,4
-1,131210060003003.000000000000000,Block 3003, Block Group 3, Census Tract 60, Fulton County, Georgia,53,3,50,50,11,39,0,0
-1,131210061003013.000000000000000,Block 3013, Block Group 3, Census Tract 61, Fulton County, Georgia,53,1,52,50,10,38,0,2
-1,131210067012003.000000000000000,Block 2003, Block Group 2, Census Tract 67.01, Fulton County, Georgia,53,3,50,50,5,43,1,0
-1,131210070014009.000000000000000,Block 4009, Block Group 4, Census Tract 70.01, Fulton County, Georgia,53,5,48,44,1,43,0,4
-1,131210073022014.000000000000000,Block 2014, Block Group 2, Census Tract 73.02, Fulton County, Georgia,53,3,50,50,0,50,0,0
-1,131210075001005.000000000000000,Block 1005, Block Group 1, Census Tract 75, Fulton County, Georgia,53,1,52,51,2,48,1,1
-1,131210076042003.000000000000000,Block 2003, Block Group 2, Census Tract 76.04, Fulton County, Georgia,53,3,50,50,0,49,1,0
-1,131210077072016.000000000000000,Block 2016, Block Group 2, Census Tract 77.07, Fulton County, Georgia,53,1,52,51,1,50,0,1
-1,131210077112009.000000000000000,Block 2009, Block Group 2, Census Tract 77.11, Fulton County, Georgia,53,1,52,51,1,49,0,1
-1,131210078082006.000000000000000,Block 2006, Block Group 2, Census Tract 78.08, Fulton County, Georgia,53,4,49,44,5,37,2,5
-1,131210079004005.000000000000000,Block 4005, Block Group 4, Census Tract 79, Fulton County, Georgia,53,1,52,51,0,49,0,1
-1,131210080004014.000000000000000,Block 4014, Block Group 4, Census Tract 80, Fulton County, Georgia,53,5,48,47,4,43,0,1
-1,131210081041006.000000000000000,Block 1006, Block Group 1, Census Tract 81.04, Fulton County, Georgia,53,2,51,51,4,47,0,0
-1,131210081043000.000000000000000,Block 3000, Block Group 3, Census Tract 81.04, Fulton County, Georgia,53,7,46,45,3,42,0,1
-1,131210081043005.000000000000000,Block 3005, Block Group 3, Census Tract 81.04, Fulton County, Georgia,53,2,51,50,1,49,0,1
-1,131210082041001.000000000000000,Block 1001, Block Group 1, Census Tract 82.04, Fulton County, Georgia,53,0,53,52,0,52,0,1
-1,131210083011017.000000000000000,Block 1017, Block Group 1, Census Tract 83.01, Fulton County, Georgia,53,2,51,51,7,44,0,0
-1,131210083021012.000000000000000,Block 1012, Block Group 1, Census Tract 83.02, Fulton County, Georgia,53,1,52,48,4,44,0,4
-1,131210088011019.000000000000000,Block 1019, Block Group 1, Census Tract 88.01, Fulton County, Georgia,53,6,47,40,34,6,0,7
-1,131210088011021.000000000000000,Block 1021, Block Group 1, Census Tract 88.01, Fulton County, Georgia,53,5,48,45,38,7,0,3
-1,131210089072003.000000000000000,Block 2003, Block Group 2, Census Tract 89.07, Fulton County, Georgia,53,10,43,40,25,12,3,3
-1,131210090022008.000000000000000,Block 2008, Block Group 2, Census Tract 90.02, Fulton County, Georgia,53,0,53,53,53,0,0,0
-1,131210092021004.000000000000000,Block 1004, Block Group 1, Census Tract 92.02, Fulton County, Georgia,53,4,49,43,40,3,0,6
-1,131210097002020.000000000000000,Block 2020, Block Group 2, Census Tract 97, Fulton County, Georgia,53,4,49,49,43,0,1,0
-1,131210099002001.000000000000000,Block 2001, Block Group 2, Census Tract 99, Fulton County, Georgia,53,0,53,47,39,0,2,6
-1,131210099003007.000000000000000,Block 3007, Block Group 3, Census Tract 99, Fulton County, Georgia,53,2,51,49,48,0,0,2
-1,131210101064007.000000000000000,Block 4007, Block Group 4, Census Tract 101.06, Fulton County, Georgia,53,0,53,50,48,0,1,3
-1,131210101082006.000000000000000,Block 2006, Block Group 2, Census Tract 101.08, Fulton County, Georgia,53,0,53,48,44,1,0,5
-1,131210101272001.000000000000000,Block 2001, Block Group 2, Census Tract 101.27, Fulton County, Georgia,53,8,45,45,39,3,0,0
-1,131210101362003.000000000000000,Block 2003, Block Group 2, Census Tract 101.36, Fulton County, Georgia,53,13,40,37,33,3,1,3
-1,131210102114005.000000000000000,Block 4005, Block Group 4, Census Tract 102.11, Fulton County, Georgia,53,1,52,50,45,0,0,2
-1,131210102201013.000000000000000,Block 1013, Block Group 1, Census Tract 102.20, Fulton County, Georgia,53,4,49,39,35,4,0,10
-1,131210102221009.000000000000000,Block 1009, Block Group 1, Census Tract 102.22, Fulton County, Georgia,53,3,50,50,44,2,1,0
-1,131210103083014.000000000000000,Block 3014, Block Group 3, Census Tract 103.08, Fulton County, Georgia,53,6,47,44,4,40,0,3
-1,131210103091015.000000000000000,Block 1015, Block Group 1, Census Tract 103.09, Fulton County, Georgia,53,12,41,35,25,9,0,6
-1,131210103092014.000000000000000,Block 2014, Block Group 2, Census Tract 103.09, Fulton County, Georgia,53,3,50,50,2,48,0,0
-1,131210103092020.000000000000000,Block 2020, Block Group 2, Census Tract 103.09, Fulton County, Georgia,53,3,50,50,0,48,0,0
-1,131210103151015.000000000000000,Block 1015, Block Group 1, Census Tract 103.15, Fulton County, Georgia,53,2,51,45,3,40,0,6
-1,131210105081007.000000000000000,Block 1007, Block Group 1, Census Tract 105.08, Fulton County, Georgia,53,2,51,50,0,49,0,1
-1,131210105192008.000000000000000,Block 2008, Block Group 2, Census Tract 105.19, Fulton County, Georgia,53,3,50,49,0,47,0,1
-1,131210105231019.000000000000000,Block 1019, Block Group 1, Census Tract 105.23, Fulton County, Georgia,53,3,50,47,0,38,6,3
-1,131210105371012.000000000000000,Block 1012, Block Group 1, Census Tract 105.37, Fulton County, Georgia,53,2,51,46,0,46,0,5
-1,131210105391007.000000000000000,Block 1007, Block Group 1, Census Tract 105.39, Fulton County, Georgia,53,7,46,45,0,45,0,1
-1,131210106011000.000000000000000,Block 1000, Block Group 1, Census Tract 106.01, Fulton County, Georgia,53,5,48,48,21,27,0,0
-1,131210108021003.000000000000000,Block 1003, Block Group 1, Census Tract 108.02, Fulton County, Georgia,53,22,31,31,8,19,1,0
-1,131210110001008.000000000000000,Block 1008, Block Group 1, Census Tract 110, Fulton County, Georgia,53,8,45,45,0,39,4,0
-1,131210110003022.000000000000000,Block 3022, Block Group 3, Census Tract 110, Fulton County, Georgia,53,5,48,48,3,45,0,0
-1,131210111003006.000000000000000,Block 3006, Block Group 3, Census Tract 111, Fulton County, Georgia,53,4,49,47,17,29,0,2
-1,131210112024006.000000000000000,Block 4006, Block Group 4, Census Tract 112.02, Fulton County, Georgia,53,2,51,49,23,26,0,2
-1,131210112041007.000000000000000,Block 1007, Block Group 1, Census Tract 112.04, Fulton County, Georgia,53,1,52,46,0,44,0,6
-1,131210113073006.000000000000000,Block 3006, Block Group 3, Census Tract 113.07, Fulton County, Georgia,53,3,50,43,6,35,0,7
-1,131210113093004.000000000000000,Block 3004, Block Group 3, Census Tract 113.09, Fulton County, Georgia,53,2,51,45,6,39,0,6
-1,131210114301012.000000000000000,Block 1012, Block Group 1, Census Tract 114.30, Fulton County, Georgia,53,38,15,8,4,4,0,7
-1,131210114463002.000000000000000,Block 3002, Block Group 3, Census Tract 114.46, Fulton County, Georgia,53,7,46,42,35,5,0,4
-1,131210115081005.000000000000000,Block 1005, Block Group 1, Census Tract 115.08, Fulton County, Georgia,53,2,51,50,41,9,0,1
-1,131210115101028.000000000000000,Block 1028, Block Group 1, Census Tract 115.10, Fulton County, Georgia,53,1,52,43,25,6,1,9
-1,131210116402004.000000000000000,Block 2004, Block Group 2, Census Tract 116.40, Fulton County, Georgia,53,6,47,43,28,11,1,4
-1,131210116493016.000000000000000,Block 3016, Block Group 3, Census Tract 116.49, Fulton County, Georgia,53,5,48,47,6,3,1,1
-1,131210116581005.000000000000000,Block 1005, Block Group 1, Census Tract 116.58, Fulton County, Georgia,53,5,48,43,5,10,2,5
-1,131210013011002.000000000000000,Block 1002, Block Group 1, Census Tract 13.01, Fulton County, Georgia,52,12,40,35,30,5,0,5
-1,131210017011000.000000000000000,Block 1000, Block Group 1, Census Tract 17.01, Fulton County, Georgia,52,1,51,46,25,21,0,5
-1,131210018022002.000000000000000,Block 2002, Block Group 2, Census Tract 18.02, Fulton County, Georgia,52,8,44,38,24,13,0,6
-1,131210021003002.000000000000000,Block 3002, Block Group 3, Census Tract 21, Fulton County, Georgia,52,4,48,39,10,27,0,9
-1,131210030002009.000000000000000,Block 2009, Block Group 2, Census Tract 30, Fulton County, Georgia,52,6,46,44,38,4,0,2
-1,131210032001014.000000000000000,Block 1014, Block Group 1, Census Tract 32, Fulton County, Georgia,52,5,47,41,38,3,0,6
-1,131210038001010.000000000000000,Block 1010, Block Group 1, Census Tract 38, Fulton County, Georgia,52,3,49,48,1,46,1,1
-1,131210039001002.000000000000000,Block 1002, Block Group 1, Census Tract 39, Fulton County, Georgia,52,0,52,52,4,48,0,0
-1,131210040002002.000000000000000,Block 2002, Block Group 2, Census Tract 40, Fulton County, Georgia,52,0,52,50,0,50,0,2
-1,131210052002013.000000000000000,Block 2013, Block Group 2, Census Tract 52, Fulton County, Georgia,52,2,50,50,33,17,0,0
-1,131210053002029.000000000000000,Block 2029, Block Group 2, Census Tract 53, Fulton County, Georgia,52,6,46,42,38,1,1,4
-1,131210060003004.000000000000000,Block 3004, Block Group 3, Census Tract 60, Fulton County, Georgia,52,2,50,49,9,40,0,1
-1,131210061002003.000000000000000,Block 2003, Block Group 2, Census Tract 61, Fulton County, Georgia,52,0,52,52,3,49,0,0
-1,131210065004018.000000000000000,Block 4018, Block Group 4, Census Tract 65, Fulton County, Georgia,52,1,51,50,12,36,0,1
-1,131210066011012.000000000000000,Block 1012, Block Group 1, Census Tract 66.01, Fulton County, Georgia,52,1,51,49,1,48,0,2
-1,131210066012014.000000000000000,Block 2014, Block Group 2, Census Tract 66.01, Fulton County, Georgia,52,2,50,50,1,48,0,0
-1,131210069002005.000000000000000,Block 2005, Block Group 2, Census Tract 69, Fulton County, Georgia,52,15,37,33,21,11,0,4
-1,131210070011005.000000000000000,Block 1005, Block Group 1, Census Tract 70.01, Fulton County, Georgia,52,8,44,44,0,44,0,0
-1,131210071002002.000000000000000,Block 2002, Block Group 2, Census Tract 71, Fulton County, Georgia,52,9,43,42,0,42,0,1
-1,131210075003017.000000000000000,Block 3017, Block Group 3, Census Tract 75, Fulton County, Georgia,52,4,48,48,1,47,0,0
-1,131210076033021.000000000000000,Block 3021, Block Group 3, Census Tract 76.03, Fulton County, Georgia,52,0,52,50,0,49,1,2
-1,131210077032002.000000000000000,Block 2002, Block Group 2, Census Tract 77.03, Fulton County, Georgia,52,5,47,46,0,46,0,1
-1,131210077071005.000000000000000,Block 1005, Block Group 1, Census Tract 77.07, Fulton County, Georgia,52,2,50,48,1,46,0,2
-1,131210078073002.000000000000000,Block 3002, Block Group 3, Census Tract 78.07, Fulton County, Georgia,52,7,45,34,0,34,0,11
-1,131210078073004.000000000000000,Block 3004, Block Group 3, Census Tract 78.07, Fulton County, Georgia,52,5,47,46,0,44,0,1
-1,131210078092010.000000000000000,Block 2010, Block Group 2, Census Tract 78.09, Fulton County, Georgia,52,2,50,49,0,49,0,1
-1,131210078102005.000000000000000,Block 2005, Block Group 2, Census Tract 78.10, Fulton County, Georgia,52,0,52,50,0,46,3,2
-1,131210080003007.000000000000000,Block 3007, Block Group 3, Census Tract 80, Fulton County, Georgia,52,2,50,45,1,44,0,5
-1,131210083012010.000000000000000,Block 2010, Block Group 2, Census Tract 83.01, Fulton County, Georgia,52,2,50,49,1,46,0,1
-1,131210085003002.000000000000000,Block 3002, Block Group 3, Census Tract 85, Fulton County, Georgia,52,4,48,47,3,41,0,1
-1,131210085003027.000000000000000,Block 3027, Block Group 3, Census Tract 85, Fulton County, Georgia,52,3,49,49,12,34,1,0
-1,131210087012003.000000000000000,Block 2003, Block Group 2, Census Tract 87.01, Fulton County, Georgia,52,2,50,47,1,42,0,3
-1,131210088022019.000000000000000,Block 2019, Block Group 2, Census Tract 88.02, Fulton County, Georgia,52,0,52,47,43,0,0,5
-1,131210090021016.000000000000000,Block 1016, Block Group 1, Census Tract 90.02, Fulton County, Georgia,52,1,51,45,42,3,0,6
-1,131210093012010.000000000000000,Block 2010, Block Group 2, Census Tract 93.01, Fulton County, Georgia,52,2,50,47,47,0,0,3
-1,131210097003017.000000000000000,Block 3017, Block Group 3, Census Tract 97, Fulton County, Georgia,52,4,48,48,41,4,2,0
-1,131210099001005.000000000000000,Block 1005, Block Group 1, Census Tract 99, Fulton County, Georgia,52,0,52,48,47,1,0,4
-1,131210101082005.000000000000000,Block 2005, Block Group 2, Census Tract 101.08, Fulton County, Georgia,52,1,51,48,36,6,0,3
-1,131210101172004.000000000000000,Block 2004, Block Group 2, Census Tract 101.17, Fulton County, Georgia,52,11,41,21,11,8,2,20
-1,131210101304000.000000000000000,Block 4000, Block Group 4, Census Tract 101.30, Fulton County, Georgia,52,6,46,43,38,3,0,3
-1,131210101304003.000000000000000,Block 4003, Block Group 4, Census Tract 101.30, Fulton County, Georgia,52,8,44,44,36,1,0,0
-1,131210102222008.000000000000000,Block 2008, Block Group 2, Census Tract 102.22, Fulton County, Georgia,52,6,46,41,33,1,0,5
-1,131210103052006.000000000000000,Block 2006, Block Group 2, Census Tract 103.05, Fulton County, Georgia,52,3,49,48,0,48,0,1
-1,131210103101008.000000000000000,Block 1008, Block Group 1, Census Tract 103.10, Fulton County, Georgia,52,1,51,51,0,50,1,0
-1,131210103112011.000000000000000,Block 2011, Block Group 2, Census Tract 103.11, Fulton County, Georgia,52,1,51,50,0,46,4,1
-1,131210104021052.000000000000000,Block 1052, Block Group 1, Census Tract 104.02, Fulton County, Georgia,52,4,48,43,43,0,0,5
-1,131210105082006.000000000000000,Block 2006, Block Group 2, Census Tract 105.08, Fulton County, Georgia,52,2,50,50,1,47,2,0
-1,131210105083014.000000000000000,Block 3014, Block Group 3, Census Tract 105.08, Fulton County, Georgia,52,0,52,51,7,43,0,1
-1,131210105181005.000000000000000,Block 1005, Block Group 1, Census Tract 105.18, Fulton County, Georgia,52,0,52,51,0,49,0,1
-1,131210105182003.000000000000000,Block 2003, Block Group 2, Census Tract 105.18, Fulton County, Georgia,52,3,49,48,0,48,0,1
-1,131210105192010.000000000000000,Block 2010, Block Group 2, Census Tract 105.19, Fulton County, Georgia,52,2,50,47,5,40,0,3
-1,131210105223003.000000000000000,Block 3003, Block Group 3, Census Tract 105.22, Fulton County, Georgia,52,1,51,51,0,32,3,0
-1,131210105272001.000000000000000,Block 2001, Block Group 2, Census Tract 105.27, Fulton County, Georgia,52,3,49,48,0,48,0,1
-1,131210106031012.000000000000000,Block 1012, Block Group 1, Census Tract 106.03, Fulton County, Georgia,52,8,44,41,0,41,0,3
-1,131210106043001.000000000000000,Block 3001, Block Group 3, Census Tract 106.04, Fulton County, Georgia,52,6,46,45,0,44,1,1
-1,131210108012016.000000000000000,Block 2016, Block Group 2, Census Tract 108.01, Fulton County, Georgia,52,5,47,44,10,34,0,3
-1,131210108024015.000000000000000,Block 4015, Block Group 4, Census Tract 108.02, Fulton County, Georgia,52,24,28,28,19,8,0,0
-1,131210111002019.000000000000000,Block 2019, Block Group 2, Census Tract 111, Fulton County, Georgia,52,1,51,50,19,31,0,1
-1,131210111003009.000000000000000,Block 3009, Block Group 3, Census Tract 111, Fulton County, Georgia,52,22,30,30,8,21,1,0
-1,131210112024002.000000000000000,Block 4002, Block Group 4, Census Tract 112.02, Fulton County, Georgia,52,11,41,37,19,17,1,4
-1,131210112031005.000000000000000,Block 1005, Block Group 1, Census Tract 112.03, Fulton County, Georgia,52,9,43,41,11,30,0,2
-1,131210112031019.000000000000000,Block 1019, Block Group 1, Census Tract 112.03, Fulton County, Georgia,52,10,42,42,24,17,0,0
-1,131210113073002.000000000000000,Block 3002, Block Group 3, Census Tract 113.07, Fulton County, Georgia,52,1,51,49,7,41,0,2
-1,131210113073003.000000000000000,Block 3003, Block Group 3, Census Tract 113.07, Fulton County, Georgia,52,3,49,43,1,42,0,6
-1,131210113105001.000000000000000,Block 5001, Block Group 5, Census Tract 113.10, Fulton County, Georgia,52,10,42,42,0,41,1,0
-1,131210114163005.000000000000000,Block 3005, Block Group 3, Census Tract 114.16, Fulton County, Georgia,52,6,46,44,19,5,0,2
-1,131210114174005.000000000000000,Block 4005, Block Group 4, Census Tract 114.17, Fulton County, Georgia,52,1,51,46,44,0,2,5
-1,131210114383004.000000000000000,Block 3004, Block Group 3, Census Tract 114.38, Fulton County, Georgia,52,11,41,26,16,5,1,15
-1,131210114442001.000000000000000,Block 2001, Block Group 2, Census Tract 114.44, Fulton County, Georgia,52,5,47,43,30,5,0,4
-1,131210115112000.000000000000000,Block 2000, Block Group 2, Census Tract 115.11, Fulton County, Georgia,52,2,50,49,48,1,0,1
-1,131210116181003.000000000000000,Block 1003, Block Group 1, Census Tract 116.18, Fulton County, Georgia,52,4,48,41,20,9,3,7
-1,131210116353016.000000000000000,Block 3016, Block Group 3, Census Tract 116.35, Fulton County, Georgia,52,5,47,47,28,0,0,0
-1,131210116472012.000000000000000,Block 2012, Block Group 2, Census Tract 116.47, Fulton County, Georgia,52,15,37,34,26,7,0,3
-1,131210116512012.000000000000000,Block 2012, Block Group 2, Census Tract 116.51, Fulton County, Georgia,52,7,45,38,14,2,0,7
-1,131210120001015.000000000000000,Block 1015, Block Group 1, Census Tract 120, Fulton County, Georgia,52,2,50,50,6,44,0,0
-1,131210002022003.000000000000000,Block 2003, Block Group 2, Census Tract 2.02, Fulton County, Georgia,51,5,46,40,33,4,0,6
-1,131210006013008.000000000000000,Block 3008, Block Group 3, Census Tract 6.01, Fulton County, Georgia,51,5,46,46,30,3,1,0
-1,131210012032001.000000000000000,Block 2001, Block Group 2, Census Tract 12.03, Fulton County, Georgia,51,2,49,45,38,0,2,4
-1,131210015021011.000000000000000,Block 1011, Block Group 1, Census Tract 15.02, Fulton County, Georgia,51,8,43,40,38,0,0,3
-1,131210042002004.000000000000000,Block 2004, Block Group 2, Census Tract 42, Fulton County, Georgia,51,0,51,51,15,35,0,0
-1,131210049001013.000000000000000,Block 1013, Block Group 1, Census Tract 49, Fulton County, Georgia,51,0,51,49,18,31,0,2
-1,131210049002010.000000000000000,Block 2010, Block Group 2, Census Tract 49, Fulton County, Georgia,51,11,40,39,34,0,0,1
-1,131210049002019.000000000000000,Block 2019, Block Group 2, Census Tract 49, Fulton County, Georgia,51,1,50,45,29,3,4,5
-1,131210050002019.000000000000000,Block 2019, Block Group 2, Census Tract 50, Fulton County, Georgia,51,5,46,43,36,0,2,3
-1,131210052003007.000000000000000,Block 3007, Block Group 3, Census Tract 52, Fulton County, Georgia,51,6,45,45,33,9,0,0
-1,131210060004003.000000000000000,Block 4003, Block Group 4, Census Tract 60, Fulton County, Georgia,51,0,51,50,2,48,0,1
-1,131210061002009.000000000000000,Block 2009, Block Group 2, Census Tract 61, Fulton County, Georgia,51,1,50,46,3,43,0,4
-1,131210061003012.000000000000000,Block 3012, Block Group 3, Census Tract 61, Fulton County, Georgia,51,0,51,51,2,49,0,0
-1,131210061003018.000000000000000,Block 3018, Block Group 3, Census Tract 61, Fulton County, Georgia,51,0,51,49,9,40,0,2
-1,131210063001019.000000000000000,Block 1019, Block Group 1, Census Tract 63, Fulton County, Georgia,51,0,51,51,7,43,1,0
-1,131210066012009.000000000000000,Block 2009, Block Group 2, Census Tract 66.01, Fulton County, Georgia,51,1,50,44,17,27,0,6
-1,131210066021002.000000000000000,Block 1002, Block Group 1, Census Tract 66.02, Fulton County, Georgia,51,3,48,48,3,45,0,0
-1,131210067021007.000000000000000,Block 1007, Block Group 1, Census Tract 67.02, Fulton County, Georgia,51,2,49,49,2,47,0,0
-1,131210069003011.000000000000000,Block 3011, Block Group 3, Census Tract 69, Fulton County, Georgia,51,20,31,30,23,4,0,1
-1,131210070011010.000000000000000,Block 1010, Block Group 1, Census Tract 70.01, Fulton County, Georgia,51,1,50,49,0,49,0,1
-1,131210070022006.000000000000000,Block 2006, Block Group 2, Census Tract 70.02, Fulton County, Georgia,51,4,47,46,0,46,0,1
-1,131210071001008.000000000000000,Block 1008, Block Group 1, Census Tract 71, Fulton County, Georgia,51,1,50,50,0,50,0,0
-1,131210074002004.000000000000000,Block 2004, Block Group 2, Census Tract 74, Fulton County, Georgia,51,9,42,40,0,35,5,2
-1,131210076021000.000000000000000,Block 1000, Block Group 1, Census Tract 76.02, Fulton County, Georgia,51,2,49,49,4,45,0,0
-1,131210076031000.000000000000000,Block 1000, Block Group 1, Census Tract 76.03, Fulton County, Georgia,51,3,48,48,4,43,0,0
-1,131210079001001.000000000000000,Block 1001, Block Group 1, Census Tract 79, Fulton County, Georgia,51,1,50,49,1,48,0,1
-1,131210079004007.000000000000000,Block 4007, Block Group 4, Census Tract 79, Fulton County, Georgia,51,0,51,51,0,51,0,0
-1,131210080005009.000000000000000,Block 5009, Block Group 5, Census Tract 80, Fulton County, Georgia,51,0,51,50,6,43,1,1
-1,131210081031003.000000000000000,Block 1003, Block Group 1, Census Tract 81.03, Fulton County, Georgia,51,8,43,41,2,37,0,2
-1,131210082022002.000000000000000,Block 2002, Block Group 2, Census Tract 82.02, Fulton County, Georgia,51,4,47,46,0,46,0,1
-1,131210083012014.000000000000000,Block 2014, Block Group 2, Census Tract 83.01, Fulton County, Georgia,51,1,50,50,4,45,1,0
-1,131210083022011.000000000000000,Block 2011, Block Group 2, Census Tract 83.02, Fulton County, Georgia,51,1,50,50,0,50,0,0
-1,131210084001000.000000000000000,Block 1000, Block Group 1, Census Tract 84, Fulton County, Georgia,51,4,47,46,0,46,0,1
-1,131210084001003.000000000000000,Block 1003, Block Group 1, Census Tract 84, Fulton County, Georgia,51,0,51,50,3,47,0,1
-1,131210085001004.000000000000000,Block 1004, Block Group 1, Census Tract 85, Fulton County, Georgia,51,2,49,48,1,47,0,1
-1,131210086013005.000000000000000,Block 3005, Block Group 3, Census Tract 86.01, Fulton County, Georgia,51,2,49,49,0,49,0,0
-1,131210088021015.000000000000000,Block 1015, Block Group 1, Census Tract 88.02, Fulton County, Georgia,51,7,44,37,16,14,0,7
-1,131210089071004.000000000000000,Block 1004, Block Group 1, Census Tract 89.07, Fulton County, Georgia,51,7,44,38,29,3,2,6
-1,131210099001002.000000000000000,Block 1002, Block Group 1, Census Tract 99, Fulton County, Georgia,51,0,51,48,41,0,0,3
-1,131210101081007.000000000000000,Block 1007, Block Group 1, Census Tract 101.08, Fulton County, Georgia,51,0,51,48,48,0,0,3
-1,131210101202001.000000000000000,Block 2001, Block Group 2, Census Tract 101.20, Fulton County, Georgia,51,4,47,44,30,7,3,3
-1,131210101373003.000000000000000,Block 3003, Block Group 3, Census Tract 101.37, Fulton County, Georgia,51,25,26,21,14,4,0,5
-1,131210102111008.000000000000000,Block 1008, Block Group 1, Census Tract 102.11, Fulton County, Georgia,51,0,51,50,47,0,0,1
-1,131210102233009.000000000000000,Block 3009, Block Group 3, Census Tract 102.23, Fulton County, Georgia,51,1,50,50,49,1,0,0
-1,131210103061003.000000000000000,Block 1003, Block Group 1, Census Tract 103.06, Fulton County, Georgia,51,1,50,49,1,47,0,1
-1,131210103061016.000000000000000,Block 1016, Block Group 1, Census Tract 103.06, Fulton County, Georgia,51,1,50,39,1,37,0,11
-1,131210103071004.000000000000000,Block 1004, Block Group 1, Census Tract 103.07, Fulton County, Georgia,51,1,50,48,4,41,3,2
-1,131210104013003.000000000000000,Block 3003, Block Group 3, Census Tract 104.01, Fulton County, Georgia,51,9,42,38,26,12,0,4
-1,131210104013033.000000000000000,Block 3033, Block Group 3, Census Tract 104.01, Fulton County, Georgia,51,13,38,38,22,16,0,0
-1,131210105171009.000000000000000,Block 1009, Block Group 1, Census Tract 105.17, Fulton County, Georgia,51,1,50,49,6,38,5,1
-1,131210105273012.000000000000000,Block 3012, Block Group 3, Census Tract 105.27, Fulton County, Georgia,51,5,46,46,9,37,0,0
-1,131210105301015.000000000000000,Block 1015, Block Group 1, Census Tract 105.30, Fulton County, Georgia,51,1,50,49,0,49,0,1
-1,131210105312010.000000000000000,Block 2010, Block Group 2, Census Tract 105.31, Fulton County, Georgia,51,15,36,31,0,29,2,5
-1,131210105352016.000000000000000,Block 2016, Block Group 2, Census Tract 105.35, Fulton County, Georgia,51,7,44,41,20,21,0,3
-1,131210106031008.000000000000000,Block 1008, Block Group 1, Census Tract 106.03, Fulton County, Georgia,51,0,51,49,0,47,0,2
-1,131210108012014.000000000000000,Block 2014, Block Group 2, Census Tract 108.01, Fulton County, Georgia,51,9,42,38,14,16,0,4
-1,131210110002015.000000000000000,Block 2015, Block Group 2, Census Tract 110, Fulton County, Georgia,51,2,49,48,0,46,2,1
-1,131210111001029.000000000000000,Block 1029, Block Group 1, Census Tract 111, Fulton County, Georgia,51,3,48,48,2,42,0,0
-1,131210113061009.000000000000000,Block 1009, Block Group 1, Census Tract 113.06, Fulton County, Georgia,51,1,50,41,2,38,1,9
-1,131210114161004.000000000000000,Block 1004, Block Group 1, Census Tract 114.16, Fulton County, Georgia,51,9,42,32,28,0,0,10
-1,131210114194012.000000000000000,Block 4012, Block Group 4, Census Tract 114.19, Fulton County, Georgia,51,7,44,42,28,5,3,2
-1,131210114362006.000000000000000,Block 2006, Block Group 2, Census Tract 114.36, Fulton County, Georgia,51,6,45,38,29,1,2,7
-1,131210114373002.000000000000000,Block 3002, Block Group 3, Census Tract 114.37, Fulton County, Georgia,51,2,49,47,39,0,3,2
-1,131210115073001.000000000000000,Block 3001, Block Group 3, Census Tract 115.07, Fulton County, Georgia,51,5,46,44,30,4,1,2
-1,131210115092004.000000000000000,Block 2004, Block Group 2, Census Tract 115.09, Fulton County, Georgia,51,0,51,50,43,3,0,1
-1,131210115131009.000000000000000,Block 1009, Block Group 1, Census Tract 115.13, Fulton County, Georgia,51,0,51,43,41,1,0,8
-1,131210116471014.000000000000000,Block 1014, Block Group 1, Census Tract 116.47, Fulton County, Georgia,51,7,44,38,38,0,0,6
-1,131210116511003.000000000000000,Block 1003, Block Group 1, Census Tract 116.51, Fulton County, Georgia,51,2,49,45,27,5,0,4
-1,131210116601005.000000000000000,Block 1005, Block Group 1, Census Tract 116.60, Fulton County, Georgia,51,4,47,41,18,0,0,6
-1,131210116601009.000000000000000,Block 1009, Block Group 1, Census Tract 116.60, Fulton County, Georgia,51,7,44,41,23,4,3,3
-1,131210120001002.000000000000000,Block 1002, Block Group 1, Census Tract 120, Fulton County, Georgia,51,6,45,41,23,13,0,4
-1,131210001003002.000000000000000,Block 3002, Block Group 3, Census Tract 1, Fulton County, Georgia,50,5,45,42,36,1,5,3
-1,131210002021008.000000000000000,Block 1008, Block Group 1, Census Tract 2.02, Fulton County, Georgia,50,1,49,49,44,0,0,0
-1,131210002023005.000000000000000,Block 3005, Block Group 3, Census Tract 2.02, Fulton County, Georgia,50,1,49,44,42,0,0,5
-1,131210006013004.000000000000000,Block 3004, Block Group 3, Census Tract 6.01, Fulton County, Georgia,50,4,46,44,22,5,0,2
-1,131210014002005.000000000000000,Block 2005, Block Group 2, Census Tract 14, Fulton County, Georgia,50,2,48,44,42,0,1,4
-1,131210017022008.000000000000000,Block 2008, Block Group 2, Census Tract 17.02, Fulton County, Georgia,50,7,43,38,26,5,2,5
-1,131210025001009.000000000000000,Block 1009, Block Group 1, Census Tract 25, Fulton County, Georgia,50,1,49,49,1,48,0,0
-1,131210030001003.000000000000000,Block 1003, Block Group 1, Census Tract 30, Fulton County, Georgia,50,0,50,49,41,4,0,1
-1,131210031001000.000000000000000,Block 1000, Block Group 1, Census Tract 31, Fulton County, Georgia,50,8,42,42,25,16,1,0
-1,131210039001005.000000000000000,Block 1005, Block Group 1, Census Tract 39, Fulton County, Georgia,50,2,48,47,0,47,0,1
-1,131210044002023.000000000000000,Block 2023, Block Group 2, Census Tract 44, Fulton County, Georgia,50,2,48,48,1,47,0,0
-1,131210050002025.000000000000000,Block 2025, Block Group 2, Census Tract 50, Fulton County, Georgia,50,7,43,35,27,6,0,8
-1,131210052002009.000000000000000,Block 2009, Block Group 2, Census Tract 52, Fulton County, Georgia,50,4,46,45,42,3,0,1
-1,131210053002030.000000000000000,Block 2030, Block Group 2, Census Tract 53, Fulton County, Georgia,50,6,44,43,34,7,2,1
-1,131210057001009.000000000000000,Block 1009, Block Group 1, Census Tract 57, Fulton County, Georgia,50,0,50,50,2,47,1,0
-1,131210057002005.000000000000000,Block 2005, Block Group 2, Census Tract 57, Fulton County, Georgia,50,4,46,44,0,44,0,2
-1,131210062001014.000000000000000,Block 1014, Block Group 1, Census Tract 62, Fulton County, Georgia,50,2,48,45,1,43,1,3
-1,131210063001008.000000000000000,Block 1008, Block Group 1, Census Tract 63, Fulton County, Georgia,50,0,50,50,1,49,0,0
-1,131210064001009.000000000000000,Block 1009, Block Group 1, Census Tract 64, Fulton County, Georgia,50,17,33,31,17,14,0,2
-1,131210065002019.000000000000000,Block 2019, Block Group 2, Census Tract 65, Fulton County, Georgia,50,0,50,50,4,46,0,0
-1,131210066012001.000000000000000,Block 2001, Block Group 2, Census Tract 66.01, Fulton County, Georgia,50,6,44,42,20,22,0,2
-1,131210069001004.000000000000000,Block 1004, Block Group 1, Census Tract 69, Fulton County, Georgia,50,1,49,49,39,9,0,0
-1,131210069002006.000000000000000,Block 2006, Block Group 2, Census Tract 69, Fulton County, Georgia,50,12,38,33,21,12,0,5
-1,131210069003026.000000000000000,Block 3026, Block Group 3, Census Tract 69, Fulton County, Georgia,50,4,46,45,38,5,0,1
-1,131210070011001.000000000000000,Block 1001, Block Group 1, Census Tract 70.01, Fulton County, Georgia,50,2,48,48,0,48,0,0
-1,131210070012013.000000000000000,Block 2013, Block Group 2, Census Tract 70.01, Fulton County, Georgia,50,0,50,48,2,46,0,2
-1,131210071001003.000000000000000,Block 1003, Block Group 1, Census Tract 71, Fulton County, Georgia,50,1,49,46,1,43,0,3
-1,131210072003003.000000000000000,Block 3003, Block Group 3, Census Tract 72, Fulton County, Georgia,50,1,49,46,0,46,0,3
-1,131210074002005.000000000000000,Block 2005, Block Group 2, Census Tract 74, Fulton County, Georgia,50,3,47,47,5,42,0,0
-1,131210076041004.000000000000000,Block 1004, Block Group 1, Census Tract 76.04, Fulton County, Georgia,50,9,41,41,0,40,0,0
-1,131210077091004.000000000000000,Block 1004, Block Group 1, Census Tract 77.09, Fulton County, Georgia,50,2,48,36,0,36,0,12
-1,131210077092001.000000000000000,Block 2001, Block Group 2, Census Tract 77.09, Fulton County, Georgia,50,4,46,44,3,38,0,2
-1,131210078061001.000000000000000,Block 1001, Block Group 1, Census Tract 78.06, Fulton County, Georgia,50,4,46,43,0,42,1,3
-1,131210078064000.000000000000000,Block 4000, Block Group 4, Census Tract 78.06, Fulton County, Georgia,50,10,40,38,1,35,0,2
-1,131210082021008.000000000000000,Block 1008, Block Group 1, Census Tract 82.02, Fulton County, Georgia,50,7,43,41,0,41,0,2
-1,131210083022014.000000000000000,Block 2014, Block Group 2, Census Tract 83.02, Fulton County, Georgia,50,1,49,48,0,48,0,1
-1,131210084001011.000000000000000,Block 1011, Block Group 1, Census Tract 84, Fulton County, Georgia,50,5,45,37,1,36,0,8
-1,131210087021014.000000000000000,Block 1014, Block Group 1, Census Tract 87.02, Fulton County, Georgia,50,3,47,47,23,20,0,0
-1,131210089062004.000000000000000,Block 2004, Block Group 2, Census Tract 89.06, Fulton County, Georgia,50,7,43,41,36,5,0,2
-1,131210092012001.000000000000000,Block 2001, Block Group 2, Census Tract 92.01, Fulton County, Georgia,50,9,41,37,31,5,0,4
-1,131210092032001.000000000000000,Block 2001, Block Group 2, Census Tract 92.03, Fulton County, Georgia,50,6,44,38,28,2,3,6
-1,131210092032006.000000000000000,Block 2006, Block Group 2, Census Tract 92.03, Fulton County, Georgia,50,4,46,44,38,2,1,2
-1,131210093012009.000000000000000,Block 2009, Block Group 2, Census Tract 93.01, Fulton County, Georgia,50,1,49,48,47,0,0,1
-1,131210093012014.000000000000000,Block 2014, Block Group 2, Census Tract 93.01, Fulton County, Georgia,50,0,50,48,48,0,0,2
-1,131210095011013.000000000000000,Block 1013, Block Group 1, Census Tract 95.01, Fulton County, Georgia,50,0,50,50,50,0,0,0
-1,131210096073005.000000000000000,Block 3005, Block Group 3, Census Tract 96.07, Fulton County, Georgia,50,10,40,31,23,7,0,9
-1,131210098022009.000000000000000,Block 2009, Block Group 2, Census Tract 98.02, Fulton County, Georgia,50,3,47,41,30,8,0,6
-1,131210100033001.000000000000000,Block 3001, Block Group 3, Census Tract 100.03, Fulton County, Georgia,50,6,44,38,38,0,0,6
-1,131210101063001.000000000000000,Block 3001, Block Group 3, Census Tract 101.06, Fulton County, Georgia,50,20,30,27,13,11,3,3
-1,131210101063003.000000000000000,Block 3003, Block Group 3, Census Tract 101.06, Fulton County, Georgia,50,16,34,29,4,21,0,5
-1,131210101211003.000000000000000,Block 1003, Block Group 1, Census Tract 101.21, Fulton County, Georgia,50,9,41,41,29,0,0,0
-1,131210101211007.000000000000000,Block 1007, Block Group 1, Census Tract 101.21, Fulton County, Georgia,50,3,47,47,35,1,1,0
-1,131210101291001.000000000000000,Block 1001, Block Group 1, Census Tract 101.29, Fulton County, Georgia,50,19,31,26,7,10,0,5
-1,131210101332009.000000000000000,Block 2009, Block Group 2, Census Tract 101.33, Fulton County, Georgia,50,1,49,46,37,0,0,3
-1,131210101362012.000000000000000,Block 2012, Block Group 2, Census Tract 101.36, Fulton County, Georgia,50,1,49,48,44,2,2,1
-1,131210102211001.000000000000000,Block 1001, Block Group 1, Census Tract 102.21, Fulton County, Georgia,50,6,44,40,39,0,0,4
-1,131210103061000.000000000000000,Block 1000, Block Group 1, Census Tract 103.06, Fulton County, Georgia,50,1,49,47,4,43,0,2
-1,131210103103015.000000000000000,Block 3015, Block Group 3, Census Tract 103.10, Fulton County, Georgia,50,2,48,48,0,48,0,0
-1,131210105192017.000000000000000,Block 2017, Block Group 2, Census Tract 105.19, Fulton County, Georgia,50,2,48,45,4,40,0,3
-1,131210105283008.000000000000000,Block 3008, Block Group 3, Census Tract 105.28, Fulton County, Georgia,50,7,43,43,4,37,0,0
-1,131210106034011.000000000000000,Block 4011, Block Group 4, Census Tract 106.03, Fulton County, Georgia,50,7,43,43,7,36,0,0
-1,131210108011027.000000000000000,Block 1027, Block Group 1, Census Tract 108.01, Fulton County, Georgia,50,10,40,34,15,15,4,6
-1,131210110003021.000000000000000,Block 3021, Block Group 3, Census Tract 110, Fulton County, Georgia,50,7,43,41,2,39,0,2
-1,131210111002034.000000000000000,Block 2034, Block Group 2, Census Tract 111, Fulton County, Georgia,50,5,45,43,12,28,0,2
-1,131210112022008.000000000000000,Block 2008, Block Group 2, Census Tract 112.02, Fulton County, Georgia,50,13,37,35,8,27,0,2
-1,131210113102002.000000000000000,Block 2002, Block Group 2, Census Tract 113.10, Fulton County, Georgia,50,10,40,40,1,37,1,0
-1,131210113104003.000000000000000,Block 4003, Block Group 4, Census Tract 113.10, Fulton County, Georgia,50,20,30,30,0,30,0,0
-1,131210114163003.000000000000000,Block 3003, Block Group 3, Census Tract 114.16, Fulton County, Georgia,50,8,42,36,28,3,0,6
-1,131210114191012.000000000000000,Block 1012, Block Group 1, Census Tract 114.19, Fulton County, Georgia,50,0,50,49,41,2,0,1
-1,131210114401002.000000000000000,Block 1002, Block Group 1, Census Tract 114.40, Fulton County, Georgia,50,6,44,34,23,11,0,10
-1,131210114412007.000000000000000,Block 2007, Block Group 2, Census Tract 114.41, Fulton County, Georgia,50,4,46,43,33,0,2,3
-1,131210114452002.000000000000000,Block 2002, Block Group 2, Census Tract 114.45, Fulton County, Georgia,50,4,46,44,44,0,0,2
-1,131210115082014.000000000000000,Block 2014, Block Group 2, Census Tract 115.08, Fulton County, Georgia,50,7,43,40,35,2,1,3
-1,131210115101027.000000000000000,Block 1027, Block Group 1, Census Tract 115.10, Fulton County, Georgia,50,0,50,45,39,2,0,5
-1,131210115112010.000000000000000,Block 2010, Block Group 2, Census Tract 115.11, Fulton County, Georgia,50,6,44,39,19,7,2,5
-1,131210116122001.000000000000000,Block 2001, Block Group 2, Census Tract 116.12, Fulton County, Georgia,50,3,47,42,38,0,0,5
-1,131210116183017.000000000000000,Block 3017, Block Group 3, Census Tract 116.18, Fulton County, Georgia,50,2,48,46,20,8,1,2
-1,131210116353006.000000000000000,Block 3006, Block Group 3, Census Tract 116.35, Fulton County, Georgia,50,2,48,46,8,1,0,2
-1,131210116361005.000000000000000,Block 1005, Block Group 1, Census Tract 116.36, Fulton County, Georgia,50,12,38,35,24,8,0,3
-1,131210116383001.000000000000000,Block 3001, Block Group 3, Census Tract 116.38, Fulton County, Georgia,50,0,50,47,36,3,0,3
-1,131210116411006.000000000000000,Block 1006, Block Group 1, Census Tract 116.41, Fulton County, Georgia,50,0,50,46,39,1,0,4
-1,131210116492003.000000000000000,Block 2003, Block Group 2, Census Tract 116.49, Fulton County, Georgia,50,1,49,37,21,9,0,12
-1,131210116551007.000000000000000,Block 1007, Block Group 1, Census Tract 116.55, Fulton County, Georgia,50,10,40,36,32,0,0,4
-1,131210118021011.000000000000000,Block 1011, Block Group 1, Census Tract 118.02, Fulton County, Georgia,50,0,50,50,0,50,0,0
-1,131210120002016.000000000000000,Block 2016, Block Group 2, Census Tract 120, Fulton County, Georgia,50,0,50,49,8,40,0,1
-1,131210005022039.000000000000000,Block 2039, Block Group 2, Census Tract 5.02, Fulton County, Georgia,49,4,45,42,38,4,0,3
-1,131210007001020.000000000000000,Block 1020, Block Group 1, Census Tract 7, Fulton County, Georgia,49,1,48,45,40,5,0,3
-1,131210019022008.000000000000000,Block 2008, Block Group 2, Census Tract 19.02, Fulton County, Georgia,49,3,46,42,13,29,0,4
-1,131210049002021.000000000000000,Block 2021, Block Group 2, Census Tract 49, Fulton County, Georgia,49,0,49,45,39,6,0,4
-1,131210061002004.000000000000000,Block 2004, Block Group 2, Census Tract 61, Fulton County, Georgia,49,1,48,43,4,39,0,5
-1,131210062002010.000000000000000,Block 2010, Block Group 2, Census Tract 62, Fulton County, Georgia,49,2,47,46,0,45,0,1
-1,131210063002005.000000000000000,Block 2005, Block Group 2, Census Tract 63, Fulton County, Georgia,49,0,49,49,0,49,0,0
-1,131210065002008.000000000000000,Block 2008, Block Group 2, Census Tract 65, Fulton County, Georgia,49,0,49,48,3,41,0,1
-1,131210065004002.000000000000000,Block 4002, Block Group 4, Census Tract 65, Fulton County, Georgia,49,0,49,45,16,29,0,4
-1,131210065004013.000000000000000,Block 4013, Block Group 4, Census Tract 65, Fulton County, Georgia,49,0,49,46,11,33,1,3
-1,131210067021026.000000000000000,Block 1026, Block Group 1, Census Tract 67.02, Fulton County, Georgia,49,4,45,42,7,35,0,3
-1,131210071002015.000000000000000,Block 2015, Block Group 2, Census Tract 71, Fulton County, Georgia,49,4,45,40,0,40,0,5
-1,131210076031006.000000000000000,Block 1006, Block Group 1, Census Tract 76.03, Fulton County, Georgia,49,4,45,40,0,37,0,5
-1,131210077053001.000000000000000,Block 3001, Block Group 3, Census Tract 77.05, Fulton County, Georgia,49,3,46,42,0,41,0,4
-1,131210077093004.000000000000000,Block 3004, Block Group 3, Census Tract 77.09, Fulton County, Georgia,49,7,42,39,0,39,0,3
-1,131210077112007.000000000000000,Block 2007, Block Group 2, Census Tract 77.11, Fulton County, Georgia,49,4,45,45,1,44,0,0
-1,131210078092017.000000000000000,Block 2017, Block Group 2, Census Tract 78.09, Fulton County, Georgia,49,0,49,49,0,49,0,0
-1,131210086013015.000000000000000,Block 3015, Block Group 3, Census Tract 86.01, Fulton County, Georgia,49,1,48,46,0,46,0,2
-1,131210089053005.000000000000000,Block 3005, Block Group 3, Census Tract 89.05, Fulton County, Georgia,49,6,43,42,25,15,0,1
-1,131210090022001.000000000000000,Block 2001, Block Group 2, Census Tract 90.02, Fulton County, Georgia,49,0,49,46,46,0,0,3
-1,131210091051009.000000000000000,Block 1009, Block Group 1, Census Tract 91.05, Fulton County, Georgia,49,0,49,47,44,3,0,2
-1,131210092011003.000000000000000,Block 1003, Block Group 1, Census Tract 92.01, Fulton County, Georgia,49,6,43,39,33,4,0,4
-1,131210093012013.000000000000000,Block 2013, Block Group 2, Census Tract 93.01, Fulton County, Georgia,49,3,46,46,46,0,0,0
-1,131210094051004.000000000000000,Block 1004, Block Group 1, Census Tract 94.05, Fulton County, Georgia,49,14,35,11,8,2,0,24
-1,131210095041006.000000000000000,Block 1006, Block Group 1, Census Tract 95.04, Fulton County, Georgia,49,8,41,36,36,0,0,5
-1,131210097003001.000000000000000,Block 3001, Block Group 3, Census Tract 97, Fulton County, Georgia,49,0,49,44,42,2,0,5
-1,131210100052023.000000000000000,Block 2023, Block Group 2, Census Tract 100.05, Fulton County, Georgia,49,3,46,42,24,4,0,4
-1,131210101261001.000000000000000,Block 1001, Block Group 1, Census Tract 101.26, Fulton County, Georgia,49,5,44,37,23,1,5,7
-1,131210101271003.000000000000000,Block 1003, Block Group 1, Census Tract 101.27, Fulton County, Georgia,49,2,47,39,12,5,4,8
-1,131210101331007.000000000000000,Block 1007, Block Group 1, Census Tract 101.33, Fulton County, Georgia,49,5,44,43,29,0,3,1
-1,131210102042007.000000000000000,Block 2007, Block Group 2, Census Tract 102.04, Fulton County, Georgia,49,2,47,42,35,0,0,5
-1,131210102113002.000000000000000,Block 3002, Block Group 3, Census Tract 102.11, Fulton County, Georgia,49,11,38,36,26,3,0,2
-1,131210102113003.000000000000000,Block 3003, Block Group 3, Census Tract 102.11, Fulton County, Georgia,49,4,45,40,33,0,0,5
-1,131210102152004.000000000000000,Block 2004, Block Group 2, Census Tract 102.15, Fulton County, Georgia,49,3,46,39,31,5,0,7
-1,131210103051021.000000000000000,Block 1021, Block Group 1, Census Tract 103.05, Fulton County, Georgia,49,5,44,44,0,44,0,0
-1,131210103053001.000000000000000,Block 3001, Block Group 3, Census Tract 103.05, Fulton County, Georgia,49,1,48,46,0,46,0,2
-1,131210103062006.000000000000000,Block 2006, Block Group 2, Census Tract 103.06, Fulton County, Georgia,49,3,46,46,0,43,0,0
-1,131210103091007.000000000000000,Block 1007, Block Group 1, Census Tract 103.09, Fulton County, Georgia,49,0,49,47,35,12,0,2
-1,131210103093003.000000000000000,Block 3003, Block Group 3, Census Tract 103.09, Fulton County, Georgia,49,9,40,39,19,17,2,1
-1,131210104021030.000000000000000,Block 1030, Block Group 1, Census Tract 104.02, Fulton County, Georgia,49,5,44,44,34,10,0,0
-1,131210105083010.000000000000000,Block 3010, Block Group 3, Census Tract 105.08, Fulton County, Georgia,49,6,43,39,1,37,0,4
-1,131210105181011.000000000000000,Block 1011, Block Group 1, Census Tract 105.18, Fulton County, Georgia,49,2,47,47,0,47,0,0
-1,131210105191003.000000000000000,Block 1003, Block Group 1, Census Tract 105.19, Fulton County, Georgia,49,11,38,31,8,23,0,7
-1,131210105202007.000000000000000,Block 2007, Block Group 2, Census Tract 105.20, Fulton County, Georgia,49,0,49,46,1,43,0,3
-1,131210105202012.000000000000000,Block 2012, Block Group 2, Census Tract 105.20, Fulton County, Georgia,49,0,49,47,0,47,0,2
-1,131210105203019.000000000000000,Block 3019, Block Group 3, Census Tract 105.20, Fulton County, Georgia,49,8,41,38,0,31,1,3
-1,131210105212017.000000000000000,Block 2017, Block Group 2, Census Tract 105.21, Fulton County, Georgia,49,0,49,41,5,36,0,8
-1,131210105262005.000000000000000,Block 2005, Block Group 2, Census Tract 105.26, Fulton County, Georgia,49,2,47,43,0,42,0,4
-1,131210105342007.000000000000000,Block 2007, Block Group 2, Census Tract 105.34, Fulton County, Georgia,49,1,48,46,0,44,2,2
-1,131210108012000.000000000000000,Block 2000, Block Group 2, Census Tract 108.01, Fulton County, Georgia,49,22,27,24,6,7,2,3
-1,131210110002022.000000000000000,Block 2022, Block Group 2, Census Tract 110, Fulton County, Georgia,49,12,37,36,5,28,3,1
-1,131210110003005.000000000000000,Block 3005, Block Group 3, Census Tract 110, Fulton County, Georgia,49,15,34,34,4,29,1,0
-1,131210112023005.000000000000000,Block 3005, Block Group 3, Census Tract 112.02, Fulton County, Georgia,49,0,49,49,10,38,1,0
-1,131210112024003.000000000000000,Block 4003, Block Group 4, Census Tract 112.02, Fulton County, Georgia,49,6,43,38,20,18,0,5
-1,131210112032001.000000000000000,Block 2001, Block Group 2, Census Tract 112.03, Fulton County, Georgia,49,3,46,45,15,30,0,1
-1,131210112032005.000000000000000,Block 2005, Block Group 2, Census Tract 112.03, Fulton County, Georgia,49,3,46,43,16,25,2,3
-1,131210113016003.000000000000000,Block 6003, Block Group 6, Census Tract 113.01, Fulton County, Georgia,49,0,49,48,0,48,0,1
-1,131210113102010.000000000000000,Block 2010, Block Group 2, Census Tract 113.10, Fulton County, Georgia,49,12,37,34,0,34,0,3
-1,131210114462003.000000000000000,Block 2003, Block Group 2, Census Tract 114.46, Fulton County, Georgia,49,5,44,40,38,2,0,4
-1,131210115152001.000000000000000,Block 2001, Block Group 2, Census Tract 115.15, Fulton County, Georgia,49,6,43,38,27,4,4,5
-1,131210116123007.000000000000000,Block 3007, Block Group 3, Census Tract 116.12, Fulton County, Georgia,49,3,46,37,25,0,1,9
-1,131210116282004.000000000000000,Block 2004, Block Group 2, Census Tract 116.28, Fulton County, Georgia,49,6,43,42,14,6,0,1
-1,131210116493014.000000000000000,Block 3014, Block Group 3, Census Tract 116.49, Fulton County, Georgia,49,1,48,44,23,10,0,4
-1,131210120002013.000000000000000,Block 2013, Block Group 2, Census Tract 120, Fulton County, Georgia,49,4,45,43,4,32,0,2
-1,131210120003011.000000000000000,Block 3011, Block Group 3, Census Tract 120, Fulton County, Georgia,49,0,49,48,5,43,0,1
-1,131210123002045.000000000000000,Block 2045, Block Group 2, Census Tract 123, Fulton County, Georgia,49,6,43,41,28,13,0,2
-1,131210007001015.000000000000000,Block 1015, Block Group 1, Census Tract 7, Fulton County, Georgia,48,2,46,44,34,10,0,2
-1,131210013011003.000000000000000,Block 1003, Block Group 1, Census Tract 13.01, Fulton County, Georgia,48,4,44,32,18,4,0,12
-1,131210025002002.000000000000000,Block 2002, Block Group 2, Census Tract 25, Fulton County, Georgia,48,1,47,45,0,45,0,2
-1,131210026002010.000000000000000,Block 2010, Block Group 2, Census Tract 26, Fulton County, Georgia,48,3,45,45,4,40,0,0
-1,131210029001021.000000000000000,Block 1021, Block Group 1, Census Tract 29, Fulton County, Georgia,48,1,47,41,27,11,0,6
-1,131210032002012.000000000000000,Block 2012, Block Group 2, Census Tract 32, Fulton County, Georgia,48,1,47,45,40,5,0,2
-1,131210037001000.000000000000000,Block 1000, Block Group 1, Census Tract 37, Fulton County, Georgia,48,0,48,48,0,48,0,0
-1,131210039001014.000000000000000,Block 1014, Block Group 1, Census Tract 39, Fulton County, Georgia,48,2,46,46,0,42,0,0
-1,131210044002013.000000000000000,Block 2013, Block Group 2, Census Tract 44, Fulton County, Georgia,48,0,48,47,0,47,0,1
-1,131210050001013.000000000000000,Block 1013, Block Group 1, Census Tract 50, Fulton County, Georgia,48,1,47,41,38,3,0,6
-1,131210055011026.000000000000000,Block 1026, Block Group 1, Census Tract 55.01, Fulton County, Georgia,48,7,41,37,13,21,0,4
-1,131210055041002.000000000000000,Block 1002, Block Group 1, Census Tract 55.04, Fulton County, Georgia,48,0,48,44,14,30,0,4
-1,131210058001044.000000000000000,Block 1044, Block Group 1, Census Tract 58, Fulton County, Georgia,48,2,46,44,23,19,2,2
-1,131210060004005.000000000000000,Block 4005, Block Group 4, Census Tract 60, Fulton County, Georgia,48,1,47,44,1,42,0,3
-1,131210061003001.000000000000000,Block 3001, Block Group 3, Census Tract 61, Fulton County, Georgia,48,2,46,44,1,41,0,2
-1,131210065001008.000000000000000,Block 1008, Block Group 1, Census Tract 65, Fulton County, Georgia,48,0,48,40,15,22,0,8
-1,131210065004017.000000000000000,Block 4017, Block Group 4, Census Tract 65, Fulton County, Georgia,48,0,48,48,13,29,4,0
-1,131210066012010.000000000000000,Block 2010, Block Group 2, Census Tract 66.01, Fulton County, Georgia,48,4,44,44,9,33,0,0
-1,131210073021005.000000000000000,Block 1005, Block Group 1, Census Tract 73.02, Fulton County, Georgia,48,2,46,41,5,36,0,5
-1,131210073022005.000000000000000,Block 2005, Block Group 2, Census Tract 73.02, Fulton County, Georgia,48,0,48,48,1,47,0,0
-1,131210075003000.000000000000000,Block 3000, Block Group 3, Census Tract 75, Fulton County, Georgia,48,1,47,45,4,39,0,2
-1,131210077092006.000000000000000,Block 2006, Block Group 2, Census Tract 77.09, Fulton County, Georgia,48,5,43,42,3,38,0,1
-1,131210078061002.000000000000000,Block 1002, Block Group 1, Census Tract 78.06, Fulton County, Georgia,48,14,34,34,0,33,0,0
-1,131210078092009.000000000000000,Block 2009, Block Group 2, Census Tract 78.09, Fulton County, Georgia,48,1,47,46,2,44,0,1
-1,131210079002004.000000000000000,Block 2004, Block Group 2, Census Tract 79, Fulton County, Georgia,48,0,48,46,0,45,0,2
-1,131210079003006.000000000000000,Block 3006, Block Group 3, Census Tract 79, Fulton County, Georgia,48,0,48,48,0,45,0,0
-1,131210080004011.000000000000000,Block 4011, Block Group 4, Census Tract 80, Fulton County, Georgia,48,6,42,40,1,39,0,2
-1,131210083022013.000000000000000,Block 2013, Block Group 2, Census Tract 83.02, Fulton County, Georgia,48,3,45,44,5,39,0,1
-1,131210084001006.000000000000000,Block 1006, Block Group 1, Census Tract 84, Fulton County, Georgia,48,0,48,43,0,43,0,5
-1,131210085001014.000000000000000,Block 1014, Block Group 1, Census Tract 85, Fulton County, Georgia,48,0,48,44,0,44,0,4
-1,131210092031006.000000000000000,Block 1006, Block Group 1, Census Tract 92.03, Fulton County, Georgia,48,10,38,31,17,5,5,7
-1,131210092031012.000000000000000,Block 1012, Block Group 1, Census Tract 92.03, Fulton County, Georgia,48,4,44,38,14,3,0,6
-1,131210098023004.000000000000000,Block 3004, Block Group 3, Census Tract 98.02, Fulton County, Georgia,48,7,41,29,22,4,3,12
-1,131210100072001.000000000000000,Block 2001, Block Group 2, Census Tract 100.07, Fulton County, Georgia,48,5,43,43,36,5,0,0
-1,131210101062006.000000000000000,Block 2006, Block Group 2, Census Tract 101.06, Fulton County, Georgia,48,9,39,29,27,0,0,10
-1,131210101251001.000000000000000,Block 1001, Block Group 1, Census Tract 101.25, Fulton County, Georgia,48,15,33,31,5,23,1,2
-1,131210101331006.000000000000000,Block 1006, Block Group 1, Census Tract 101.33, Fulton County, Georgia,48,8,40,40,27,10,0,0
-1,131210101361004.000000000000000,Block 1004, Block Group 1, Census Tract 101.36, Fulton County, Georgia,48,0,48,44,43,0,0,4
-1,131210101371003.000000000000000,Block 1003, Block Group 1, Census Tract 101.37, Fulton County, Georgia,48,5,43,38,31,3,3,5
-1,131210102221008.000000000000000,Block 1008, Block Group 1, Census Tract 102.22, Fulton County, Georgia,48,5,43,39,38,0,0,4
-1,131210102222002.000000000000000,Block 2002, Block Group 2, Census Tract 102.22, Fulton County, Georgia,48,1,47,43,43,0,0,4
-1,131210103061009.000000000000000,Block 1009, Block Group 1, Census Tract 103.06, Fulton County, Georgia,48,3,45,41,1,38,1,4
-1,131210103071000.000000000000000,Block 1000, Block Group 1, Census Tract 103.07, Fulton County, Georgia,48,1,47,47,7,40,0,0
-1,131210103091008.000000000000000,Block 1008, Block Group 1, Census Tract 103.09, Fulton County, Georgia,48,2,46,45,44,0,1,1
-1,131210103091032.000000000000000,Block 1032, Block Group 1, Census Tract 103.09, Fulton County, Georgia,48,0,48,47,29,18,0,1
-1,131210103152003.000000000000000,Block 2003, Block Group 2, Census Tract 103.15, Fulton County, Georgia,48,0,48,43,0,42,1,5
-1,131210104013002.000000000000000,Block 3002, Block Group 3, Census Tract 104.01, Fulton County, Georgia,48,8,40,40,32,8,0,0
-1,131210104022044.000000000000000,Block 2044, Block Group 2, Census Tract 104.02, Fulton County, Georgia,48,2,46,46,41,5,0,0
-1,131210105203005.000000000000000,Block 3005, Block Group 3, Census Tract 105.20, Fulton County, Georgia,48,6,42,42,21,21,0,0
-1,131210105262007.000000000000000,Block 2007, Block Group 2, Census Tract 105.26, Fulton County, Georgia,48,2,46,44,1,37,5,2
-1,131210105264013.000000000000000,Block 4013, Block Group 4, Census Tract 105.26, Fulton County, Georgia,48,4,44,43,0,43,0,1
-1,131210105293006.000000000000000,Block 3006, Block Group 3, Census Tract 105.29, Fulton County, Georgia,48,4,44,44,2,42,0,0
-1,131210105341011.000000000000000,Block 1011, Block Group 1, Census Tract 105.34, Fulton County, Georgia,48,2,46,45,0,37,1,1
-1,131210105352013.000000000000000,Block 2013, Block Group 2, Census Tract 105.35, Fulton County, Georgia,48,13,35,30,0,30,0,5
-1,131210105391025.000000000000000,Block 1025, Block Group 1, Census Tract 105.39, Fulton County, Georgia,48,2,46,46,0,46,0,0
-1,131210112026006.000000000000000,Block 6006, Block Group 6, Census Tract 112.02, Fulton County, Georgia,48,0,48,48,15,31,2,0
-1,131210112031022.000000000000000,Block 1022, Block Group 1, Census Tract 112.03, Fulton County, Georgia,48,5,43,36,17,19,0,7
-1,131210113013008.000000000000000,Block 3008, Block Group 3, Census Tract 113.01, Fulton County, Georgia,48,11,37,36,2,33,0,1
-1,131210113081006.000000000000000,Block 1006, Block Group 1, Census Tract 113.08, Fulton County, Georgia,48,0,48,41,0,41,0,7
-1,131210113104001.000000000000000,Block 4001, Block Group 4, Census Tract 113.10, Fulton County, Georgia,48,6,42,42,7,35,0,0
-1,131210114193004.000000000000000,Block 3004, Block Group 3, Census Tract 114.19, Fulton County, Georgia,48,2,46,43,39,0,0,3
-1,131210114261007.000000000000000,Block 1007, Block Group 1, Census Tract 114.26, Fulton County, Georgia,48,18,30,21,16,1,0,9
-1,131210114371002.000000000000000,Block 1002, Block Group 1, Census Tract 114.37, Fulton County, Georgia,48,5,43,41,22,18,1,2
-1,131210116453010.000000000000000,Block 3010, Block Group 3, Census Tract 116.45, Fulton County, Georgia,48,19,29,26,10,9,2,3
-1,131210116512010.000000000000000,Block 2010, Block Group 2, Census Tract 116.51, Fulton County, Georgia,48,5,43,42,29,8,2,1
-1,131210116522002.000000000000000,Block 2002, Block Group 2, Census Tract 116.52, Fulton County, Georgia,48,3,45,37,23,2,0,8
-1,131210001004012.000000000000000,Block 4012, Block Group 4, Census Tract 1, Fulton County, Georgia,47,2,45,44,40,1,3,1
-1,131210001004014.000000000000000,Block 4014, Block Group 4, Census Tract 1, Fulton County, Georgia,47,3,44,43,32,4,3,1
-1,131210012041000.000000000000000,Block 1000, Block Group 1, Census Tract 12.04, Fulton County, Georgia,47,2,45,38,32,4,0,7
-1,131210024002000.000000000000000,Block 2000, Block Group 2, Census Tract 24, Fulton County, Georgia,47,7,40,38,4,33,0,2
-1,131210031001004.000000000000000,Block 1004, Block Group 1, Census Tract 31, Fulton County, Georgia,47,9,38,38,33,3,0,0
-1,131210040003001.000000000000000,Block 3001, Block Group 3, Census Tract 40, Fulton County, Georgia,47,0,47,46,9,37,0,1
-1,131210041002007.000000000000000,Block 2007, Block Group 2, Census Tract 41, Fulton County, Georgia,47,2,45,43,12,31,0,2
-1,131210049002020.000000000000000,Block 2020, Block Group 2, Census Tract 49, Fulton County, Georgia,47,4,43,39,39,0,0,4
-1,131210049002026.000000000000000,Block 2026, Block Group 2, Census Tract 49, Fulton County, Georgia,47,1,46,44,43,1,0,2
-1,131210050001011.000000000000000,Block 1011, Block Group 1, Census Tract 50, Fulton County, Georgia,47,5,42,42,22,20,0,0
-1,131210050002024.000000000000000,Block 2024, Block Group 2, Census Tract 50, Fulton County, Georgia,47,5,42,41,37,0,3,1
-1,131210052001017.000000000000000,Block 1017, Block Group 1, Census Tract 52, Fulton County, Georgia,47,7,40,40,35,4,0,0
-1,131210052002014.000000000000000,Block 2014, Block Group 2, Census Tract 52, Fulton County, Georgia,47,1,46,40,40,0,0,6
-1,131210055041023.000000000000000,Block 1023, Block Group 1, Census Tract 55.04, Fulton County, Georgia,47,4,43,39,4,35,0,4
-1,131210057001008.000000000000000,Block 1008, Block Group 1, Census Tract 57, Fulton County, Georgia,47,0,47,47,2,45,0,0
-1,131210058001037.000000000000000,Block 1037, Block Group 1, Census Tract 58, Fulton County, Georgia,47,1,46,45,13,30,0,1
-1,131210060004004.000000000000000,Block 4004, Block Group 4, Census Tract 60, Fulton County, Georgia,47,0,47,46,9,37,0,1
-1,131210061002005.000000000000000,Block 2005, Block Group 2, Census Tract 61, Fulton County, Georgia,47,1,46,45,0,45,0,1
-1,131210062001011.000000000000000,Block 1011, Block Group 1, Census Tract 62, Fulton County, Georgia,47,1,46,44,0,44,0,2
-1,131210063001025.000000000000000,Block 1025, Block Group 1, Census Tract 63, Fulton County, Georgia,47,5,42,42,1,41,0,0
-1,131210065002020.000000000000000,Block 2020, Block Group 2, Census Tract 65, Fulton County, Georgia,47,0,47,46,13,32,0,1
-1,131210065003017.000000000000000,Block 3017, Block Group 3, Census Tract 65, Fulton County, Georgia,47,0,47,34,2,31,0,13
-1,131210066012022.000000000000000,Block 2022, Block Group 2, Census Tract 66.01, Fulton County, Georgia,47,0,47,40,26,12,0,7
-1,131210066021008.000000000000000,Block 1008, Block Group 1, Census Tract 66.02, Fulton County, Georgia,47,5,42,41,2,39,0,1
-1,131210069001006.000000000000000,Block 1006, Block Group 1, Census Tract 69, Fulton County, Georgia,47,7,40,39,35,1,0,1
-1,131210072003011.000000000000000,Block 3011, Block Group 3, Census Tract 72, Fulton County, Georgia,47,2,45,45,0,45,0,0
-1,131210073011011.000000000000000,Block 1011, Block Group 1, Census Tract 73.01, Fulton County, Georgia,47,4,43,43,0,39,0,0
-1,131210074002006.000000000000000,Block 2006, Block Group 2, Census Tract 74, Fulton County, Georgia,47,6,41,38,0,38,0,3
-1,131210077033006.000000000000000,Block 3006, Block Group 3, Census Tract 77.03, Fulton County, Georgia,47,1,46,42,1,40,0,4
-1,131210077091002.000000000000000,Block 1002, Block Group 1, Census Tract 77.09, Fulton County, Georgia,47,4,43,42,0,42,0,1
-1,131210078102001.000000000000000,Block 2001, Block Group 2, Census Tract 78.10, Fulton County, Georgia,47,6,41,40,10,30,0,1
-1,131210082041002.000000000000000,Block 1002, Block Group 1, Census Tract 82.04, Fulton County, Georgia,47,1,46,46,0,44,0,0
-1,131210086014002.000000000000000,Block 4002, Block Group 4, Census Tract 86.01, Fulton County, Georgia,47,1,46,45,1,42,2,1
-1,131210088021037.000000000000000,Block 1037, Block Group 1, Census Tract 88.02, Fulton County, Georgia,47,2,45,43,38,0,1,2
-1,131210089051003.000000000000000,Block 1003, Block Group 1, Census Tract 89.05, Fulton County, Georgia,47,4,43,41,33,4,1,2
-1,131210091051000.000000000000000,Block 1000, Block Group 1, Census Tract 91.05, Fulton County, Georgia,47,1,46,42,41,0,1,4
-1,131210097002017.000000000000000,Block 2017, Block Group 2, Census Tract 97, Fulton County, Georgia,47,5,42,39,30,4,0,3
-1,131210099005007.000000000000000,Block 5007, Block Group 5, Census Tract 99, Fulton County, Georgia,47,1,46,41,37,0,0,5
-1,131210100041003.000000000000000,Block 1003, Block Group 1, Census Tract 100.04, Fulton County, Georgia,47,1,46,44,36,0,0,2
-1,131210100051018.000000000000000,Block 1018, Block Group 1, Census Tract 100.05, Fulton County, Georgia,47,1,46,45,45,0,0,1
-1,131210100071002.000000000000000,Block 1002, Block Group 1, Census Tract 100.07, Fulton County, Georgia,47,3,44,40,38,0,0,4
-1,131210100071009.000000000000000,Block 1009, Block Group 1, Census Tract 100.07, Fulton County, Georgia,47,3,44,43,31,6,0,1
-1,131210101262002.000000000000000,Block 2002, Block Group 2, Census Tract 101.26, Fulton County, Georgia,47,11,36,22,13,2,0,14
-1,131210101271000.000000000000000,Block 1000, Block Group 1, Census Tract 101.27, Fulton County, Georgia,47,2,45,29,25,2,1,16
-1,131210101343002.000000000000000,Block 3002, Block Group 3, Census Tract 101.34, Fulton County, Georgia,47,9,38,37,19,10,4,1
-1,131210101351002.000000000000000,Block 1002, Block Group 1, Census Tract 101.35, Fulton County, Georgia,47,2,45,38,24,9,4,7
-1,131210101362009.000000000000000,Block 2009, Block Group 2, Census Tract 101.36, Fulton County, Georgia,47,6,41,40,34,4,0,1
-1,131210102213004.000000000000000,Block 3004, Block Group 3, Census Tract 102.21, Fulton County, Georgia,47,16,31,27,19,4,0,4
-1,131210102221002.000000000000000,Block 1002, Block Group 1, Census Tract 102.22, Fulton County, Georgia,47,5,42,35,29,1,1,7
-1,131210102222006.000000000000000,Block 2006, Block Group 2, Census Tract 102.22, Fulton County, Georgia,47,1,46,45,42,0,3,1
-1,131210103051017.000000000000000,Block 1017, Block Group 1, Census Tract 103.05, Fulton County, Georgia,47,0,47,46,0,43,3,1
-1,131210103081005.000000000000000,Block 1005, Block Group 1, Census Tract 103.08, Fulton County, Georgia,47,0,47,37,3,34,0,10
-1,131210103112003.000000000000000,Block 2003, Block Group 2, Census Tract 103.11, Fulton County, Georgia,47,1,46,45,3,41,0,1
-1,131210104011027.000000000000000,Block 1027, Block Group 1, Census Tract 104.01, Fulton County, Georgia,47,11,36,27,3,21,1,9
-1,131210104013001.000000000000000,Block 3001, Block Group 3, Census Tract 104.01, Fulton County, Georgia,47,0,47,47,22,25,0,0
-1,131210104013038.000000000000000,Block 3038, Block Group 3, Census Tract 104.01, Fulton County, Georgia,47,4,43,40,3,37,0,3
-1,131210104022053.000000000000000,Block 2053, Block Group 2, Census Tract 104.02, Fulton County, Georgia,47,0,47,47,12,35,0,0
-1,131210104023014.000000000000000,Block 3014, Block Group 3, Census Tract 104.02, Fulton County, Georgia,47,0,47,44,42,2,0,3
-1,131210104023019.000000000000000,Block 3019, Block Group 3, Census Tract 104.02, Fulton County, Georgia,47,0,47,47,44,3,0,0
-1,131210105082002.000000000000000,Block 2002, Block Group 2, Census Tract 105.08, Fulton County, Georgia,47,0,47,43,0,43,0,4
-1,131210105181004.000000000000000,Block 1004, Block Group 1, Census Tract 105.18, Fulton County, Georgia,47,3,44,44,0,42,2,0
-1,131210105203018.000000000000000,Block 3018, Block Group 3, Census Tract 105.20, Fulton County, Georgia,47,6,41,41,1,40,0,0
-1,131210105222033.000000000000000,Block 2033, Block Group 2, Census Tract 105.22, Fulton County, Georgia,47,3,44,36,0,35,0,8
-1,131210105251005.000000000000000,Block 1005, Block Group 1, Census Tract 105.25, Fulton County, Georgia,47,3,44,44,2,38,0,0
-1,131210105293017.000000000000000,Block 3017, Block Group 3, Census Tract 105.29, Fulton County, Georgia,47,5,42,40,0,40,0,2
-1,131210105301004.000000000000000,Block 1004, Block Group 1, Census Tract 105.30, Fulton County, Georgia,47,7,40,40,0,40,0,0
-1,131210105382003.000000000000000,Block 2003, Block Group 2, Census Tract 105.38, Fulton County, Georgia,47,1,46,46,5,41,0,0
-1,131210105392007.000000000000000,Block 2007, Block Group 2, Census Tract 105.39, Fulton County, Georgia,47,0,47,42,1,41,0,5
-1,131210105401005.000000000000000,Block 1005, Block Group 1, Census Tract 105.40, Fulton County, Georgia,47,0,47,44,3,35,5,3
-1,131210105401008.000000000000000,Block 1008, Block Group 1, Census Tract 105.40, Fulton County, Georgia,47,5,42,39,8,31,0,3
-1,131210106043011.000000000000000,Block 3011, Block Group 3, Census Tract 106.04, Fulton County, Georgia,47,6,41,38,9,28,0,3
-1,131210108012003.000000000000000,Block 2003, Block Group 2, Census Tract 108.01, Fulton County, Georgia,47,19,28,28,5,22,1,0
-1,131210108021010.000000000000000,Block 1010, Block Group 1, Census Tract 108.02, Fulton County, Georgia,47,8,39,35,12,14,0,4
-1,131210108022013.000000000000000,Block 2013, Block Group 2, Census Tract 108.02, Fulton County, Georgia,47,2,45,45,22,20,0,0
-1,131210110002001.000000000000000,Block 2001, Block Group 2, Census Tract 110, Fulton County, Georgia,47,5,42,42,0,42,0,0
-1,131210110002010.000000000000000,Block 2010, Block Group 2, Census Tract 110, Fulton County, Georgia,47,8,39,39,6,32,0,0
-1,131210112023023.000000000000000,Block 3023, Block Group 3, Census Tract 112.02, Fulton County, Georgia,47,14,33,33,0,33,0,0
-1,131210113013001.000000000000000,Block 3001, Block Group 3, Census Tract 113.01, Fulton County, Georgia,47,2,45,40,2,38,0,5
-1,131210113015004.000000000000000,Block 5004, Block Group 5, Census Tract 113.01, Fulton County, Georgia,47,7,40,40,1,39,0,0
-1,131210113071001.000000000000000,Block 1001, Block Group 1, Census Tract 113.07, Fulton County, Georgia,47,10,37,35,0,35,0,2
-1,131210114163010.000000000000000,Block 3010, Block Group 3, Census Tract 114.16, Fulton County, Georgia,47,2,45,39,32,2,0,6
-1,131210114234008.000000000000000,Block 4008, Block Group 4, Census Tract 114.23, Fulton County, Georgia,47,16,31,28,22,3,0,3
-1,131210115081003.000000000000000,Block 1003, Block Group 1, Census Tract 115.08, Fulton County, Georgia,47,3,44,44,38,3,0,0
-1,131210115092012.000000000000000,Block 2012, Block Group 2, Census Tract 115.09, Fulton County, Georgia,47,4,43,39,28,9,0,4
-1,131210115112017.000000000000000,Block 2017, Block Group 2, Census Tract 115.11, Fulton County, Georgia,47,5,42,38,21,6,0,4
-1,131210116353004.000000000000000,Block 3004, Block Group 3, Census Tract 116.35, Fulton County, Georgia,47,4,43,31,0,6,1,12
-1,131210116431002.000000000000000,Block 1002, Block Group 1, Census Tract 116.43, Fulton County, Georgia,47,8,39,38,11,5,3,1
-1,131210116473004.000000000000000,Block 3004, Block Group 3, Census Tract 116.47, Fulton County, Georgia,47,8,39,32,9,7,0,7
-1,131210116473018.000000000000000,Block 3018, Block Group 3, Census Tract 116.47, Fulton County, Georgia,47,40,7,1,0,0,0,6
-1,131210116482004.000000000000000,Block 2004, Block Group 2, Census Tract 116.48, Fulton County, Georgia,47,6,41,38,1,0,0,3
-1,131210116601013.000000000000000,Block 1013, Block Group 1, Census Tract 116.60, Fulton County, Georgia,47,3,44,39,24,0,0,5
-1,131210116601014.000000000000000,Block 1014, Block Group 1, Census Tract 116.60, Fulton County, Georgia,47,5,42,36,11,10,1,6
-1,131210120003014.000000000000000,Block 3014, Block Group 3, Census Tract 120, Fulton County, Georgia,47,0,47,47,7,40,0,0
-1,131210123002031.000000000000000,Block 2031, Block Group 2, Census Tract 123, Fulton County, Georgia,47,0,47,47,15,31,0,0
-1,131210001002010.000000000000000,Block 2010, Block Group 2, Census Tract 1, Fulton County, Georgia,46,2,44,40,32,1,2,4
-1,131210002022007.000000000000000,Block 2007, Block Group 2, Census Tract 2.02, Fulton County, Georgia,46,4,42,41,38,0,1,1
-1,131210007001025.000000000000000,Block 1025, Block Group 1, Census Tract 7, Fulton County, Georgia,46,2,44,43,1,41,0,1
-1,131210029002002.000000000000000,Block 2002, Block Group 2, Census Tract 29, Fulton County, Georgia,46,1,45,41,32,8,0,4
-1,131210039002007.000000000000000,Block 2007, Block Group 2, Census Tract 39, Fulton County, Georgia,46,6,40,39,4,35,0,1
-1,131210049002001.000000000000000,Block 2001, Block Group 2, Census Tract 49, Fulton County, Georgia,46,3,43,39,38,1,0,4
-1,131210052001004.000000000000000,Block 1004, Block Group 1, Census Tract 52, Fulton County, Georgia,46,1,45,39,38,1,0,6
-1,131210052004000.000000000000000,Block 4000, Block Group 4, Census Tract 52, Fulton County, Georgia,46,8,38,38,18,19,0,0
-1,131210052004015.000000000000000,Block 4015, Block Group 4, Census Tract 52, Fulton County, Georgia,46,4,42,41,28,13,0,1
-1,131210053001020.000000000000000,Block 1020, Block Group 1, Census Tract 53, Fulton County, Georgia,46,3,43,36,19,14,0,7
-1,131210053002012.000000000000000,Block 2012, Block Group 2, Census Tract 53, Fulton County, Georgia,46,3,43,42,18,23,0,1
-1,131210058001035.000000000000000,Block 1035, Block Group 1, Census Tract 58, Fulton County, Georgia,46,1,45,41,19,22,0,4
-1,131210060002005.000000000000000,Block 2005, Block Group 2, Census Tract 60, Fulton County, Georgia,46,0,46,46,12,33,1,0
-1,131210061003000.000000000000000,Block 3000, Block Group 3, Census Tract 61, Fulton County, Georgia,46,0,46,44,0,44,0,2
-1,131210064001014.000000000000000,Block 1014, Block Group 1, Census Tract 64, Fulton County, Georgia,46,0,46,40,16,24,0,6
-1,131210065001005.000000000000000,Block 1005, Block Group 1, Census Tract 65, Fulton County, Georgia,46,7,39,39,9,30,0,0
-1,131210075003006.000000000000000,Block 3006, Block Group 3, Census Tract 75, Fulton County, Georgia,46,2,44,43,2,36,0,1
-1,131210077033007.000000000000000,Block 3007, Block Group 3, Census Tract 77.03, Fulton County, Georgia,46,0,46,46,0,46,0,0
-1,131210077051008.000000000000000,Block 1008, Block Group 1, Census Tract 77.05, Fulton County, Georgia,46,1,45,44,1,43,0,1
-1,131210077082004.000000000000000,Block 2004, Block Group 2, Census Tract 77.08, Fulton County, Georgia,46,11,35,33,0,33,0,2
-1,131210077092003.000000000000000,Block 2003, Block Group 2, Census Tract 77.09, Fulton County, Georgia,46,2,44,43,0,43,0,1
-1,131210078072003.000000000000000,Block 2003, Block Group 2, Census Tract 78.07, Fulton County, Georgia,46,2,44,43,0,41,1,1
-1,131210079002008.000000000000000,Block 2008, Block Group 2, Census Tract 79, Fulton County, Georgia,46,0,46,40,0,36,2,6
-1,131210081041010.000000000000000,Block 1010, Block Group 1, Census Tract 81.04, Fulton County, Georgia,46,1,45,45,0,45,0,0
-1,131210081041017.000000000000000,Block 1017, Block Group 1, Census Tract 81.04, Fulton County, Georgia,46,2,44,43,0,43,0,1
-1,131210082021006.000000000000000,Block 1006, Block Group 1, Census Tract 82.02, Fulton County, Georgia,46,0,46,46,0,44,2,0
-1,131210082023003.000000000000000,Block 3003, Block Group 3, Census Tract 82.02, Fulton County, Georgia,46,4,42,42,0,42,0,0
-1,131210084001015.000000000000000,Block 1015, Block Group 1, Census Tract 84, Fulton County, Georgia,46,1,45,44,3,41,0,1
-1,131210087012005.000000000000000,Block 2005, Block Group 2, Census Tract 87.01, Fulton County, Georgia,46,1,45,42,5,35,0,3
-1,131210089052010.000000000000000,Block 2010, Block Group 2, Census Tract 89.05, Fulton County, Georgia,46,7,39,36,17,8,1,3
-1,131210089052014.000000000000000,Block 2014, Block Group 2, Census Tract 89.05, Fulton County, Georgia,46,8,38,38,32,0,0,0
-1,131210089052017.000000000000000,Block 2017, Block Group 2, Census Tract 89.05, Fulton County, Georgia,46,1,45,38,29,7,0,7
-1,131210089052021.000000000000000,Block 2021, Block Group 2, Census Tract 89.05, Fulton County, Georgia,46,2,44,34,14,10,2,10
-1,131210089062015.000000000000000,Block 2015, Block Group 2, Census Tract 89.06, Fulton County, Georgia,46,9,37,35,31,3,0,2
-1,131210095041013.000000000000000,Block 1013, Block Group 1, Census Tract 95.04, Fulton County, Georgia,46,3,43,34,18,9,6,9
-1,131210096012003.000000000000000,Block 2003, Block Group 2, Census Tract 96.01, Fulton County, Georgia,46,5,41,32,20,10,2,9
-1,131210102041001.000000000000000,Block 1001, Block Group 1, Census Tract 102.04, Fulton County, Georgia,46,4,42,40,38,2,0,2
-1,131210103051014.000000000000000,Block 1014, Block Group 1, Census Tract 103.05, Fulton County, Georgia,46,0,46,45,1,41,0,1
-1,131210103073005.000000000000000,Block 3005, Block Group 3, Census Tract 103.07, Fulton County, Georgia,46,0,46,45,0,44,1,1
-1,131210103082022.000000000000000,Block 2022, Block Group 2, Census Tract 103.08, Fulton County, Georgia,46,2,44,44,0,43,1,0
-1,131210105081013.000000000000000,Block 1013, Block Group 1, Census Tract 105.08, Fulton County, Georgia,46,1,45,40,1,39,0,5
-1,131210105301003.000000000000000,Block 1003, Block Group 1, Census Tract 105.30, Fulton County, Georgia,46,1,45,45,0,44,0,0
-1,131210105302021.000000000000000,Block 2021, Block Group 2, Census Tract 105.30, Fulton County, Georgia,46,3,43,41,0,40,0,2
-1,131210105391016.000000000000000,Block 1016, Block Group 1, Census Tract 105.39, Fulton County, Georgia,46,3,43,43,0,42,1,0
-1,131210105392020.000000000000000,Block 2020, Block Group 2, Census Tract 105.39, Fulton County, Georgia,46,2,44,41,0,39,2,3
-1,131210106013010.000000000000000,Block 3010, Block Group 3, Census Tract 106.01, Fulton County, Georgia,46,2,44,41,22,19,0,3
-1,131210108012013.000000000000000,Block 2013, Block Group 2, Census Tract 108.01, Fulton County, Georgia,46,4,42,42,28,14,0,0
-1,131210108024013.000000000000000,Block 4013, Block Group 4, Census Tract 108.02, Fulton County, Georgia,46,2,44,43,12,30,1,1
-1,131210112024000.000000000000000,Block 4000, Block Group 4, Census Tract 112.02, Fulton County, Georgia,46,11,35,34,12,17,5,1
-1,131210114234006.000000000000000,Block 4006, Block Group 4, Census Tract 114.23, Fulton County, Georgia,46,15,31,30,30,0,0,1
-1,131210115071015.000000000000000,Block 1015, Block Group 1, Census Tract 115.07, Fulton County, Georgia,46,6,40,35,30,0,2,5
-1,131210115122021.000000000000000,Block 2021, Block Group 2, Census Tract 115.12, Fulton County, Georgia,46,1,45,41,41,0,0,4
-1,131210115152006.000000000000000,Block 2006, Block Group 2, Census Tract 115.15, Fulton County, Georgia,46,2,44,42,32,6,0,2
-1,131210116314001.000000000000000,Block 4001, Block Group 4, Census Tract 116.31, Fulton County, Georgia,46,18,28,24,7,2,0,4
-1,131210116321005.000000000000000,Block 1005, Block Group 1, Census Tract 116.32, Fulton County, Georgia,46,2,44,41,7,24,0,3
-1,131210116433004.000000000000000,Block 3004, Block Group 3, Census Tract 116.43, Fulton County, Georgia,46,17,29,21,14,7,0,8
-1,131210116441001.000000000000000,Block 1001, Block Group 1, Census Tract 116.44, Fulton County, Georgia,46,7,39,39,17,8,4,0
-1,131210116453006.000000000000000,Block 3006, Block Group 3, Census Tract 116.45, Fulton County, Georgia,46,6,40,31,6,4,0,9
-1,131210116531003.000000000000000,Block 1003, Block Group 1, Census Tract 116.53, Fulton County, Georgia,46,3,43,42,17,14,0,1
-1,131210116552005.000000000000000,Block 2005, Block Group 2, Census Tract 116.55, Fulton County, Georgia,46,6,40,31,31,0,0,9
-1,131210116601002.000000000000000,Block 1002, Block Group 1, Census Tract 116.60, Fulton County, Georgia,46,2,44,42,25,6,1,2
-1,131210118021027.000000000000000,Block 1027, Block Group 1, Census Tract 118.02, Fulton County, Georgia,46,0,46,45,0,45,0,1
-1,131210120002007.000000000000000,Block 2007, Block Group 2, Census Tract 120, Fulton County, Georgia,46,5,41,41,0,41,0,0
-1,131210123003009.000000000000000,Block 3009, Block Group 3, Census Tract 123, Fulton County, Georgia,46,8,38,36,15,20,0,2
-1,131210001004010.000000000000000,Block 4010, Block Group 4, Census Tract 1, Fulton County, Georgia,45,0,45,39,37,0,0,6
-1,131210005011002.000000000000000,Block 1002, Block Group 1, Census Tract 5.01, Fulton County, Georgia,45,1,44,40,23,5,0,4
-1,131210005012013.000000000000000,Block 2013, Block Group 2, Census Tract 5.01, Fulton County, Georgia,45,5,40,40,11,21,3,0
-1,131210007001014.000000000000000,Block 1014, Block Group 1, Census Tract 7, Fulton County, Georgia,45,6,39,39,33,4,0,0
-1,131210017012008.000000000000000,Block 2008, Block Group 2, Census Tract 17.01, Fulton County, Georgia,45,5,40,39,25,9,0,1
-1,131210023002015.000000000000000,Block 2015, Block Group 2, Census Tract 23, Fulton County, Georgia,45,1,44,44,0,44,0,0
-1,131210023002017.000000000000000,Block 2017, Block Group 2, Census Tract 23, Fulton County, Georgia,45,0,45,45,0,45,0,0
-1,131210025001001.000000000000000,Block 1001, Block Group 1, Census Tract 25, Fulton County, Georgia,45,0,45,44,0,44,0,1
-1,131210031001024.000000000000000,Block 1024, Block Group 1, Census Tract 31, Fulton County, Georgia,45,2,43,42,35,7,0,1
-1,131210032001015.000000000000000,Block 1015, Block Group 1, Census Tract 32, Fulton County, Georgia,45,5,40,39,37,2,0,1
-1,131210040003003.000000000000000,Block 3003, Block Group 3, Census Tract 40, Fulton County, Georgia,45,0,45,43,8,35,0,2
-1,131210041003005.000000000000000,Block 3005, Block Group 3, Census Tract 41, Fulton County, Georgia,45,0,45,43,19,24,0,2
-1,131210041003014.000000000000000,Block 3014, Block Group 3, Census Tract 41, Fulton County, Georgia,45,0,45,42,20,22,0,3
-1,131210042002014.000000000000000,Block 2014, Block Group 2, Census Tract 42, Fulton County, Georgia,45,1,44,44,3,40,0,0
-1,131210049002018.000000000000000,Block 2018, Block Group 2, Census Tract 49, Fulton County, Georgia,45,4,41,37,36,0,0,4
-1,131210052003006.000000000000000,Block 3006, Block Group 3, Census Tract 52, Fulton County, Georgia,45,2,43,40,28,11,0,3
-1,131210053003003.000000000000000,Block 3003, Block Group 3, Census Tract 53, Fulton County, Georgia,45,2,43,42,32,6,0,1
-1,131210055012020.000000000000000,Block 2020, Block Group 2, Census Tract 55.01, Fulton County, Georgia,45,0,45,44,2,37,0,1
-1,131210060004011.000000000000000,Block 4011, Block Group 4, Census Tract 60, Fulton County, Georgia,45,2,43,43,6,37,0,0
-1,131210062001013.000000000000000,Block 1013, Block Group 1, Census Tract 62, Fulton County, Georgia,45,5,40,39,11,24,0,1
-1,131210063001028.000000000000000,Block 1028, Block Group 1, Census Tract 63, Fulton County, Georgia,45,1,44,42,6,36,0,2
-1,131210065003018.000000000000000,Block 3018, Block Group 3, Census Tract 65, Fulton County, Georgia,45,0,45,40,0,40,0,5
-1,131210069003015.000000000000000,Block 3015, Block Group 3, Census Tract 69, Fulton County, Georgia,45,6,39,37,25,12,0,2
-1,131210070023011.000000000000000,Block 3011, Block Group 3, Census Tract 70.02, Fulton County, Georgia,45,3,42,38,1,35,2,4
-1,131210071001001.000000000000000,Block 1001, Block Group 1, Census Tract 71, Fulton County, Georgia,45,8,37,32,0,30,0,5
-1,131210071002003.000000000000000,Block 2003, Block Group 2, Census Tract 71, Fulton County, Georgia,45,7,38,37,5,32,0,1
-1,131210071002013.000000000000000,Block 2013, Block Group 2, Census Tract 71, Fulton County, Georgia,45,3,42,42,2,36,4,0
-1,131210072001005.000000000000000,Block 1005, Block Group 1, Census Tract 72, Fulton County, Georgia,45,3,42,42,1,41,0,0
-1,131210072002002.000000000000000,Block 2002, Block Group 2, Census Tract 72, Fulton County, Georgia,45,0,45,42,1,39,0,3
-1,131210073014001.000000000000000,Block 4001, Block Group 4, Census Tract 73.01, Fulton County, Georgia,45,2,43,40,6,33,0,3
-1,131210073022008.000000000000000,Block 2008, Block Group 2, Census Tract 73.02, Fulton County, Georgia,45,4,41,40,0,40,0,1
-1,131210077032003.000000000000000,Block 2003, Block Group 2, Census Tract 77.03, Fulton County, Georgia,45,1,44,41,0,41,0,3
-1,131210077033012.000000000000000,Block 3012, Block Group 3, Census Tract 77.03, Fulton County, Georgia,45,0,45,44,0,44,0,1
-1,131210077092008.000000000000000,Block 2008, Block Group 2, Census Tract 77.09, Fulton County, Georgia,45,2,43,41,0,37,0,2
-1,131210078052007.000000000000000,Block 2007, Block Group 2, Census Tract 78.05, Fulton County, Georgia,45,4,41,41,0,41,0,0
-1,131210079002011.000000000000000,Block 2011, Block Group 2, Census Tract 79, Fulton County, Georgia,45,5,40,34,0,34,0,6
-1,131210081043001.000000000000000,Block 3001, Block Group 3, Census Tract 81.04, Fulton County, Georgia,45,1,44,41,0,41,0,3
-1,131210081043012.000000000000000,Block 3012, Block Group 3, Census Tract 81.04, Fulton County, Georgia,45,1,44,43,1,42,0,1
-1,131210082022005.000000000000000,Block 2005, Block Group 2, Census Tract 82.02, Fulton County, Georgia,45,4,41,38,1,36,1,3
-1,131210083012003.000000000000000,Block 2003, Block Group 2, Census Tract 83.01, Fulton County, Georgia,45,3,42,42,1,41,0,0
-1,131210083012013.000000000000000,Block 2013, Block Group 2, Census Tract 83.01, Fulton County, Georgia,45,0,45,45,6,35,1,0
-1,131210086011006.000000000000000,Block 1006, Block Group 1, Census Tract 86.01, Fulton County, Georgia,45,3,42,37,0,37,0,5
-1,131210086013019.000000000000000,Block 3019, Block Group 3, Census Tract 86.01, Fulton County, Georgia,45,3,42,40,2,38,0,2
-1,131210088021029.000000000000000,Block 1029, Block Group 1, Census Tract 88.02, Fulton County, Georgia,45,2,43,41,38,2,0,2
-1,131210091051004.000000000000000,Block 1004, Block Group 1, Census Tract 91.05, Fulton County, Georgia,45,1,44,38,33,2,0,6
-1,131210094111008.000000000000000,Block 1008, Block Group 1, Census Tract 94.11, Fulton County, Georgia,45,4,41,39,20,19,0,2
-1,131210101082002.000000000000000,Block 2002, Block Group 2, Census Tract 101.08, Fulton County, Georgia,45,2,43,43,33,2,0,0
-1,131210101251003.000000000000000,Block 1003, Block Group 1, Census Tract 101.25, Fulton County, Georgia,45,13,32,28,9,17,1,4
-1,131210101271006.000000000000000,Block 1006, Block Group 1, Census Tract 101.27, Fulton County, Georgia,45,10,35,34,26,1,0,1
-1,131210101311002.000000000000000,Block 1002, Block Group 1, Census Tract 101.31, Fulton County, Georgia,45,9,36,33,32,0,0,3
-1,131210102042015.000000000000000,Block 2015, Block Group 2, Census Tract 102.04, Fulton County, Georgia,45,2,43,40,34,2,0,3
-1,131210102114010.000000000000000,Block 4010, Block Group 4, Census Tract 102.11, Fulton County, Georgia,45,1,44,43,41,1,0,1
-1,131210103051022.000000000000000,Block 1022, Block Group 1, Census Tract 103.05, Fulton County, Georgia,45,0,45,44,0,44,0,1
-1,131210103083006.000000000000000,Block 3006, Block Group 3, Census Tract 103.08, Fulton County, Georgia,45,3,42,41,0,38,3,1
-1,131210103091010.000000000000000,Block 1010, Block Group 1, Census Tract 103.09, Fulton County, Georgia,45,2,43,41,35,6,0,2
-1,131210103103009.000000000000000,Block 3009, Block Group 3, Census Tract 103.10, Fulton County, Georgia,45,2,43,41,0,40,1,2
-1,131210103152004.000000000000000,Block 2004, Block Group 2, Census Tract 103.15, Fulton County, Georgia,45,2,43,43,2,39,2,0
-1,131210104011012.000000000000000,Block 1012, Block Group 1, Census Tract 104.01, Fulton County, Georgia,45,0,45,45,25,18,2,0
-1,131210104013013.000000000000000,Block 3013, Block Group 3, Census Tract 104.01, Fulton County, Georgia,45,29,16,13,3,10,0,3
-1,131210105191055.000000000000000,Block 1055, Block Group 1, Census Tract 105.19, Fulton County, Georgia,45,10,35,29,6,22,0,6
-1,131210105212000.000000000000000,Block 2000, Block Group 2, Census Tract 105.21, Fulton County, Georgia,45,1,44,44,2,39,3,0
-1,131210105231024.000000000000000,Block 1024, Block Group 1, Census Tract 105.23, Fulton County, Georgia,45,5,40,39,3,36,0,1
-1,131210105264015.000000000000000,Block 4015, Block Group 4, Census Tract 105.26, Fulton County, Georgia,45,14,31,31,7,24,0,0
-1,131210105301014.000000000000000,Block 1014, Block Group 1, Census Tract 105.30, Fulton County, Georgia,45,4,41,38,0,38,0,3
-1,131210105351004.000000000000000,Block 1004, Block Group 1, Census Tract 105.35, Fulton County, Georgia,45,0,45,44,0,44,0,1
-1,131210105361006.000000000000000,Block 1006, Block Group 1, Census Tract 105.36, Fulton County, Georgia,45,0,45,44,0,43,1,1
-1,131210108024016.000000000000000,Block 4016, Block Group 4, Census Tract 108.02, Fulton County, Georgia,45,18,27,27,6,21,0,0
-1,131210108024018.000000000000000,Block 4018, Block Group 4, Census Tract 108.02, Fulton County, Georgia,45,10,35,34,13,21,0,1
-1,131210111002027.000000000000000,Block 2027, Block Group 2, Census Tract 111, Fulton County, Georgia,45,7,38,33,10,23,0,5
-1,131210111002035.000000000000000,Block 2035, Block Group 2, Census Tract 111, Fulton County, Georgia,45,10,35,34,16,18,0,1
-1,131210112024013.000000000000000,Block 4013, Block Group 4, Census Tract 112.02, Fulton County, Georgia,45,8,37,34,8,26,0,3
-1,131210112025009.000000000000000,Block 5009, Block Group 5, Census Tract 112.02, Fulton County, Georgia,45,2,43,40,11,29,0,3
-1,131210112032004.000000000000000,Block 2004, Block Group 2, Census Tract 112.03, Fulton County, Georgia,45,1,44,42,15,27,0,2
-1,131210112032020.000000000000000,Block 2020, Block Group 2, Census Tract 112.03, Fulton County, Georgia,45,9,36,34,21,13,0,2
-1,131210112032021.000000000000000,Block 2021, Block Group 2, Census Tract 112.03, Fulton County, Georgia,45,5,40,40,4,36,0,0
-1,131210112042004.000000000000000,Block 2004, Block Group 2, Census Tract 112.04, Fulton County, Georgia,45,0,45,45,0,45,0,0
-1,131210114191011.000000000000000,Block 1011, Block Group 1, Census Tract 114.19, Fulton County, Georgia,45,4,41,37,33,4,0,4
-1,131210114194015.000000000000000,Block 4015, Block Group 4, Census Tract 114.19, Fulton County, Georgia,45,0,45,42,34,2,0,3
-1,131210114214005.000000000000000,Block 4005, Block Group 4, Census Tract 114.21, Fulton County, Georgia,45,5,40,38,36,0,1,2
-1,131210114223009.000000000000000,Block 3009, Block Group 3, Census Tract 114.22, Fulton County, Georgia,45,3,42,42,36,1,1,0
-1,131210114303003.000000000000000,Block 3003, Block Group 3, Census Tract 114.30, Fulton County, Georgia,45,7,38,37,12,22,3,1
-1,131210114311006.000000000000000,Block 1006, Block Group 1, Census Tract 114.31, Fulton County, Georgia,45,19,26,19,7,9,1,7
-1,131210114372010.000000000000000,Block 2010, Block Group 2, Census Tract 114.37, Fulton County, Georgia,45,31,14,13,12,1,0,1
-1,131210115071003.000000000000000,Block 1003, Block Group 1, Census Tract 115.07, Fulton County, Georgia,45,12,33,33,26,0,0,0
-1,131210115101014.000000000000000,Block 1014, Block Group 1, Census Tract 115.10, Fulton County, Georgia,45,4,41,35,35,0,0,6
-1,131210115122032.000000000000000,Block 2032, Block Group 2, Census Tract 115.12, Fulton County, Georgia,45,2,43,32,28,1,0,11
-1,131210116292002.000000000000000,Block 2002, Block Group 2, Census Tract 116.29, Fulton County, Georgia,45,7,38,31,3,2,0,7
-1,131210116383005.000000000000000,Block 3005, Block Group 3, Census Tract 116.38, Fulton County, Georgia,45,10,35,26,23,0,3,9
-1,131210116462002.000000000000000,Block 2002, Block Group 2, Census Tract 116.46, Fulton County, Georgia,45,3,42,31,20,4,1,11
-1,131210005022024.000000000000000,Block 2024, Block Group 2, Census Tract 5.02, Fulton County, Georgia,44,1,43,39,37,1,0,4
-1,131210010011009.000000000000000,Block 1009, Block Group 1, Census Tract 10.01, Fulton County, Georgia,44,3,41,37,22,8,0,4
-1,131210010012014.000000000000000,Block 2014, Block Group 2, Census Tract 10.01, Fulton County, Georgia,44,2,42,29,14,5,0,13
-1,131210024001007.000000000000000,Block 1007, Block Group 1, Census Tract 24, Fulton County, Georgia,44,3,41,40,5,33,0,1
-1,131210025001019.000000000000000,Block 1019, Block Group 1, Census Tract 25, Fulton County, Georgia,44,0,44,38,0,37,0,6
-1,131210028011007.000000000000000,Block 1007, Block Group 1, Census Tract 28.01, Fulton County, Georgia,44,0,44,44,5,39,0,0
-1,131210030002004.000000000000000,Block 2004, Block Group 2, Census Tract 30, Fulton County, Georgia,44,6,38,37,37,0,0,1
-1,131210031001022.000000000000000,Block 1022, Block Group 1, Census Tract 31, Fulton County, Georgia,44,3,41,38,27,10,1,3
-1,131210038001011.000000000000000,Block 1011, Block Group 1, Census Tract 38, Fulton County, Georgia,44,0,44,42,0,40,0,2
-1,131210038002001.000000000000000,Block 2001, Block Group 2, Census Tract 38, Fulton County, Georgia,44,1,43,40,4,36,0,3
-1,131210041001000.000000000000000,Block 1000, Block Group 1, Census Tract 41, Fulton County, Georgia,44,5,39,39,5,30,0,0
-1,131210041001009.000000000000000,Block 1009, Block Group 1, Census Tract 41, Fulton County, Georgia,44,4,40,38,11,26,1,2
-1,131210049002017.000000000000000,Block 2017, Block Group 2, Census Tract 49, Fulton County, Georgia,44,0,44,42,37,5,0,2
-1,131210050002016.000000000000000,Block 2016, Block Group 2, Census Tract 50, Fulton County, Georgia,44,9,35,31,28,0,0,4
-1,131210052004003.000000000000000,Block 4003, Block Group 4, Census Tract 52, Fulton County, Georgia,44,4,40,36,19,11,0,4
-1,131210053001013.000000000000000,Block 1013, Block Group 1, Census Tract 53, Fulton County, Georgia,44,0,44,35,17,16,0,9
-1,131210053001016.000000000000000,Block 1016, Block Group 1, Census Tract 53, Fulton County, Georgia,44,1,43,37,21,7,0,6
-1,131210063001011.000000000000000,Block 1011, Block Group 1, Census Tract 63, Fulton County, Georgia,44,3,41,38,6,32,0,3
-1,131210065002006.000000000000000,Block 2006, Block Group 2, Census Tract 65, Fulton County, Georgia,44,4,40,37,2,35,0,3
-1,131210067022006.000000000000000,Block 2006, Block Group 2, Census Tract 67.02, Fulton County, Georgia,44,1,43,40,1,37,0,3
-1,131210069001012.000000000000000,Block 1012, Block Group 1, Census Tract 69, Fulton County, Georgia,44,6,38,34,21,13,0,4
-1,131210070021008.000000000000000,Block 1008, Block Group 1, Census Tract 70.02, Fulton County, Georgia,44,4,40,37,1,36,0,3
-1,131210077072003.000000000000000,Block 2003, Block Group 2, Census Tract 77.07, Fulton County, Georgia,44,5,39,39,0,39,0,0
-1,131210077082012.000000000000000,Block 2012, Block Group 2, Census Tract 77.08, Fulton County, Georgia,44,5,39,31,9,22,0,8
-1,131210078051030.000000000000000,Block 1030, Block Group 1, Census Tract 78.05, Fulton County, Georgia,44,0,44,43,4,39,0,1
-1,131210078102004.000000000000000,Block 2004, Block Group 2, Census Tract 78.10, Fulton County, Georgia,44,1,43,40,0,40,0,3
-1,131210079004013.000000000000000,Block 4013, Block Group 4, Census Tract 79, Fulton County, Georgia,44,3,41,39,0,39,0,2
-1,131210080003005.000000000000000,Block 3005, Block Group 3, Census Tract 80, Fulton County, Georgia,44,1,43,42,4,38,0,1
-1,131210081041019.000000000000000,Block 1019, Block Group 1, Census Tract 81.04, Fulton County, Georgia,44,0,44,44,0,44,0,0
-1,131210082031006.000000000000000,Block 1006, Block Group 1, Census Tract 82.03, Fulton County, Georgia,44,1,43,39,0,39,0,4
-1,131210083022002.000000000000000,Block 2002, Block Group 2, Census Tract 83.02, Fulton County, Georgia,44,0,44,44,3,41,0,0
-1,131210086014010.000000000000000,Block 4010, Block Group 4, Census Tract 86.01, Fulton County, Georgia,44,0,44,44,4,40,0,0
-1,131210087011016.000000000000000,Block 1016, Block Group 1, Census Tract 87.01, Fulton County, Georgia,44,2,42,41,2,35,1,1
-1,131210087022016.000000000000000,Block 2016, Block Group 2, Census Tract 87.02, Fulton County, Georgia,44,0,44,41,1,40,0,3
-1,131210089031009.000000000000000,Block 1009, Block Group 1, Census Tract 89.03, Fulton County, Georgia,44,5,39,34,16,17,1,5
-1,131210089053007.000000000000000,Block 3007, Block Group 3, Census Tract 89.05, Fulton County, Georgia,44,8,36,34,32,0,0,2
-1,131210089054001.000000000000000,Block 4001, Block Group 4, Census Tract 89.05, Fulton County, Georgia,44,2,42,42,40,0,0,0
-1,131210095011019.000000000000000,Block 1019, Block Group 1, Census Tract 95.01, Fulton County, Georgia,44,1,43,42,42,0,0,1
-1,131210095013004.000000000000000,Block 3004, Block Group 3, Census Tract 95.01, Fulton County, Georgia,44,9,35,32,31,0,0,3
-1,131210095013005.000000000000000,Block 3005, Block Group 3, Census Tract 95.01, Fulton County, Georgia,44,0,44,39,39,0,0,5
-1,131210096073004.000000000000000,Block 3004, Block Group 3, Census Tract 96.07, Fulton County, Georgia,44,14,30,26,16,7,0,4
-1,131210100052009.000000000000000,Block 2009, Block Group 2, Census Tract 100.05, Fulton County, Georgia,44,3,41,38,33,0,0,3
-1,131210101241001.000000000000000,Block 1001, Block Group 1, Census Tract 101.24, Fulton County, Georgia,44,13,31,29,7,20,0,2
-1,131210101242004.000000000000000,Block 2004, Block Group 2, Census Tract 101.24, Fulton County, Georgia,44,9,35,26,8,11,1,9
-1,131210101321014.000000000000000,Block 1014, Block Group 1, Census Tract 101.32, Fulton County, Georgia,44,2,42,42,39,0,3,0
-1,131210102114008.000000000000000,Block 4008, Block Group 4, Census Tract 102.11, Fulton County, Georgia,44,2,42,41,35,5,1,1
-1,131210102171002.000000000000000,Block 1002, Block Group 1, Census Tract 102.17, Fulton County, Georgia,44,12,32,31,9,15,0,1
-1,131210103062004.000000000000000,Block 2004, Block Group 2, Census Tract 103.06, Fulton County, Georgia,44,4,40,40,0,40,0,0
-1,131210103071003.000000000000000,Block 1003, Block Group 1, Census Tract 103.07, Fulton County, Georgia,44,6,38,33,0,33,0,5
-1,131210103081009.000000000000000,Block 1009, Block Group 1, Census Tract 103.08, Fulton County, Georgia,44,4,40,38,1,32,4,2
-1,131210103091017.000000000000000,Block 1017, Block Group 1, Census Tract 103.09, Fulton County, Georgia,44,2,42,40,14,26,0,2
-1,131210103091026.000000000000000,Block 1026, Block Group 1, Census Tract 103.09, Fulton County, Georgia,44,7,37,37,0,34,0,0
-1,131210103123003.000000000000000,Block 3003, Block Group 3, Census Tract 103.12, Fulton County, Georgia,44,2,42,42,1,41,0,0
-1,131210103142002.000000000000000,Block 2002, Block Group 2, Census Tract 103.14, Fulton County, Georgia,44,4,40,33,4,27,2,7
-1,131210105082003.000000000000000,Block 2003, Block Group 2, Census Tract 105.08, Fulton County, Georgia,44,1,43,39,0,39,0,4
-1,131210105172006.000000000000000,Block 2006, Block Group 2, Census Tract 105.17, Fulton County, Georgia,44,12,32,32,4,28,0,0
-1,131210105231023.000000000000000,Block 1023, Block Group 1, Census Tract 105.23, Fulton County, Georgia,44,3,41,40,0,40,0,1
-1,131210105251003.000000000000000,Block 1003, Block Group 1, Census Tract 105.25, Fulton County, Georgia,44,0,44,33,1,31,0,11
-1,131210105271013.000000000000000,Block 1013, Block Group 1, Census Tract 105.27, Fulton County, Georgia,44,5,39,38,3,35,0,1
-1,131210105362004.000000000000000,Block 2004, Block Group 2, Census Tract 105.36, Fulton County, Georgia,44,1,43,40,12,27,1,3
-1,131210105392022.000000000000000,Block 2022, Block Group 2, Census Tract 105.39, Fulton County, Georgia,44,1,43,38,1,35,2,5
-1,131210106013009.000000000000000,Block 3009, Block Group 3, Census Tract 106.01, Fulton County, Georgia,44,1,43,42,21,18,0,1
-1,131210108024014.000000000000000,Block 4014, Block Group 4, Census Tract 108.02, Fulton County, Georgia,44,18,26,25,5,20,0,1
-1,131210110001009.000000000000000,Block 1009, Block Group 1, Census Tract 110, Fulton County, Georgia,44,4,40,37,2,35,0,3
-1,131210111002020.000000000000000,Block 2020, Block Group 2, Census Tract 111, Fulton County, Georgia,44,4,40,38,3,35,0,2
-1,131210111003014.000000000000000,Block 3014, Block Group 3, Census Tract 111, Fulton County, Georgia,44,9,35,32,14,18,0,3
-1,131210112021001.000000000000000,Block 1001, Block Group 1, Census Tract 112.02, Fulton County, Georgia,44,1,43,42,13,26,3,1
-1,131210112022003.000000000000000,Block 2003, Block Group 2, Census Tract 112.02, Fulton County, Georgia,44,8,36,35,12,22,0,1
-1,131210112024005.000000000000000,Block 4005, Block Group 4, Census Tract 112.02, Fulton County, Georgia,44,1,43,42,13,28,1,1
-1,131210113014008.000000000000000,Block 4008, Block Group 4, Census Tract 113.01, Fulton County, Georgia,44,7,37,36,1,35,0,1
-1,131210113081011.000000000000000,Block 1011, Block Group 1, Census Tract 113.08, Fulton County, Georgia,44,2,42,41,0,41,0,1
-1,131210113093009.000000000000000,Block 3009, Block Group 3, Census Tract 113.09, Fulton County, Georgia,44,2,42,36,3,30,0,6
-1,131210114173004.000000000000000,Block 3004, Block Group 3, Census Tract 114.17, Fulton County, Georgia,44,5,39,37,23,8,0,2
-1,131210114241001.000000000000000,Block 1001, Block Group 1, Census Tract 114.24, Fulton County, Georgia,44,4,40,23,18,4,0,17
-1,131210114353007.000000000000000,Block 3007, Block Group 3, Census Tract 114.35, Fulton County, Georgia,44,2,42,35,29,4,0,7
-1,131210114372003.000000000000000,Block 2003, Block Group 2, Census Tract 114.37, Fulton County, Georgia,44,18,26,25,15,10,0,1
-1,131210115102010.000000000000000,Block 2010, Block Group 2, Census Tract 115.10, Fulton County, Georgia,44,10,34,30,27,0,0,4
-1,131210115121005.000000000000000,Block 1005, Block Group 1, Census Tract 115.12, Fulton County, Georgia,44,6,38,34,28,4,1,4
-1,131210115142000.000000000000000,Block 2000, Block Group 2, Census Tract 115.14, Fulton County, Georgia,44,8,36,35,35,0,0,1
-1,131210115151004.000000000000000,Block 1004, Block Group 1, Census Tract 115.15, Fulton County, Georgia,44,8,36,27,22,2,0,9
-1,131210116372013.000000000000000,Block 2013, Block Group 2, Census Tract 116.37, Fulton County, Georgia,44,6,38,37,30,0,0,1
-1,131210116471006.000000000000000,Block 1006, Block Group 1, Census Tract 116.47, Fulton County, Georgia,44,3,41,34,24,8,2,7
-1,131210116482006.000000000000000,Block 2006, Block Group 2, Census Tract 116.48, Fulton County, Georgia,44,1,43,40,8,0,0,3
-1,131210116561001.000000000000000,Block 1001, Block Group 1, Census Tract 116.56, Fulton County, Georgia,44,3,41,41,38,3,0,0
-1,131210116592002.000000000000000,Block 2002, Block Group 2, Census Tract 116.59, Fulton County, Georgia,44,11,33,24,15,0,1,9
-1,131210116602027.000000000000000,Block 2027, Block Group 2, Census Tract 116.60, Fulton County, Georgia,44,7,37,35,32,3,0,2
-1,131210004001009.000000000000000,Block 1009, Block Group 1, Census Tract 4, Fulton County, Georgia,43,5,38,34,20,2,1,4
-1,131210005022017.000000000000000,Block 2017, Block Group 2, Census Tract 5.02, Fulton County, Georgia,43,2,41,41,40,1,0,0
-1,131210010011007.000000000000000,Block 1007, Block Group 1, Census Tract 10.01, Fulton County, Georgia,43,7,36,35,25,3,1,1
-1,131210019022005.000000000000000,Block 2005, Block Group 2, Census Tract 19.02, Fulton County, Georgia,43,4,39,32,13,10,0,7
-1,131210032002007.000000000000000,Block 2007, Block Group 2, Census Tract 32, Fulton County, Georgia,43,5,38,36,32,0,0,2
-1,131210032002011.000000000000000,Block 2011, Block Group 2, Census Tract 32, Fulton County, Georgia,43,0,43,42,37,2,0,1
-1,131210044001000.000000000000000,Block 1000, Block Group 1, Census Tract 44, Fulton County, Georgia,43,3,40,39,5,34,0,1
-1,131210050002022.000000000000000,Block 2022, Block Group 2, Census Tract 50, Fulton County, Georgia,43,10,33,32,21,8,0,1
-1,131210053002027.000000000000000,Block 2027, Block Group 2, Census Tract 53, Fulton County, Georgia,43,3,40,38,22,14,0,2
-1,131210055011013.000000000000000,Block 1013, Block Group 1, Census Tract 55.01, Fulton County, Georgia,43,0,43,40,25,15,0,3
-1,131210055012002.000000000000000,Block 2002, Block Group 2, Census Tract 55.01, Fulton County, Georgia,43,3,40,35,18,17,0,5
-1,131210055041024.000000000000000,Block 1024, Block Group 1, Census Tract 55.04, Fulton County, Georgia,43,2,41,40,3,35,0,1
-1,131210061003014.000000000000000,Block 3014, Block Group 3, Census Tract 61, Fulton County, Georgia,43,1,42,42,8,34,0,0
-1,131210065004008.000000000000000,Block 4008, Block Group 4, Census Tract 65, Fulton County, Georgia,43,8,35,33,13,20,0,2
-1,131210069001002.000000000000000,Block 1002, Block Group 1, Census Tract 69, Fulton County, Georgia,43,3,40,30,21,5,2,10
-1,131210075001019.000000000000000,Block 1019, Block Group 1, Census Tract 75, Fulton County, Georgia,43,2,41,38,3,35,0,3
-1,131210081043009.000000000000000,Block 3009, Block Group 3, Census Tract 81.04, Fulton County, Georgia,43,3,40,40,7,33,0,0
-1,131210082041010.000000000000000,Block 1010, Block Group 1, Census Tract 82.04, Fulton County, Georgia,43,5,38,38,2,36,0,0
-1,131210083013003.000000000000000,Block 3003, Block Group 3, Census Tract 83.01, Fulton County, Georgia,43,8,35,34,5,29,0,1
-1,131210084003002.000000000000000,Block 3002, Block Group 3, Census Tract 84, Fulton County, Georgia,43,1,42,41,1,40,0,1
-1,131210085001005.000000000000000,Block 1005, Block Group 1, Census Tract 85, Fulton County, Georgia,43,0,43,41,4,37,0,2
-1,131210088011005.000000000000000,Block 1005, Block Group 1, Census Tract 88.01, Fulton County, Georgia,43,5,38,33,20,10,1,5
-1,131210089053006.000000000000000,Block 3006, Block Group 3, Census Tract 89.05, Fulton County, Georgia,43,15,28,20,8,12,0,8
-1,131210092011004.000000000000000,Block 1004, Block Group 1, Census Tract 92.01, Fulton County, Georgia,43,9,34,32,16,9,0,2
-1,131210092031011.000000000000000,Block 1011, Block Group 1, Census Tract 92.03, Fulton County, Georgia,43,7,36,33,24,7,0,3
-1,131210094112002.000000000000000,Block 2002, Block Group 2, Census Tract 94.11, Fulton County, Georgia,43,10,33,25,17,6,0,8
-1,131210098031004.000000000000000,Block 1004, Block Group 1, Census Tract 98.03, Fulton County, Georgia,43,1,42,40,31,4,0,2
-1,131210100042006.000000000000000,Block 2006, Block Group 2, Census Tract 100.04, Fulton County, Georgia,43,0,43,37,36,1,0,6
-1,131210100071007.000000000000000,Block 1007, Block Group 1, Census Tract 100.07, Fulton County, Georgia,43,6,37,37,33,0,2,0
-1,131210101261003.000000000000000,Block 1003, Block Group 1, Census Tract 101.26, Fulton County, Georgia,43,10,33,22,21,0,0,11
-1,131210101321005.000000000000000,Block 1005, Block Group 1, Census Tract 101.32, Fulton County, Georgia,43,10,33,31,31,0,0,2
-1,131210101331002.000000000000000,Block 1002, Block Group 1, Census Tract 101.33, Fulton County, Georgia,43,8,35,34,22,6,0,1
-1,131210102162006.000000000000000,Block 2006, Block Group 2, Census Tract 102.16, Fulton County, Georgia,43,3,40,39,34,2,0,1
-1,131210103072018.000000000000000,Block 2018, Block Group 2, Census Tract 103.07, Fulton County, Georgia,43,0,43,38,3,35,0,5
-1,131210103081012.000000000000000,Block 1012, Block Group 1, Census Tract 103.08, Fulton County, Georgia,43,1,42,42,0,40,0,0
-1,131210103101015.000000000000000,Block 1015, Block Group 1, Census Tract 103.10, Fulton County, Georgia,43,6,37,35,1,34,0,2
-1,131210103102003.000000000000000,Block 2003, Block Group 2, Census Tract 103.10, Fulton County, Georgia,43,8,35,34,2,30,2,1
-1,131210103123002.000000000000000,Block 3002, Block Group 3, Census Tract 103.12, Fulton County, Georgia,43,2,41,41,0,41,0,0
-1,131210104022020.000000000000000,Block 2020, Block Group 2, Census Tract 104.02, Fulton County, Georgia,43,2,41,41,18,23,0,0
-1,131210104023004.000000000000000,Block 3004, Block Group 3, Census Tract 104.02, Fulton County, Georgia,43,0,43,43,26,17,0,0
-1,131210105191005.000000000000000,Block 1005, Block Group 1, Census Tract 105.19, Fulton County, Georgia,43,4,39,39,20,18,1,0
-1,131210105201000.000000000000000,Block 1000, Block Group 1, Census Tract 105.20, Fulton County, Georgia,43,8,35,28,10,18,0,7
-1,131210105201005.000000000000000,Block 1005, Block Group 1, Census Tract 105.20, Fulton County, Georgia,43,3,40,34,2,32,0,6
-1,131210105221005.000000000000000,Block 1005, Block Group 1, Census Tract 105.22, Fulton County, Georgia,43,0,43,43,2,35,0,0
-1,131210105263011.000000000000000,Block 3011, Block Group 3, Census Tract 105.26, Fulton County, Georgia,43,1,42,40,5,35,0,2
-1,131210105284004.000000000000000,Block 4004, Block Group 4, Census Tract 105.28, Fulton County, Georgia,43,3,40,36,9,27,0,4
-1,131210105343027.000000000000000,Block 3027, Block Group 3, Census Tract 105.34, Fulton County, Georgia,43,12,31,30,12,11,0,1
-1,131210105391028.000000000000000,Block 1028, Block Group 1, Census Tract 105.39, Fulton County, Georgia,43,1,42,39,0,35,4,3
-1,131210108012008.000000000000000,Block 2008, Block Group 2, Census Tract 108.01, Fulton County, Georgia,43,7,36,35,12,22,0,1
-1,131210108022004.000000000000000,Block 2004, Block Group 2, Census Tract 108.02, Fulton County, Georgia,43,8,35,32,13,14,2,3
-1,131210108024010.000000000000000,Block 4010, Block Group 4, Census Tract 108.02, Fulton County, Georgia,43,20,23,23,3,17,0,0
-1,131210110003024.000000000000000,Block 3024, Block Group 3, Census Tract 110, Fulton County, Georgia,43,3,40,37,6,31,0,3
-1,131210112021007.000000000000000,Block 1007, Block Group 1, Census Tract 112.02, Fulton County, Georgia,43,9,34,34,28,6,0,0
-1,131210112026002.000000000000000,Block 6002, Block Group 6, Census Tract 112.02, Fulton County, Georgia,43,2,41,41,20,21,0,0
-1,131210112026008.000000000000000,Block 6008, Block Group 6, Census Tract 112.02, Fulton County, Georgia,43,4,39,33,7,26,0,6
-1,131210112031018.000000000000000,Block 1018, Block Group 1, Census Tract 112.03, Fulton County, Georgia,43,14,29,28,1,26,1,1
-1,131210113011002.000000000000000,Block 1002, Block Group 1, Census Tract 113.01, Fulton County, Georgia,43,8,35,35,3,32,0,0
-1,131210113014004.000000000000000,Block 4004, Block Group 4, Census Tract 113.01, Fulton County, Georgia,43,9,34,34,3,31,0,0
-1,131210113016007.000000000000000,Block 6007, Block Group 6, Census Tract 113.01, Fulton County, Georgia,43,0,43,33,3,30,0,10
-1,131210113016010.000000000000000,Block 6010, Block Group 6, Census Tract 113.01, Fulton County, Georgia,43,2,41,34,5,26,2,7
-1,131210114161003.000000000000000,Block 1003, Block Group 1, Census Tract 114.16, Fulton County, Georgia,43,5,38,36,29,5,0,2
-1,131210114173000.000000000000000,Block 3000, Block Group 3, Census Tract 114.17, Fulton County, Georgia,43,9,34,30,25,2,0,4
-1,131210114194029.000000000000000,Block 4029, Block Group 4, Census Tract 114.19, Fulton County, Georgia,43,1,42,42,39,3,0,0
-1,131210114353004.000000000000000,Block 3004, Block Group 3, Census Tract 114.35, Fulton County, Georgia,43,3,40,39,32,5,0,1
-1,131210114371011.000000000000000,Block 1011, Block Group 1, Census Tract 114.37, Fulton County, Georgia,43,3,40,32,32,0,0,8
-1,131210115092015.000000000000000,Block 2015, Block Group 2, Census Tract 115.09, Fulton County, Georgia,43,7,36,28,24,4,0,8
-1,131210116121001.000000000000000,Block 1001, Block Group 1, Census Tract 116.12, Fulton County, Georgia,43,6,37,37,35,2,0,0
-1,131210116123003.000000000000000,Block 3003, Block Group 3, Census Tract 116.12, Fulton County, Georgia,43,0,43,42,29,7,3,1
-1,131210116353010.000000000000000,Block 3010, Block Group 3, Census Tract 116.35, Fulton County, Georgia,43,7,36,27,1,14,0,9
-1,131210116453003.000000000000000,Block 3003, Block Group 3, Census Tract 116.45, Fulton County, Georgia,43,3,40,30,14,3,0,10
-1,131210116541008.000000000000000,Block 1008, Block Group 1, Census Tract 116.54, Fulton County, Georgia,43,2,41,36,24,2,0,5
-1,131210120003042.000000000000000,Block 3042, Block Group 3, Census Tract 120, Fulton County, Georgia,43,0,43,41,0,41,0,2
-1,131210123001016.000000000000000,Block 1016, Block Group 1, Census Tract 123, Fulton County, Georgia,43,4,39,38,35,2,0,1
-1,131210123004002.000000000000000,Block 4002, Block Group 4, Census Tract 123, Fulton County, Georgia,43,0,43,43,25,18,0,0
-1,131210005022028.000000000000000,Block 2028, Block Group 2, Census Tract 5.02, Fulton County, Georgia,42,6,36,36,36,0,0,0
-1,131210006013007.000000000000000,Block 3007, Block Group 3, Census Tract 6.01, Fulton County, Georgia,42,4,38,36,21,6,0,2
-1,131210010021008.000000000000000,Block 1008, Block Group 1, Census Tract 10.02, Fulton County, Georgia,42,1,41,35,26,1,0,6
-1,131210018021002.000000000000000,Block 1002, Block Group 1, Census Tract 18.02, Fulton County, Georgia,42,5,37,33,27,5,0,4
-1,131210025002013.000000000000000,Block 2013, Block Group 2, Census Tract 25, Fulton County, Georgia,42,5,37,34,0,34,0,3
-1,131210026001014.000000000000000,Block 1014, Block Group 1, Census Tract 26, Fulton County, Georgia,42,2,40,40,6,34,0,0
-1,131210030002008.000000000000000,Block 2008, Block Group 2, Census Tract 30, Fulton County, Georgia,42,10,32,26,18,5,0,6
-1,131210031002006.000000000000000,Block 2006, Block Group 2, Census Tract 31, Fulton County, Georgia,42,2,40,36,23,3,0,4
-1,131210032002015.000000000000000,Block 2015, Block Group 2, Census Tract 32, Fulton County, Georgia,42,3,39,38,36,1,0,1
-1,131210032002016.000000000000000,Block 2016, Block Group 2, Census Tract 32, Fulton County, Georgia,42,4,38,35,35,0,0,3
-1,131210040001013.000000000000000,Block 1013, Block Group 1, Census Tract 40, Fulton County, Georgia,42,1,41,40,4,35,1,1
-1,131210040003005.000000000000000,Block 3005, Block Group 3, Census Tract 40, Fulton County, Georgia,42,0,42,40,7,33,0,2
-1,131210042002013.000000000000000,Block 2013, Block Group 2, Census Tract 42, Fulton County, Georgia,42,0,42,42,1,36,0,0
-1,131210049002027.000000000000000,Block 2027, Block Group 2, Census Tract 49, Fulton County, Georgia,42,1,41,37,37,0,0,4
-1,131210052003008.000000000000000,Block 3008, Block Group 3, Census Tract 52, Fulton County, Georgia,42,1,41,39,29,8,0,2
-1,131210053001015.000000000000000,Block 1015, Block Group 1, Census Tract 53, Fulton County, Georgia,42,2,40,37,32,5,0,3
-1,131210053002028.000000000000000,Block 2028, Block Group 2, Census Tract 53, Fulton County, Georgia,42,2,40,38,16,19,3,2
-1,131210053003002.000000000000000,Block 3002, Block Group 3, Census Tract 53, Fulton County, Georgia,42,5,37,33,28,4,1,4
-1,131210060004008.000000000000000,Block 4008, Block Group 4, Census Tract 60, Fulton County, Georgia,42,3,39,35,12,22,0,4
-1,131210064001005.000000000000000,Block 1005, Block Group 1, Census Tract 64, Fulton County, Georgia,42,8,34,34,1,33,0,0
-1,131210065002011.000000000000000,Block 2011, Block Group 2, Census Tract 65, Fulton County, Georgia,42,0,42,42,2,40,0,0
-1,131210065002013.000000000000000,Block 2013, Block Group 2, Census Tract 65, Fulton County, Georgia,42,0,42,40,4,36,0,2
-1,131210066012012.000000000000000,Block 2012, Block Group 2, Census Tract 66.01, Fulton County, Georgia,42,3,39,39,6,33,0,0
-1,131210067011002.000000000000000,Block 1002, Block Group 1, Census Tract 67.01, Fulton County, Georgia,42,4,38,31,0,29,2,7
-1,131210067011003.000000000000000,Block 1003, Block Group 1, Census Tract 67.01, Fulton County, Georgia,42,1,41,39,0,39,0,2
-1,131210070011007.000000000000000,Block 1007, Block Group 1, Census Tract 70.01, Fulton County, Georgia,42,0,42,39,0,38,1,3
-1,131210070022000.000000000000000,Block 2000, Block Group 2, Census Tract 70.02, Fulton County, Georgia,42,8,34,32,4,27,1,2
-1,131210072003010.000000000000000,Block 3010, Block Group 3, Census Tract 72, Fulton County, Georgia,42,3,39,36,0,36,0,3
-1,131210073021002.000000000000000,Block 1002, Block Group 1, Census Tract 73.02, Fulton County, Georgia,42,1,41,34,4,30,0,7
-1,131210077071006.000000000000000,Block 1006, Block Group 1, Census Tract 77.07, Fulton County, Georgia,42,0,42,42,0,42,0,0
-1,131210077072015.000000000000000,Block 2015, Block Group 2, Census Tract 77.07, Fulton County, Georgia,42,2,40,38,0,38,0,2
-1,131210077112008.000000000000000,Block 2008, Block Group 2, Census Tract 77.11, Fulton County, Georgia,42,1,41,41,6,35,0,0
-1,131210081042005.000000000000000,Block 2005, Block Group 2, Census Tract 81.04, Fulton County, Georgia,42,1,41,38,1,37,0,3
-1,131210085002002.000000000000000,Block 2002, Block Group 2, Census Tract 85, Fulton County, Georgia,42,0,42,41,9,32,0,1
-1,131210086013016.000000000000000,Block 3016, Block Group 3, Census Tract 86.01, Fulton County, Georgia,42,1,41,41,4,36,1,0
-1,131210086014012.000000000000000,Block 4012, Block Group 4, Census Tract 86.01, Fulton County, Georgia,42,0,42,40,1,37,0,2
-1,131210088022004.000000000000000,Block 2004, Block Group 2, Census Tract 88.02, Fulton County, Georgia,42,5,37,36,31,5,0,1
-1,131210089054013.000000000000000,Block 4013, Block Group 4, Census Tract 89.05, Fulton County, Georgia,42,2,40,40,25,14,0,0
-1,131210089081001.000000000000000,Block 1001, Block Group 1, Census Tract 89.08, Fulton County, Georgia,42,8,34,25,17,7,0,9
-1,131210089091010.000000000000000,Block 1010, Block Group 1, Census Tract 89.09, Fulton County, Georgia,42,5,37,36,29,0,2,1
-1,131210100051007.000000000000000,Block 1007, Block Group 1, Census Tract 100.05, Fulton County, Georgia,42,5,37,37,37,0,0,0
-1,131210101282000.000000000000000,Block 2000, Block Group 2, Census Tract 101.28, Fulton County, Georgia,42,9,33,23,7,15,1,10
-1,131210101341001.000000000000000,Block 1001, Block Group 1, Census Tract 101.34, Fulton County, Georgia,42,3,39,37,8,26,3,2
-1,131210102044001.000000000000000,Block 4001, Block Group 4, Census Tract 102.04, Fulton County, Georgia,42,4,38,38,37,0,1,0
-1,131210102171003.000000000000000,Block 1003, Block Group 1, Census Tract 102.17, Fulton County, Georgia,42,2,40,34,9,17,0,6
-1,131210102211006.000000000000000,Block 1006, Block Group 1, Census Tract 102.21, Fulton County, Georgia,42,2,40,29,23,0,2,11
-1,131210103091040.000000000000000,Block 1040, Block Group 1, Census Tract 103.09, Fulton County, Georgia,42,7,35,34,32,0,1,1
-1,131210104021004.000000000000000,Block 1004, Block Group 1, Census Tract 104.02, Fulton County, Georgia,42,2,40,37,32,5,0,3
-1,131210104022019.000000000000000,Block 2019, Block Group 2, Census Tract 104.02, Fulton County, Georgia,42,4,38,38,32,5,0,0
-1,131210105083017.000000000000000,Block 3017, Block Group 3, Census Tract 105.08, Fulton County, Georgia,42,1,41,40,0,40,0,1
-1,131210105181003.000000000000000,Block 1003, Block Group 1, Census Tract 105.18, Fulton County, Georgia,42,2,40,40,0,37,3,0
-1,131210105202006.000000000000000,Block 2006, Block Group 2, Census Tract 105.20, Fulton County, Georgia,42,6,36,35,1,34,0,1
-1,131210105231025.000000000000000,Block 1025, Block Group 1, Census Tract 105.23, Fulton County, Georgia,42,0,42,41,3,36,0,1
-1,131210105262012.000000000000000,Block 2012, Block Group 2, Census Tract 105.26, Fulton County, Georgia,42,1,41,39,0,39,0,2
-1,131210105352014.000000000000000,Block 2014, Block Group 2, Census Tract 105.35, Fulton County, Georgia,42,14,28,24,6,17,1,4
-1,131210105381012.000000000000000,Block 1012, Block Group 1, Census Tract 105.38, Fulton County, Georgia,42,0,42,39,30,9,0,3
-1,131210106014002.000000000000000,Block 4002, Block Group 4, Census Tract 106.01, Fulton County, Georgia,42,2,40,40,4,31,5,0
-1,131210110002023.000000000000000,Block 2023, Block Group 2, Census Tract 110, Fulton County, Georgia,42,0,42,41,0,41,0,1
-1,131210111002004.000000000000000,Block 2004, Block Group 2, Census Tract 111, Fulton County, Georgia,42,4,38,38,21,17,0,0
-1,131210112024014.000000000000000,Block 4014, Block Group 4, Census Tract 112.02, Fulton County, Georgia,42,0,42,35,5,30,0,7
-1,131210113093005.000000000000000,Block 3005, Block Group 3, Census Tract 113.09, Fulton County, Georgia,42,4,38,35,0,33,0,3
-1,131210113102003.000000000000000,Block 2003, Block Group 2, Census Tract 113.10, Fulton County, Georgia,42,0,42,39,3,36,0,3
-1,131210114161002.000000000000000,Block 1002, Block Group 1, Census Tract 114.16, Fulton County, Georgia,42,2,40,31,25,5,1,9
-1,131210114172002.000000000000000,Block 2002, Block Group 2, Census Tract 114.17, Fulton County, Georgia,42,17,25,23,20,2,0,2
-1,131210114194014.000000000000000,Block 4014, Block Group 4, Census Tract 114.19, Fulton County, Georgia,42,3,39,39,34,5,0,0
-1,131210114322004.000000000000000,Block 2004, Block Group 2, Census Tract 114.32, Fulton County, Georgia,42,1,41,34,12,18,0,7
-1,131210114323001.000000000000000,Block 3001, Block Group 3, Census Tract 114.32, Fulton County, Georgia,42,5,37,25,19,1,0,12
-1,131210114392001.000000000000000,Block 2001, Block Group 2, Census Tract 114.39, Fulton County, Georgia,42,10,32,18,8,0,0,14
-1,131210115082004.000000000000000,Block 2004, Block Group 2, Census Tract 115.08, Fulton County, Georgia,42,8,34,28,26,0,0,6
-1,131210115101023.000000000000000,Block 1023, Block Group 1, Census Tract 115.10, Fulton County, Georgia,42,1,41,40,27,6,0,1
-1,131210115131014.000000000000000,Block 1014, Block Group 1, Census Tract 115.13, Fulton County, Georgia,42,9,33,31,27,2,1,2
-1,131210116441014.000000000000000,Block 1014, Block Group 1, Census Tract 116.44, Fulton County, Georgia,42,14,28,21,5,1,0,7
-1,131210116462008.000000000000000,Block 2008, Block Group 2, Census Tract 116.46, Fulton County, Georgia,42,14,28,17,12,2,3,11
-1,131210116551014.000000000000000,Block 1014, Block Group 1, Census Tract 116.55, Fulton County, Georgia,42,6,36,28,28,0,0,8
-1,131210116601004.000000000000000,Block 1004, Block Group 1, Census Tract 116.60, Fulton County, Georgia,42,6,36,34,26,5,0,2
-1,131210123001007.000000000000000,Block 1007, Block Group 1, Census Tract 123, Fulton County, Georgia,42,5,37,37,14,22,1,0
-1,131210002012008.000000000000000,Block 2008, Block Group 2, Census Tract 2.01, Fulton County, Georgia,41,4,37,29,27,2,0,8
-1,131210006012002.000000000000000,Block 2002, Block Group 2, Census Tract 6.01, Fulton County, Georgia,41,2,39,38,25,0,3,1
-1,131210006013002.000000000000000,Block 3002, Block Group 3, Census Tract 6.01, Fulton County, Georgia,41,0,41,41,28,1,0,0
-1,131210017011007.000000000000000,Block 1007, Block Group 1, Census Tract 17.01, Fulton County, Georgia,41,13,28,24,24,0,0,4
-1,131210038001017.000000000000000,Block 1017, Block Group 1, Census Tract 38, Fulton County, Georgia,41,0,41,40,4,36,0,1
-1,131210039002000.000000000000000,Block 2000, Block Group 2, Census Tract 39, Fulton County, Georgia,41,5,36,34,8,25,0,2
-1,131210040001005.000000000000000,Block 1005, Block Group 1, Census Tract 40, Fulton County, Georgia,41,0,41,41,0,39,2,0
-1,131210040002009.000000000000000,Block 2009, Block Group 2, Census Tract 40, Fulton County, Georgia,41,2,39,39,8,31,0,0
-1,131210040002012.000000000000000,Block 2012, Block Group 2, Census Tract 40, Fulton County, Georgia,41,6,35,30,11,19,0,5
-1,131210050001015.000000000000000,Block 1015, Block Group 1, Census Tract 50, Fulton County, Georgia,41,5,36,36,36,0,0,0
-1,131210050002007.000000000000000,Block 2007, Block Group 2, Census Tract 50, Fulton County, Georgia,41,7,34,34,31,1,0,0
-1,131210052001000.000000000000000,Block 1000, Block Group 1, Census Tract 52, Fulton County, Georgia,41,0,41,22,22,0,0,19
-1,131210053001018.000000000000000,Block 1018, Block Group 1, Census Tract 53, Fulton County, Georgia,41,4,37,27,12,12,0,10
-1,131210053003001.000000000000000,Block 3001, Block Group 3, Census Tract 53, Fulton County, Georgia,41,2,39,38,34,4,0,1
-1,131210058001039.000000000000000,Block 1039, Block Group 1, Census Tract 58, Fulton County, Georgia,41,6,35,34,14,18,2,1
-1,131210061001008.000000000000000,Block 1008, Block Group 1, Census Tract 61, Fulton County, Georgia,41,0,41,40,5,34,0,1
-1,131210061002011.000000000000000,Block 2011, Block Group 2, Census Tract 61, Fulton County, Georgia,41,0,41,41,3,38,0,0
-1,131210065003008.000000000000000,Block 3008, Block Group 3, Census Tract 65, Fulton County, Georgia,41,1,40,36,14,22,0,4
-1,131210065004010.000000000000000,Block 4010, Block Group 4, Census Tract 65, Fulton County, Georgia,41,0,41,41,14,27,0,0
-1,131210065004016.000000000000000,Block 4016, Block Group 4, Census Tract 65, Fulton County, Georgia,41,6,35,33,9,20,2,2
-1,131210066012002.000000000000000,Block 2002, Block Group 2, Census Tract 66.01, Fulton County, Georgia,41,1,40,40,6,32,0,0
-1,131210070013001.000000000000000,Block 3001, Block Group 3, Census Tract 70.01, Fulton County, Georgia,41,7,34,34,0,31,0,0
-1,131210070022002.000000000000000,Block 2002, Block Group 2, Census Tract 70.02, Fulton County, Georgia,41,2,39,36,3,32,1,3
-1,131210070022004.000000000000000,Block 2004, Block Group 2, Census Tract 70.02, Fulton County, Georgia,41,5,36,34,1,32,0,2
-1,131210070022007.000000000000000,Block 2007, Block Group 2, Census Tract 70.02, Fulton County, Georgia,41,0,41,35,3,32,0,6
-1,131210077072002.000000000000000,Block 2002, Block Group 2, Census Tract 77.07, Fulton County, Georgia,41,4,37,34,0,34,0,3
-1,131210078101006.000000000000000,Block 1006, Block Group 1, Census Tract 78.10, Fulton County, Georgia,41,0,41,39,2,31,3,2
-1,131210078102008.000000000000000,Block 2008, Block Group 2, Census Tract 78.10, Fulton County, Georgia,41,0,41,39,0,39,0,2
-1,131210080004000.000000000000000,Block 4000, Block Group 4, Census Tract 80, Fulton County, Georgia,41,0,41,37,4,32,0,4
-1,131210082032008.000000000000000,Block 2008, Block Group 2, Census Tract 82.03, Fulton County, Georgia,41,2,39,38,1,36,0,1
-1,131210086014000.000000000000000,Block 4000, Block Group 4, Census Tract 86.01, Fulton County, Georgia,41,0,41,41,1,40,0,0
-1,131210088022002.000000000000000,Block 2002, Block Group 2, Census Tract 88.02, Fulton County, Georgia,41,5,36,34,33,0,1,2
-1,131210089061004.000000000000000,Block 1004, Block Group 1, Census Tract 89.06, Fulton County, Georgia,41,2,39,34,30,1,0,5
-1,131210089091013.000000000000000,Block 1013, Block Group 1, Census Tract 89.09, Fulton County, Georgia,41,8,33,32,32,0,0,1
-1,131210090021019.000000000000000,Block 1019, Block Group 1, Census Tract 90.02, Fulton County, Georgia,41,7,34,31,16,9,3,3
-1,131210092021005.000000000000000,Block 1005, Block Group 1, Census Tract 92.02, Fulton County, Georgia,41,2,39,38,35,2,0,1
-1,131210098021002.000000000000000,Block 1002, Block Group 1, Census Tract 98.02, Fulton County, Georgia,41,6,35,35,34,0,0,0
-1,131210100071006.000000000000000,Block 1006, Block Group 1, Census Tract 100.07, Fulton County, Georgia,41,6,35,33,31,0,1,2
-1,131210101152020.000000000000000,Block 2020, Block Group 2, Census Tract 101.15, Fulton County, Georgia,41,0,41,35,33,2,0,6
-1,131210101211008.000000000000000,Block 1008, Block Group 1, Census Tract 101.21, Fulton County, Georgia,41,5,36,30,26,4,0,6
-1,131210101273003.000000000000000,Block 3003, Block Group 3, Census Tract 101.27, Fulton County, Georgia,41,4,37,37,24,3,0,0
-1,131210103051008.000000000000000,Block 1008, Block Group 1, Census Tract 103.05, Fulton County, Georgia,41,0,41,41,1,40,0,0
-1,131210103071001.000000000000000,Block 1001, Block Group 1, Census Tract 103.07, Fulton County, Georgia,41,0,41,41,1,40,0,0
-1,131210103083019.000000000000000,Block 3019, Block Group 3, Census Tract 103.08, Fulton County, Georgia,41,3,38,33,0,33,0,5
-1,131210103092026.000000000000000,Block 2026, Block Group 2, Census Tract 103.09, Fulton County, Georgia,41,0,41,40,5,35,0,1
-1,131210103102004.000000000000000,Block 2004, Block Group 2, Census Tract 103.10, Fulton County, Georgia,41,5,36,35,0,34,0,1
-1,131210105081005.000000000000000,Block 1005, Block Group 1, Census Tract 105.08, Fulton County, Georgia,41,1,40,40,0,40,0,0
-1,131210105082007.000000000000000,Block 2007, Block Group 2, Census Tract 105.08, Fulton County, Georgia,41,4,37,34,0,34,0,3
-1,131210105191004.000000000000000,Block 1004, Block Group 1, Census Tract 105.19, Fulton County, Georgia,41,8,33,32,12,19,1,1
-1,131210105192015.000000000000000,Block 2015, Block Group 2, Census Tract 105.19, Fulton County, Georgia,41,2,39,37,0,36,1,2
-1,131210105332012.000000000000000,Block 2012, Block Group 2, Census Tract 105.33, Fulton County, Georgia,41,9,32,28,0,28,0,4
-1,131210105352011.000000000000000,Block 2011, Block Group 2, Census Tract 105.35, Fulton County, Georgia,41,2,39,38,1,37,0,1
-1,131210105391019.000000000000000,Block 1019, Block Group 1, Census Tract 105.39, Fulton County, Georgia,41,4,37,35,0,35,0,2
-1,131210105391020.000000000000000,Block 1020, Block Group 1, Census Tract 105.39, Fulton County, Georgia,41,2,39,39,0,36,3,0
-1,131210108012019.000000000000000,Block 2019, Block Group 2, Census Tract 108.01, Fulton County, Georgia,41,20,21,21,12,7,0,0
-1,131210108023018.000000000000000,Block 3018, Block Group 3, Census Tract 108.02, Fulton County, Georgia,41,18,23,23,19,0,0,0
-1,131210108024012.000000000000000,Block 4012, Block Group 4, Census Tract 108.02, Fulton County, Georgia,41,15,26,24,6,17,0,2
-1,131210110002021.000000000000000,Block 2021, Block Group 2, Census Tract 110, Fulton County, Georgia,41,7,34,34,0,33,1,0
-1,131210111003005.000000000000000,Block 3005, Block Group 3, Census Tract 111, Fulton County, Georgia,41,4,37,34,13,21,0,3
-1,131210112025008.000000000000000,Block 5008, Block Group 5, Census Tract 112.02, Fulton County, Georgia,41,5,36,36,0,36,0,0
-1,131210112026012.000000000000000,Block 6012, Block Group 6, Census Tract 112.02, Fulton County, Georgia,41,5,36,36,10,26,0,0
-1,131210114241009.000000000000000,Block 1009, Block Group 1, Census Tract 114.24, Fulton County, Georgia,41,13,28,14,7,4,2,14
-1,131210114351000.000000000000000,Block 1000, Block Group 1, Census Tract 114.35, Fulton County, Georgia,41,16,25,12,6,0,0,13
-1,131210114413004.000000000000000,Block 3004, Block Group 3, Census Tract 114.41, Fulton County, Georgia,41,14,27,23,16,4,1,4
-1,131210114441001.000000000000000,Block 1001, Block Group 1, Census Tract 114.44, Fulton County, Georgia,41,1,40,36,7,7,0,4
-1,131210116271007.000000000000000,Block 1007, Block Group 1, Census Tract 116.27, Fulton County, Georgia,41,3,38,29,14,3,0,9
-1,131210116372011.000000000000000,Block 2011, Block Group 2, Census Tract 116.37, Fulton County, Georgia,41,8,33,30,19,3,0,3
-1,131210116423004.000000000000000,Block 3004, Block Group 3, Census Tract 116.42, Fulton County, Georgia,41,9,32,31,12,5,2,1
-1,131210116423008.000000000000000,Block 3008, Block Group 3, Census Tract 116.42, Fulton County, Georgia,41,11,30,27,8,13,0,3
-1,131210116473009.000000000000000,Block 3009, Block Group 3, Census Tract 116.47, Fulton County, Georgia,41,13,28,24,22,1,0,4
-1,131210116474010.000000000000000,Block 4010, Block Group 4, Census Tract 116.47, Fulton County, Georgia,41,17,24,21,8,5,1,3
-1,131210116552000.000000000000000,Block 2000, Block Group 2, Census Tract 116.55, Fulton County, Georgia,41,8,33,26,22,3,0,7
-1,131210002011004.000000000000000,Block 1004, Block Group 1, Census Tract 2.01, Fulton County, Georgia,40,5,35,35,24,0,0,0
-1,131210013011007.000000000000000,Block 1007, Block Group 1, Census Tract 13.01, Fulton County, Georgia,40,0,40,38,27,3,0,2
-1,131210013022009.000000000000000,Block 2009, Block Group 2, Census Tract 13.02, Fulton County, Georgia,40,5,35,29,25,0,4,6
-1,131210019023011.000000000000000,Block 3011, Block Group 3, Census Tract 19.02, Fulton County, Georgia,40,0,40,39,15,24,0,1
-1,131210023001007.000000000000000,Block 1007, Block Group 1, Census Tract 23, Fulton County, Georgia,40,1,39,39,0,39,0,0
-1,131210024001008.000000000000000,Block 1008, Block Group 1, Census Tract 24, Fulton County, Georgia,40,0,40,38,3,35,0,2
-1,131210029001014.000000000000000,Block 1014, Block Group 1, Census Tract 29, Fulton County, Georgia,40,7,33,27,18,7,0,6
-1,131210030001017.000000000000000,Block 1017, Block Group 1, Census Tract 30, Fulton County, Georgia,40,1,39,33,23,7,0,6
-1,131210030001023.000000000000000,Block 1023, Block Group 1, Census Tract 30, Fulton County, Georgia,40,2,38,34,31,3,0,4
-1,131210031001025.000000000000000,Block 1025, Block Group 1, Census Tract 31, Fulton County, Georgia,40,6,34,25,17,7,1,9
-1,131210040001014.000000000000000,Block 1014, Block Group 1, Census Tract 40, Fulton County, Georgia,40,5,35,34,0,32,2,1
-1,131210040001021.000000000000000,Block 1021, Block Group 1, Census Tract 40, Fulton County, Georgia,40,0,40,40,0,39,0,0
-1,131210040003008.000000000000000,Block 3008, Block Group 3, Census Tract 40, Fulton County, Georgia,40,0,40,37,2,35,0,3
-1,131210050002005.000000000000000,Block 2005, Block Group 2, Census Tract 50, Fulton County, Georgia,40,4,36,35,35,0,0,1
-1,131210052003012.000000000000000,Block 3012, Block Group 3, Census Tract 52, Fulton County, Georgia,40,2,38,38,26,8,0,0
-1,131210057002009.000000000000000,Block 2009, Block Group 2, Census Tract 57, Fulton County, Georgia,40,1,39,36,0,34,0,3
-1,131210064001012.000000000000000,Block 1012, Block Group 1, Census Tract 64, Fulton County, Georgia,40,29,11,8,8,0,0,3
-1,131210065003013.000000000000000,Block 3013, Block Group 3, Census Tract 65, Fulton County, Georgia,40,0,40,40,8,32,0,0
-1,131210066012005.000000000000000,Block 2005, Block Group 2, Census Tract 66.01, Fulton County, Georgia,40,0,40,40,2,32,3,0
-1,131210067011004.000000000000000,Block 1004, Block Group 1, Census Tract 67.01, Fulton County, Georgia,40,0,40,39,0,36,1,1
-1,131210069003022.000000000000000,Block 3022, Block Group 3, Census Tract 69, Fulton County, Georgia,40,9,31,31,14,17,0,0
-1,131210072003012.000000000000000,Block 3012, Block Group 3, Census Tract 72, Fulton County, Georgia,40,1,39,39,0,37,2,0
-1,131210075002006.000000000000000,Block 2006, Block Group 2, Census Tract 75, Fulton County, Georgia,40,2,38,34,0,30,0,4
-1,131210075003007.000000000000000,Block 3007, Block Group 3, Census Tract 75, Fulton County, Georgia,40,0,40,39,7,32,0,1
-1,131210077072007.000000000000000,Block 2007, Block Group 2, Census Tract 77.07, Fulton County, Georgia,40,2,38,37,0,37,0,1
-1,131210078061014.000000000000000,Block 1014, Block Group 1, Census Tract 78.06, Fulton County, Georgia,40,10,30,27,0,27,0,3
-1,131210078071000.000000000000000,Block 1000, Block Group 1, Census Tract 78.07, Fulton County, Georgia,40,10,30,30,1,29,0,0
-1,131210078091002.000000000000000,Block 1002, Block Group 1, Census Tract 78.09, Fulton County, Georgia,40,1,39,39,7,29,3,0
-1,131210079003003.000000000000000,Block 3003, Block Group 3, Census Tract 79, Fulton County, Georgia,40,2,38,35,0,35,0,3
-1,131210080004002.000000000000000,Block 4002, Block Group 4, Census Tract 80, Fulton County, Georgia,40,0,40,39,8,31,0,1
-1,131210080004010.000000000000000,Block 4010, Block Group 4, Census Tract 80, Fulton County, Georgia,40,2,38,35,1,34,0,3
-1,131210082032005.000000000000000,Block 2005, Block Group 2, Census Tract 82.03, Fulton County, Georgia,40,2,38,29,2,26,0,9
-1,131210082042014.000000000000000,Block 2014, Block Group 2, Census Tract 82.04, Fulton County, Georgia,40,1,39,38,0,38,0,1
-1,131210082043002.000000000000000,Block 3002, Block Group 3, Census Tract 82.04, Fulton County, Georgia,40,0,40,38,1,37,0,2
-1,131210083011007.000000000000000,Block 1007, Block Group 1, Census Tract 83.01, Fulton County, Georgia,40,7,33,32,0,32,0,1
-1,131210084001007.000000000000000,Block 1007, Block Group 1, Census Tract 84, Fulton County, Georgia,40,3,37,36,0,36,0,1
-1,131210086012023.000000000000000,Block 2023, Block Group 2, Census Tract 86.01, Fulton County, Georgia,40,2,38,37,0,37,0,1
-1,131210087011014.000000000000000,Block 1014, Block Group 1, Census Tract 87.01, Fulton County, Georgia,40,1,39,36,2,32,0,3
-1,131210087022001.000000000000000,Block 2001, Block Group 2, Census Tract 87.02, Fulton County, Georgia,40,3,37,32,20,10,0,5
-1,131210087022004.000000000000000,Block 2004, Block Group 2, Census Tract 87.02, Fulton County, Georgia,40,0,40,37,25,8,0,3
-1,131210090011002.000000000000000,Block 1002, Block Group 1, Census Tract 90.01, Fulton County, Georgia,40,3,37,37,29,8,0,0
-1,131210097003020.000000000000000,Block 3020, Block Group 3, Census Tract 97, Fulton County, Georgia,40,0,40,37,33,1,0,3
-1,131210099001003.000000000000000,Block 1003, Block Group 1, Census Tract 99, Fulton County, Georgia,40,1,39,38,32,5,0,1
-1,131210101271004.000000000000000,Block 1004, Block Group 1, Census Tract 101.27, Fulton County, Georgia,40,11,29,26,10,1,0,3
-1,131210101312002.000000000000000,Block 2002, Block Group 2, Census Tract 101.31, Fulton County, Georgia,40,1,39,36,35,0,0,3
-1,131210101332005.000000000000000,Block 2005, Block Group 2, Census Tract 101.33, Fulton County, Georgia,40,0,40,37,31,0,3,3
-1,131210101362013.000000000000000,Block 2013, Block Group 2, Census Tract 101.36, Fulton County, Georgia,40,5,35,34,33,0,0,1
-1,131210102114006.000000000000000,Block 4006, Block Group 4, Census Tract 102.11, Fulton County, Georgia,40,3,37,35,33,0,0,2
-1,131210102233012.000000000000000,Block 3012, Block Group 3, Census Tract 102.23, Fulton County, Georgia,40,1,39,37,28,8,0,2
-1,131210103072001.000000000000000,Block 2001, Block Group 2, Census Tract 103.07, Fulton County, Georgia,40,3,37,37,0,36,0,0
-1,131210103083007.000000000000000,Block 3007, Block Group 3, Census Tract 103.08, Fulton County, Georgia,40,1,39,37,0,36,1,2
-1,131210103103008.000000000000000,Block 3008, Block Group 3, Census Tract 103.10, Fulton County, Georgia,40,0,40,38,0,38,0,2
-1,131210103111006.000000000000000,Block 1006, Block Group 1, Census Tract 103.11, Fulton County, Georgia,40,1,39,39,2,35,2,0
-1,131210104021019.000000000000000,Block 1019, Block Group 1, Census Tract 104.02, Fulton County, Georgia,40,4,36,36,34,2,0,0
-1,131210105201009.000000000000000,Block 1009, Block Group 1, Census Tract 105.20, Fulton County, Georgia,40,2,38,37,0,35,2,1
-1,131210105223006.000000000000000,Block 3006, Block Group 3, Census Tract 105.22, Fulton County, Georgia,40,1,39,38,0,34,3,1
-1,131210105242002.000000000000000,Block 2002, Block Group 2, Census Tract 105.24, Fulton County, Georgia,40,8,32,31,0,29,0,1
-1,131210105251004.000000000000000,Block 1004, Block Group 1, Census Tract 105.25, Fulton County, Georgia,40,0,40,38,3,35,0,2
-1,131210105263008.000000000000000,Block 3008, Block Group 3, Census Tract 105.26, Fulton County, Georgia,40,11,29,29,0,29,0,0
-1,131210105342012.000000000000000,Block 2012, Block Group 2, Census Tract 105.34, Fulton County, Georgia,40,4,36,35,1,31,3,1
-1,131210105382001.000000000000000,Block 2001, Block Group 2, Census Tract 105.38, Fulton County, Georgia,40,9,31,27,0,27,0,4
-1,131210105402037.000000000000000,Block 2037, Block Group 2, Census Tract 105.40, Fulton County, Georgia,40,3,37,37,30,6,1,0
-1,131210106011003.000000000000000,Block 1003, Block Group 1, Census Tract 106.01, Fulton County, Georgia,40,0,40,40,18,22,0,0
-1,131210106014000.000000000000000,Block 4000, Block Group 4, Census Tract 106.01, Fulton County, Georgia,40,15,25,25,9,16,0,0
-1,131210108013036.000000000000000,Block 3036, Block Group 3, Census Tract 108.01, Fulton County, Georgia,40,2,38,38,26,12,0,0
-1,131210110002006.000000000000000,Block 2006, Block Group 2, Census Tract 110, Fulton County, Georgia,40,7,33,32,0,30,2,1
-1,131210112021006.000000000000000,Block 1006, Block Group 1, Census Tract 112.02, Fulton County, Georgia,40,8,32,31,4,27,0,1
-1,131210112022010.000000000000000,Block 2010, Block Group 2, Census Tract 112.02, Fulton County, Georgia,40,28,12,11,6,5,0,1
-1,131210112031023.000000000000000,Block 1023, Block Group 1, Census Tract 112.03, Fulton County, Georgia,40,8,32,25,8,17,0,7
-1,131210112042002.000000000000000,Block 2002, Block Group 2, Census Tract 112.04, Fulton County, Georgia,40,5,35,34,2,32,0,1
-1,131210113014006.000000000000000,Block 4006, Block Group 4, Census Tract 113.01, Fulton County, Georgia,40,3,37,36,2,34,0,1
-1,131210113073009.000000000000000,Block 3009, Block Group 3, Census Tract 113.07, Fulton County, Georgia,40,2,38,36,1,34,0,2
-1,131210114223001.000000000000000,Block 3001, Block Group 3, Census Tract 114.22, Fulton County, Georgia,40,3,37,31,29,1,1,6
-1,131210114282011.000000000000000,Block 2011, Block Group 2, Census Tract 114.28, Fulton County, Georgia,40,6,34,32,23,6,3,2
-1,131210114322002.000000000000000,Block 2002, Block Group 2, Census Tract 114.32, Fulton County, Georgia,40,11,29,28,11,11,2,1
-1,131210114342008.000000000000000,Block 2008, Block Group 2, Census Tract 114.34, Fulton County, Georgia,40,10,30,28,18,10,0,2
-1,131210115102020.000000000000000,Block 2020, Block Group 2, Census Tract 115.10, Fulton County, Georgia,40,6,34,31,19,2,0,3
-1,131210115141008.000000000000000,Block 1008, Block Group 1, Census Tract 115.14, Fulton County, Georgia,40,5,35,33,33,0,0,2
-1,131210116282002.000000000000000,Block 2002, Block Group 2, Census Tract 116.28, Fulton County, Georgia,40,1,39,35,5,3,0,4
-1,131210116402003.000000000000000,Block 2003, Block Group 2, Census Tract 116.40, Fulton County, Georgia,40,7,33,31,27,0,0,2
-1,131210116402008.000000000000000,Block 2008, Block Group 2, Census Tract 116.40, Fulton County, Georgia,40,12,28,24,20,2,1,4
-1,131210116453007.000000000000000,Block 3007, Block Group 3, Census Tract 116.45, Fulton County, Georgia,40,14,26,25,18,5,0,1
-1,131210116602014.000000000000000,Block 2014, Block Group 2, Census Tract 116.60, Fulton County, Georgia,40,3,37,33,26,1,0,4
-1,131210118021024.000000000000000,Block 1024, Block Group 1, Census Tract 118.02, Fulton County, Georgia,40,1,39,35,1,34,0,4
-1,131210120002006.000000000000000,Block 2006, Block Group 2, Census Tract 120, Fulton County, Georgia,40,0,40,36,1,35,0,4
-1,131210123003024.000000000000000,Block 3024, Block Group 3, Census Tract 123, Fulton County, Georgia,40,0,40,40,3,37,0,0
-1,131210002012002.000000000000000,Block 2002, Block Group 2, Census Tract 2.01, Fulton County, Georgia,39,0,39,39,37,0,2,0
-1,131210002012004.000000000000000,Block 2004, Block Group 2, Census Tract 2.01, Fulton County, Georgia,39,2,37,35,33,0,1,2
-1,131210024002016.000000000000000,Block 2016, Block Group 2, Census Tract 24, Fulton County, Georgia,39,2,37,33,0,33,0,4
-1,131210025001005.000000000000000,Block 1005, Block Group 1, Census Tract 25, Fulton County, Georgia,39,4,35,33,0,33,0,2
-1,131210028021000.000000000000000,Block 1000, Block Group 1, Census Tract 28.02, Fulton County, Georgia,39,1,38,36,11,24,1,2
-1,131210042001009.000000000000000,Block 1009, Block Group 1, Census Tract 42, Fulton County, Georgia,39,3,36,32,0,32,0,4
-1,131210042002012.000000000000000,Block 2012, Block Group 2, Census Tract 42, Fulton County, Georgia,39,3,36,36,9,27,0,0
-1,131210052001007.000000000000000,Block 1007, Block Group 1, Census Tract 52, Fulton County, Georgia,39,0,39,38,18,18,0,1
-1,131210052002011.000000000000000,Block 2011, Block Group 2, Census Tract 52, Fulton County, Georgia,39,2,37,36,31,2,0,1
-1,131210052003011.000000000000000,Block 3011, Block Group 3, Census Tract 52, Fulton County, Georgia,39,4,35,29,27,2,0,6
-1,131210052004016.000000000000000,Block 4016, Block Group 4, Census Tract 52, Fulton County, Georgia,39,0,39,38,37,0,0,1
-1,131210052004018.000000000000000,Block 4018, Block Group 4, Census Tract 52, Fulton County, Georgia,39,7,32,26,24,2,0,6
-1,131210053002017.000000000000000,Block 2017, Block Group 2, Census Tract 53, Fulton County, Georgia,39,2,37,37,37,0,0,0
-1,131210057001005.000000000000000,Block 1005, Block Group 1, Census Tract 57, Fulton County, Georgia,39,0,39,36,2,32,0,3
-1,131210061002002.000000000000000,Block 2002, Block Group 2, Census Tract 61, Fulton County, Georgia,39,2,37,37,0,37,0,0
-1,131210062001016.000000000000000,Block 1016, Block Group 1, Census Tract 62, Fulton County, Georgia,39,3,36,36,0,34,2,0
-1,131210062002008.000000000000000,Block 2008, Block Group 2, Census Tract 62, Fulton County, Georgia,39,0,39,38,0,38,0,1
-1,131210065001011.000000000000000,Block 1011, Block Group 1, Census Tract 65, Fulton County, Georgia,39,0,39,36,7,28,0,3
-1,131210065004019.000000000000000,Block 4019, Block Group 4, Census Tract 65, Fulton County, Georgia,39,2,37,34,14,19,0,3
-1,131210070021006.000000000000000,Block 1006, Block Group 1, Census Tract 70.02, Fulton County, Georgia,39,0,39,37,3,34,0,2
-1,131210074001008.000000000000000,Block 1008, Block Group 1, Census Tract 74, Fulton County, Georgia,39,5,34,33,0,33,0,1
-1,131210074001011.000000000000000,Block 1011, Block Group 1, Census Tract 74, Fulton County, Georgia,39,17,22,20,1,19,0,2
-1,131210076021002.000000000000000,Block 1002, Block Group 1, Census Tract 76.02, Fulton County, Georgia,39,0,39,37,0,37,0,2
-1,131210076022000.000000000000000,Block 2000, Block Group 2, Census Tract 76.02, Fulton County, Georgia,39,6,33,32,1,31,0,1
-1,131210077053007.000000000000000,Block 3007, Block Group 3, Census Tract 77.05, Fulton County, Georgia,39,2,37,33,0,32,0,4
-1,131210077072012.000000000000000,Block 2012, Block Group 2, Census Tract 77.07, Fulton County, Georgia,39,0,39,39,2,35,0,0
-1,131210078094002.000000000000000,Block 4002, Block Group 4, Census Tract 78.09, Fulton County, Georgia,39,1,38,38,1,37,0,0
-1,131210081043013.000000000000000,Block 3013, Block Group 3, Census Tract 81.04, Fulton County, Georgia,39,2,37,36,7,29,0,1
-1,131210082022003.000000000000000,Block 2003, Block Group 2, Census Tract 82.02, Fulton County, Georgia,39,3,36,35,2,33,0,1
-1,131210084001009.000000000000000,Block 1009, Block Group 1, Census Tract 84, Fulton County, Georgia,39,0,39,37,0,37,0,2
-1,131210086012012.000000000000000,Block 2012, Block Group 2, Census Tract 86.01, Fulton County, Georgia,39,5,34,34,0,33,1,0
-1,131210086013012.000000000000000,Block 3012, Block Group 3, Census Tract 86.01, Fulton County, Georgia,39,1,38,38,2,35,1,0
-1,131210087021003.000000000000000,Block 1003, Block Group 1, Census Tract 87.02, Fulton County, Georgia,39,2,37,37,16,21,0,0
-1,131210088011030.000000000000000,Block 1030, Block Group 1, Census Tract 88.01, Fulton County, Georgia,39,5,34,31,22,9,0,3
-1,131210088021014.000000000000000,Block 1014, Block Group 1, Census Tract 88.02, Fulton County, Georgia,39,5,34,34,34,0,0,0
-1,131210089052019.000000000000000,Block 2019, Block Group 2, Census Tract 89.05, Fulton County, Georgia,39,3,36,33,20,7,1,3
-1,131210093011000.000000000000000,Block 1000, Block Group 1, Census Tract 93.01, Fulton County, Georgia,39,3,36,34,25,1,0,2
-1,131210095011014.000000000000000,Block 1014, Block Group 1, Census Tract 95.01, Fulton County, Georgia,39,0,39,39,36,0,3,0
-1,131210097001012.000000000000000,Block 1012, Block Group 1, Census Tract 97, Fulton County, Georgia,39,4,35,33,22,4,0,2
-1,131210097002009.000000000000000,Block 2009, Block Group 2, Census Tract 97, Fulton County, Georgia,39,8,31,19,9,6,1,12
-1,131210098021001.000000000000000,Block 1001, Block Group 1, Census Tract 98.02, Fulton County, Georgia,39,1,38,37,35,0,0,1
-1,131210099001014.000000000000000,Block 1014, Block Group 1, Census Tract 99, Fulton County, Georgia,39,3,36,29,26,0,0,7
-1,131210099002006.000000000000000,Block 2006, Block Group 2, Census Tract 99, Fulton County, Georgia,39,0,39,38,35,1,0,1
-1,131210100051001.000000000000000,Block 1001, Block Group 1, Census Tract 100.05, Fulton County, Georgia,39,1,38,36,35,0,0,2
-1,131210101062008.000000000000000,Block 2008, Block Group 2, Census Tract 101.06, Fulton County, Georgia,39,6,33,31,29,1,1,2
-1,131210101062009.000000000000000,Block 2009, Block Group 2, Census Tract 101.06, Fulton County, Georgia,39,2,37,33,33,0,0,4
-1,131210101151007.000000000000000,Block 1007, Block Group 1, Census Tract 101.15, Fulton County, Georgia,39,4,35,33,27,0,1,2
-1,131210101202003.000000000000000,Block 2003, Block Group 2, Census Tract 101.20, Fulton County, Georgia,39,15,24,22,15,0,2,2
-1,131210101321009.000000000000000,Block 1009, Block Group 1, Census Tract 101.32, Fulton County, Georgia,39,5,34,31,28,0,0,3
-1,131210101343001.000000000000000,Block 3001, Block Group 3, Census Tract 101.34, Fulton County, Georgia,39,3,36,31,23,0,0,5
-1,131210102111011.000000000000000,Block 1011, Block Group 1, Census Tract 102.11, Fulton County, Georgia,39,2,37,37,34,1,2,0
-1,131210103051020.000000000000000,Block 1020, Block Group 1, Census Tract 103.05, Fulton County, Georgia,39,0,39,39,0,39,0,0
-1,131210103083003.000000000000000,Block 3003, Block Group 3, Census Tract 103.08, Fulton County, Georgia,39,1,38,36,1,35,0,2
-1,131210103091001.000000000000000,Block 1001, Block Group 1, Census Tract 103.09, Fulton County, Georgia,39,2,37,37,33,3,1,0
-1,131210103092019.000000000000000,Block 2019, Block Group 2, Census Tract 103.09, Fulton County, Georgia,39,0,39,37,0,37,0,2
-1,131210103092022.000000000000000,Block 2022, Block Group 2, Census Tract 103.09, Fulton County, Georgia,39,1,38,35,0,35,0,3
-1,131210104021003.000000000000000,Block 1003, Block Group 1, Census Tract 104.02, Fulton County, Georgia,39,2,37,35,34,0,0,2
-1,131210104022021.000000000000000,Block 2021, Block Group 2, Census Tract 104.02, Fulton County, Georgia,39,4,35,34,20,13,0,1
-1,131210104022069.000000000000000,Block 2069, Block Group 2, Census Tract 104.02, Fulton County, Georgia,39,1,38,37,35,2,0,1
-1,131210105181010.000000000000000,Block 1010, Block Group 1, Census Tract 105.18, Fulton County, Georgia,39,0,39,32,4,28,0,7
-1,131210105271015.000000000000000,Block 1015, Block Group 1, Census Tract 105.27, Fulton County, Georgia,39,19,20,18,7,11,0,2
-1,131210105283004.000000000000000,Block 3004, Block Group 3, Census Tract 105.28, Fulton County, Georgia,39,6,33,24,3,21,0,9
-1,131210105323009.000000000000000,Block 3009, Block Group 3, Census Tract 105.32, Fulton County, Georgia,39,1,38,38,0,38,0,0
-1,131210105352002.000000000000000,Block 2002, Block Group 2, Census Tract 105.35, Fulton County, Georgia,39,10,29,29,0,29,0,0
-1,131210105381008.000000000000000,Block 1008, Block Group 1, Census Tract 105.38, Fulton County, Georgia,39,0,39,39,0,38,1,0
-1,131210105391029.000000000000000,Block 1029, Block Group 1, Census Tract 105.39, Fulton County, Georgia,39,7,32,32,2,30,0,0
-1,131210106011007.000000000000000,Block 1007, Block Group 1, Census Tract 106.01, Fulton County, Georgia,39,0,39,38,33,5,0,1
-1,131210112031013.000000000000000,Block 1013, Block Group 1, Census Tract 112.03, Fulton County, Georgia,39,1,38,38,7,31,0,0
-1,131210112031015.000000000000000,Block 1015, Block Group 1, Census Tract 112.03, Fulton County, Georgia,39,6,33,33,14,16,0,0
-1,131210112032018.000000000000000,Block 2018, Block Group 2, Census Tract 112.03, Fulton County, Georgia,39,9,30,24,0,24,0,6
-1,131210113012007.000000000000000,Block 2007, Block Group 2, Census Tract 113.01, Fulton County, Georgia,39,6,33,33,3,29,1,0
-1,131210113103005.000000000000000,Block 3005, Block Group 3, Census Tract 113.10, Fulton County, Georgia,39,4,35,34,0,32,1,1
-1,131210113104002.000000000000000,Block 4002, Block Group 4, Census Tract 113.10, Fulton County, Georgia,39,9,30,29,4,25,0,1
-1,131210113105003.000000000000000,Block 5003, Block Group 5, Census Tract 113.10, Fulton County, Georgia,39,26,13,13,0,10,3,0
-1,131210114162005.000000000000000,Block 2005, Block Group 2, Census Tract 114.16, Fulton County, Georgia,39,3,36,35,27,8,0,1
-1,131210114194020.000000000000000,Block 4020, Block Group 4, Census Tract 114.19, Fulton County, Georgia,39,2,37,37,26,7,0,0
-1,131210114323002.000000000000000,Block 3002, Block Group 3, Census Tract 114.32, Fulton County, Georgia,39,8,31,30,20,5,2,1
-1,131210114353005.000000000000000,Block 3005, Block Group 3, Census Tract 114.35, Fulton County, Georgia,39,14,25,19,19,0,0,6
-1,131210114362005.000000000000000,Block 2005, Block Group 2, Census Tract 114.36, Fulton County, Georgia,39,8,31,21,17,4,0,10
-1,131210114373003.000000000000000,Block 3003, Block Group 3, Census Tract 114.37, Fulton County, Georgia,39,3,36,34,27,4,3,2
-1,131210114382006.000000000000000,Block 2006, Block Group 2, Census Tract 114.38, Fulton County, Georgia,39,8,31,24,18,1,0,7
-1,131210114452003.000000000000000,Block 2003, Block Group 2, Census Tract 114.45, Fulton County, Georgia,39,5,34,28,26,1,0,6
-1,131210115091017.000000000000000,Block 1017, Block Group 1, Census Tract 115.09, Fulton County, Georgia,39,5,34,33,32,0,0,1
-1,131210115102014.000000000000000,Block 2014, Block Group 2, Census Tract 115.10, Fulton County, Georgia,39,1,38,34,26,8,0,4
-1,131210116271002.000000000000000,Block 1002, Block Group 1, Census Tract 116.27, Fulton County, Georgia,39,9,30,23,9,0,0,7
-1,131210116542004.000000000000000,Block 2004, Block Group 2, Census Tract 116.54, Fulton County, Georgia,39,3,36,31,30,0,0,5
-1,131210116582007.000000000000000,Block 2007, Block Group 2, Census Tract 116.58, Fulton County, Georgia,39,2,37,33,4,15,0,4
-1,131210116602016.000000000000000,Block 2016, Block Group 2, Census Tract 116.60, Fulton County, Georgia,39,0,39,38,38,0,0,1
-1,131210118021020.000000000000000,Block 1020, Block Group 1, Census Tract 118.02, Fulton County, Georgia,39,1,38,38,0,38,0,0
-1,131210123004024.000000000000000,Block 4024, Block Group 4, Census Tract 123, Fulton County, Georgia,39,10,29,29,5,23,0,0
-1,131210002011001.000000000000000,Block 1001, Block Group 1, Census Tract 2.01, Fulton County, Georgia,38,6,32,28,22,5,1,4
-1,131210007001030.000000000000000,Block 1030, Block Group 1, Census Tract 7, Fulton County, Georgia,38,0,38,37,28,8,0,1
-1,131210010012006.000000000000000,Block 2006, Block Group 2, Census Tract 10.01, Fulton County, Georgia,38,7,31,28,11,4,0,3
-1,131210017011005.000000000000000,Block 1005, Block Group 1, Census Tract 17.01, Fulton County, Georgia,38,8,30,30,9,21,0,0
-1,131210017012000.000000000000000,Block 2000, Block Group 2, Census Tract 17.01, Fulton County, Georgia,38,1,37,36,18,11,0,1
-1,131210023001008.000000000000000,Block 1008, Block Group 1, Census Tract 23, Fulton County, Georgia,38,0,38,38,0,38,0,0
-1,131210023001012.000000000000000,Block 1012, Block Group 1, Census Tract 23, Fulton County, Georgia,38,0,38,38,0,38,0,0
-1,131210026001008.000000000000000,Block 1008, Block Group 1, Census Tract 26, Fulton County, Georgia,38,0,38,35,4,31,0,3
-1,131210030001029.000000000000000,Block 1029, Block Group 1, Census Tract 30, Fulton County, Georgia,38,4,34,31,24,5,0,3
-1,131210032001011.000000000000000,Block 1011, Block Group 1, Census Tract 32, Fulton County, Georgia,38,3,35,31,31,0,0,4
-1,131210039001003.000000000000000,Block 1003, Block Group 1, Census Tract 39, Fulton County, Georgia,38,1,37,36,11,25,0,1
-1,131210039001009.000000000000000,Block 1009, Block Group 1, Census Tract 39, Fulton County, Georgia,38,2,36,33,3,26,3,3
-1,131210039001017.000000000000000,Block 1017, Block Group 1, Census Tract 39, Fulton County, Georgia,38,2,36,36,0,36,0,0
-1,131210040001015.000000000000000,Block 1015, Block Group 1, Census Tract 40, Fulton County, Georgia,38,4,34,33,9,24,0,1
-1,131210040001022.000000000000000,Block 1022, Block Group 1, Census Tract 40, Fulton County, Georgia,38,0,38,37,1,36,0,1
-1,131210050002012.000000000000000,Block 2012, Block Group 2, Census Tract 50, Fulton County, Georgia,38,8,30,28,24,4,0,2
-1,131210053001001.000000000000000,Block 1001, Block Group 1, Census Tract 53, Fulton County, Georgia,38,1,37,33,25,8,0,4
-1,131210053002007.000000000000000,Block 2007, Block Group 2, Census Tract 53, Fulton County, Georgia,38,1,37,36,33,2,0,1
-1,131210055011028.000000000000000,Block 1028, Block Group 1, Census Tract 55.01, Fulton County, Georgia,38,3,35,28,12,11,0,7
-1,131210057001000.000000000000000,Block 1000, Block Group 1, Census Tract 57, Fulton County, Georgia,38,1,37,37,6,29,0,0
-1,131210062001002.000000000000000,Block 1002, Block Group 1, Census Tract 62, Fulton County, Georgia,38,0,38,33,10,23,0,5
-1,131210063001006.000000000000000,Block 1006, Block Group 1, Census Tract 63, Fulton County, Georgia,38,2,36,36,4,32,0,0
-1,131210063001016.000000000000000,Block 1016, Block Group 1, Census Tract 63, Fulton County, Georgia,38,0,38,31,4,27,0,7
-1,131210065003006.000000000000000,Block 3006, Block Group 3, Census Tract 65, Fulton County, Georgia,38,0,38,38,13,25,0,0
-1,131210065004015.000000000000000,Block 4015, Block Group 4, Census Tract 65, Fulton County, Georgia,38,1,37,35,15,18,1,2
-1,131210066012013.000000000000000,Block 2013, Block Group 2, Census Tract 66.01, Fulton County, Georgia,38,5,33,31,9,22,0,2
-1,131210067021022.000000000000000,Block 1022, Block Group 1, Census Tract 67.02, Fulton County, Georgia,38,3,35,32,2,29,1,3
-1,131210067021033.000000000000000,Block 1033, Block Group 1, Census Tract 67.02, Fulton County, Georgia,38,0,38,34,10,24,0,4
-1,131210069003025.000000000000000,Block 3025, Block Group 3, Census Tract 69, Fulton County, Georgia,38,4,34,32,32,0,0,2
-1,131210076042002.000000000000000,Block 2002, Block Group 2, Census Tract 76.04, Fulton County, Georgia,38,5,33,29,0,29,0,4
-1,131210077053016.000000000000000,Block 3016, Block Group 3, Census Tract 77.05, Fulton County, Georgia,38,0,38,34,0,34,0,4
-1,131210077103004.000000000000000,Block 3004, Block Group 3, Census Tract 77.10, Fulton County, Georgia,38,1,37,33,2,29,0,4
-1,131210079003004.000000000000000,Block 3004, Block Group 3, Census Tract 79, Fulton County, Georgia,38,1,37,36,0,36,0,1
-1,131210081031008.000000000000000,Block 1008, Block Group 1, Census Tract 81.03, Fulton County, Georgia,38,7,31,28,6,20,2,3
-1,131210081042001.000000000000000,Block 2001, Block Group 2, Census Tract 81.04, Fulton County, Georgia,38,2,36,31,0,31,0,5
-1,131210081043002.000000000000000,Block 3002, Block Group 3, Census Tract 81.04, Fulton County, Georgia,38,2,36,36,1,35,0,0
-1,131210082032003.000000000000000,Block 2003, Block Group 2, Census Tract 82.03, Fulton County, Georgia,38,4,34,33,12,20,1,1
-1,131210082041009.000000000000000,Block 1009, Block Group 1, Census Tract 82.04, Fulton County, Georgia,38,1,37,35,4,31,0,2
-1,131210082042001.000000000000000,Block 2001, Block Group 2, Census Tract 82.04, Fulton County, Georgia,38,0,38,38,0,38,0,0
-1,131210085003022.000000000000000,Block 3022, Block Group 3, Census Tract 85, Fulton County, Georgia,38,1,37,34,3,29,2,3
-1,131210086022002.000000000000000,Block 2002, Block Group 2, Census Tract 86.02, Fulton County, Georgia,38,7,31,29,2,23,4,2
-1,131210087012007.000000000000000,Block 2007, Block Group 2, Census Tract 87.01, Fulton County, Georgia,38,9,29,27,14,13,0,2
-1,131210088011020.000000000000000,Block 1020, Block Group 1, Census Tract 88.01, Fulton County, Georgia,38,8,30,26,22,1,0,4
-1,131210088022016.000000000000000,Block 2016, Block Group 2, Census Tract 88.02, Fulton County, Georgia,38,0,38,35,18,12,0,3
-1,131210089054019.000000000000000,Block 4019, Block Group 4, Census Tract 89.05, Fulton County, Georgia,38,1,37,37,35,2,0,0
-1,131210090021009.000000000000000,Block 1009, Block Group 1, Census Tract 90.02, Fulton County, Georgia,38,1,37,35,31,0,0,2
-1,131210090022016.000000000000000,Block 2016, Block Group 2, Census Tract 90.02, Fulton County, Georgia,38,0,38,32,32,0,0,6
-1,131210092011006.000000000000000,Block 1006, Block Group 1, Census Tract 92.01, Fulton County, Georgia,38,13,25,22,21,1,0,3
-1,131210094102003.000000000000000,Block 2003, Block Group 2, Census Tract 94.10, Fulton County, Georgia,38,4,34,28,20,6,0,6
-1,131210095014003.000000000000000,Block 4003, Block Group 4, Census Tract 95.01, Fulton County, Georgia,38,1,37,32,24,7,0,5
-1,131210098021003.000000000000000,Block 1003, Block Group 1, Census Tract 98.02, Fulton County, Georgia,38,1,37,37,37,0,0,0
-1,131210099001001.000000000000000,Block 1001, Block Group 1, Census Tract 99, Fulton County, Georgia,38,5,33,31,20,4,5,2
-1,131210101312001.000000000000000,Block 2001, Block Group 2, Census Tract 101.31, Fulton County, Georgia,38,1,37,34,27,0,3,3
-1,131210101332006.000000000000000,Block 2006, Block Group 2, Census Tract 101.33, Fulton County, Georgia,38,4,34,27,15,6,1,7
-1,131210102044004.000000000000000,Block 4004, Block Group 4, Census Tract 102.04, Fulton County, Georgia,38,0,38,34,31,0,0,4
-1,131210102221007.000000000000000,Block 1007, Block Group 1, Census Tract 102.22, Fulton County, Georgia,38,6,32,32,24,5,0,0
-1,131210103051033.000000000000000,Block 1033, Block Group 1, Census Tract 103.05, Fulton County, Georgia,38,0,38,37,1,36,0,1
-1,131210103081015.000000000000000,Block 1015, Block Group 1, Census Tract 103.08, Fulton County, Georgia,38,1,37,35,1,34,0,2
-1,131210103112010.000000000000000,Block 2010, Block Group 2, Census Tract 103.11, Fulton County, Georgia,38,6,32,31,0,31,0,1
-1,131210103123005.000000000000000,Block 3005, Block Group 3, Census Tract 103.12, Fulton County, Georgia,38,1,37,37,0,37,0,0
-1,131210103151008.000000000000000,Block 1008, Block Group 1, Census Tract 103.15, Fulton County, Georgia,38,2,36,30,1,29,0,6
-1,131210104012016.000000000000000,Block 2016, Block Group 2, Census Tract 104.01, Fulton County, Georgia,38,6,32,30,1,23,0,2
-1,131210104023006.000000000000000,Block 3006, Block Group 3, Census Tract 104.02, Fulton County, Georgia,38,0,38,38,26,12,0,0
-1,131210105192001.000000000000000,Block 2001, Block Group 2, Census Tract 105.19, Fulton County, Georgia,38,3,35,31,0,29,0,4
-1,131210105202019.000000000000000,Block 2019, Block Group 2, Census Tract 105.20, Fulton County, Georgia,38,0,38,38,4,32,2,0
-1,131210105241017.000000000000000,Block 1017, Block Group 1, Census Tract 105.24, Fulton County, Georgia,38,5,33,28,2,24,0,5
-1,131210105264012.000000000000000,Block 4012, Block Group 4, Census Tract 105.26, Fulton County, Georgia,38,4,34,33,0,33,0,1
-1,131210105293019.000000000000000,Block 3019, Block Group 3, Census Tract 105.29, Fulton County, Georgia,38,2,36,34,0,34,0,2
-1,131210105302024.000000000000000,Block 2024, Block Group 2, Census Tract 105.30, Fulton County, Georgia,38,1,37,37,3,34,0,0
-1,131210105311003.000000000000000,Block 1003, Block Group 1, Census Tract 105.31, Fulton County, Georgia,38,1,37,29,0,22,7,8
-1,131210105341005.000000000000000,Block 1005, Block Group 1, Census Tract 105.34, Fulton County, Georgia,38,1,37,31,2,27,1,6
-1,131210105352018.000000000000000,Block 2018, Block Group 2, Census Tract 105.35, Fulton County, Georgia,38,1,37,37,17,20,0,0
-1,131210106011008.000000000000000,Block 1008, Block Group 1, Census Tract 106.01, Fulton County, Georgia,38,1,37,36,24,12,0,1
-1,131210106032005.000000000000000,Block 2005, Block Group 2, Census Tract 106.03, Fulton County, Georgia,38,1,37,37,0,35,2,0
-1,131210108023007.000000000000000,Block 3007, Block Group 3, Census Tract 108.02, Fulton County, Georgia,38,6,32,32,24,7,0,0
-1,131210108023008.000000000000000,Block 3008, Block Group 3, Census Tract 108.02, Fulton County, Georgia,38,6,32,27,23,3,1,5
-1,131210108024003.000000000000000,Block 4003, Block Group 4, Census Tract 108.02, Fulton County, Georgia,38,14,24,21,18,0,1,3
-1,131210112024001.000000000000000,Block 4001, Block Group 4, Census Tract 112.02, Fulton County, Georgia,38,1,37,36,24,6,6,1
-1,131210112024009.000000000000000,Block 4009, Block Group 4, Census Tract 112.02, Fulton County, Georgia,38,1,37,33,7,21,1,4
-1,131210112026009.000000000000000,Block 6009, Block Group 6, Census Tract 112.02, Fulton County, Georgia,38,16,22,20,0,15,0,2
-1,131210112026010.000000000000000,Block 6010, Block Group 6, Census Tract 112.02, Fulton County, Georgia,38,9,29,27,0,27,0,2
-1,131210112031009.000000000000000,Block 1009, Block Group 1, Census Tract 112.03, Fulton County, Georgia,38,8,30,29,4,25,0,1
-1,131210113011005.000000000000000,Block 1005, Block Group 1, Census Tract 113.01, Fulton County, Georgia,38,0,38,38,6,32,0,0
-1,131210113071003.000000000000000,Block 1003, Block Group 1, Census Tract 113.07, Fulton County, Georgia,38,7,31,29,0,28,0,2
-1,131210114172007.000000000000000,Block 2007, Block Group 2, Census Tract 114.17, Fulton County, Georgia,38,1,37,34,26,5,2,3
-1,131210114211004.000000000000000,Block 1004, Block Group 1, Census Tract 114.21, Fulton County, Georgia,38,12,26,18,6,10,0,8
-1,131210114352001.000000000000000,Block 2001, Block Group 2, Census Tract 114.35, Fulton County, Georgia,38,15,23,15,6,4,4,8
-1,131210114372007.000000000000000,Block 2007, Block Group 2, Census Tract 114.37, Fulton County, Georgia,38,20,18,17,10,4,0,1
-1,131210114401001.000000000000000,Block 1001, Block Group 1, Census Tract 114.40, Fulton County, Georgia,38,10,28,20,12,4,0,8
-1,131210114401012.000000000000000,Block 1012, Block Group 1, Census Tract 114.40, Fulton County, Georgia,38,6,32,28,26,2,0,4
-1,131210115082007.000000000000000,Block 2007, Block Group 2, Census Tract 115.08, Fulton County, Georgia,38,6,32,29,26,3,0,3
-1,131210116391006.000000000000000,Block 1006, Block Group 1, Census Tract 116.39, Fulton County, Georgia,38,4,34,33,20,0,2,1
-1,131210116402010.000000000000000,Block 2010, Block Group 2, Census Tract 116.40, Fulton County, Georgia,38,7,31,30,26,2,0,1
-1,131210116431003.000000000000000,Block 1003, Block Group 1, Census Tract 116.43, Fulton County, Georgia,38,9,29,21,4,11,1,8
-1,131210005022021.000000000000000,Block 2021, Block Group 2, Census Tract 5.02, Fulton County, Georgia,37,5,32,32,24,1,0,0
-1,131210017012011.000000000000000,Block 2011, Block Group 2, Census Tract 17.01, Fulton County, Georgia,37,5,32,30,23,7,0,2
-1,131210021003001.000000000000000,Block 3001, Block Group 3, Census Tract 21, Fulton County, Georgia,37,8,29,27,12,11,0,2
-1,131210025001015.000000000000000,Block 1015, Block Group 1, Census Tract 25, Fulton County, Georgia,37,9,28,26,0,26,0,2
-1,131210035002035.000000000000000,Block 2035, Block Group 2, Census Tract 35, Fulton County, Georgia,37,0,37,37,7,30,0,0
-1,131210040002011.000000000000000,Block 2011, Block Group 2, Census Tract 40, Fulton County, Georgia,37,2,35,33,3,30,0,2
-1,131210042002015.000000000000000,Block 2015, Block Group 2, Census Tract 42, Fulton County, Georgia,37,0,37,31,8,23,0,6
-1,131210042003018.000000000000000,Block 3018, Block Group 3, Census Tract 42, Fulton County, Georgia,37,1,36,35,1,34,0,1
-1,131210049002011.000000000000000,Block 2011, Block Group 2, Census Tract 49, Fulton County, Georgia,37,0,37,36,34,2,0,1
-1,131210049002030.000000000000000,Block 2030, Block Group 2, Census Tract 49, Fulton County, Georgia,37,2,35,35,35,0,0,0
-1,131210050002017.000000000000000,Block 2017, Block Group 2, Census Tract 50, Fulton County, Georgia,37,3,34,33,31,1,1,1
-1,131210057002017.000000000000000,Block 2017, Block Group 2, Census Tract 57, Fulton County, Georgia,37,1,36,33,0,33,0,3
-1,131210062001004.000000000000000,Block 1004, Block Group 1, Census Tract 62, Fulton County, Georgia,37,0,37,36,6,30,0,1
-1,131210065002005.000000000000000,Block 2005, Block Group 2, Census Tract 65, Fulton County, Georgia,37,0,37,35,3,32,0,2
-1,131210065002010.000000000000000,Block 2010, Block Group 2, Census Tract 65, Fulton County, Georgia,37,0,37,36,0,35,0,1
-1,131210065004005.000000000000000,Block 4005, Block Group 4, Census Tract 65, Fulton County, Georgia,37,3,34,34,9,22,0,0
-1,131210070024006.000000000000000,Block 4006, Block Group 4, Census Tract 70.02, Fulton County, Georgia,37,1,36,35,0,34,0,1
-1,131210076022003.000000000000000,Block 2003, Block Group 2, Census Tract 76.02, Fulton County, Georgia,37,0,37,36,2,34,0,1
-1,131210077053005.000000000000000,Block 3005, Block Group 3, Census Tract 77.05, Fulton County, Georgia,37,2,35,29,0,25,4,6
-1,131210077053021.000000000000000,Block 3021, Block Group 3, Census Tract 77.05, Fulton County, Georgia,37,2,35,35,0,35,0,0
-1,131210077082011.000000000000000,Block 2011, Block Group 2, Census Tract 77.08, Fulton County, Georgia,37,4,33,29,2,24,3,4
-1,131210079003021.000000000000000,Block 3021, Block Group 3, Census Tract 79, Fulton County, Georgia,37,1,36,34,3,31,0,2
-1,131210079004017.000000000000000,Block 4017, Block Group 4, Census Tract 79, Fulton County, Georgia,37,0,37,34,1,32,1,3
-1,131210082021011.000000000000000,Block 1011, Block Group 1, Census Tract 82.02, Fulton County, Georgia,37,3,34,32,0,32,0,2
-1,131210082022009.000000000000000,Block 2009, Block Group 2, Census Tract 82.02, Fulton County, Georgia,37,0,37,34,4,30,0,3
-1,131210082042012.000000000000000,Block 2012, Block Group 2, Census Tract 82.04, Fulton County, Georgia,37,0,37,36,4,32,0,1
-1,131210084001005.000000000000000,Block 1005, Block Group 1, Census Tract 84, Fulton County, Georgia,37,2,35,35,1,34,0,0
-1,131210085002021.000000000000000,Block 2021, Block Group 2, Census Tract 85, Fulton County, Georgia,37,2,35,33,4,28,1,2
-1,131210085003033.000000000000000,Block 3033, Block Group 3, Census Tract 85, Fulton County, Georgia,37,0,37,36,0,36,0,1
-1,131210086013009.000000000000000,Block 3009, Block Group 3, Census Tract 86.01, Fulton County, Georgia,37,0,37,37,0,37,0,0
-1,131210086014009.000000000000000,Block 4009, Block Group 4, Census Tract 86.01, Fulton County, Georgia,37,3,34,33,1,31,0,1
-1,131210087011002.000000000000000,Block 1002, Block Group 1, Census Tract 87.01, Fulton County, Georgia,37,4,33,33,3,30,0,0
-1,131210088022005.000000000000000,Block 2005, Block Group 2, Census Tract 88.02, Fulton County, Georgia,37,8,29,27,20,5,2,2
-1,131210089051004.000000000000000,Block 1004, Block Group 1, Census Tract 89.05, Fulton County, Georgia,37,7,30,27,18,5,0,3
-1,131210089053002.000000000000000,Block 3002, Block Group 3, Census Tract 89.05, Fulton County, Georgia,37,8,29,28,17,8,0,1
-1,131210090021004.000000000000000,Block 1004, Block Group 1, Census Tract 90.02, Fulton County, Georgia,37,6,31,31,29,0,2,0
-1,131210090021006.000000000000000,Block 1006, Block Group 1, Census Tract 90.02, Fulton County, Georgia,37,1,36,36,35,0,0,0
-1,131210091061004.000000000000000,Block 1004, Block Group 1, Census Tract 91.06, Fulton County, Georgia,37,8,29,15,9,3,0,14
-1,131210098041012.000000000000000,Block 1012, Block Group 1, Census Tract 98.04, Fulton County, Georgia,37,4,33,31,30,0,1,2
-1,131210101082003.000000000000000,Block 2003, Block Group 2, Census Tract 101.08, Fulton County, Georgia,37,3,34,26,12,12,1,8
-1,131210101321010.000000000000000,Block 1010, Block Group 1, Census Tract 101.32, Fulton County, Georgia,37,6,31,29,26,0,0,2
-1,131210101332004.000000000000000,Block 2004, Block Group 2, Census Tract 101.33, Fulton County, Georgia,37,3,34,30,29,1,0,4
-1,131210102202001.000000000000000,Block 2001, Block Group 2, Census Tract 102.20, Fulton County, Georgia,37,2,35,35,23,6,1,0
-1,131210103093012.000000000000000,Block 3012, Block Group 3, Census Tract 103.09, Fulton County, Georgia,37,0,37,35,0,34,1,2
-1,131210103103003.000000000000000,Block 3003, Block Group 3, Census Tract 103.10, Fulton County, Georgia,37,0,37,36,0,34,2,1
-1,131210103123001.000000000000000,Block 3001, Block Group 3, Census Tract 103.12, Fulton County, Georgia,37,2,35,32,5,27,0,3
-1,131210103131002.000000000000000,Block 1002, Block Group 1, Census Tract 103.13, Fulton County, Georgia,37,3,34,32,0,32,0,2
-1,131210105223012.000000000000000,Block 3012, Block Group 3, Census Tract 105.22, Fulton County, Georgia,37,0,37,36,1,34,1,1
-1,131210105273009.000000000000000,Block 3009, Block Group 3, Census Tract 105.27, Fulton County, Georgia,37,7,30,23,4,19,0,7
-1,131210105273013.000000000000000,Block 3013, Block Group 3, Census Tract 105.27, Fulton County, Georgia,37,0,37,34,0,34,0,3
-1,131210105293007.000000000000000,Block 3007, Block Group 3, Census Tract 105.29, Fulton County, Georgia,37,0,37,37,2,35,0,0
-1,131210105381010.000000000000000,Block 1010, Block Group 1, Census Tract 105.38, Fulton County, Georgia,37,2,35,35,1,34,0,0
-1,131210105381013.000000000000000,Block 1013, Block Group 1, Census Tract 105.38, Fulton County, Georgia,37,11,26,25,12,13,0,1
-1,131210106012000.000000000000000,Block 2000, Block Group 2, Census Tract 106.01, Fulton County, Georgia,37,2,35,33,6,27,0,2
-1,131210108022009.000000000000000,Block 2009, Block Group 2, Census Tract 108.02, Fulton County, Georgia,37,11,26,24,18,3,1,2
-1,131210108023006.000000000000000,Block 3006, Block Group 3, Census Tract 108.02, Fulton County, Georgia,37,5,32,29,6,10,0,3
-1,131210111003002.000000000000000,Block 3002, Block Group 3, Census Tract 111, Fulton County, Georgia,37,0,37,33,8,25,0,4
-1,131210112023027.000000000000000,Block 3027, Block Group 3, Census Tract 112.02, Fulton County, Georgia,37,16,21,21,8,13,0,0
-1,131210112031007.000000000000000,Block 1007, Block Group 1, Census Tract 112.03, Fulton County, Georgia,37,2,35,33,8,19,1,2
-1,131210112032010.000000000000000,Block 2010, Block Group 2, Census Tract 112.03, Fulton County, Georgia,37,3,34,34,3,29,2,0
-1,131210114171004.000000000000000,Block 1004, Block Group 1, Census Tract 114.17, Fulton County, Georgia,37,2,35,34,28,0,3,1
-1,131210114194013.000000000000000,Block 4013, Block Group 4, Census Tract 114.19, Fulton County, Georgia,37,12,25,20,19,0,0,5
-1,131210114294001.000000000000000,Block 4001, Block Group 4, Census Tract 114.29, Fulton County, Georgia,37,9,28,23,5,1,2,5
-1,131210114301010.000000000000000,Block 1010, Block Group 1, Census Tract 114.30, Fulton County, Georgia,37,29,8,8,1,3,2,0
-1,131210114363002.000000000000000,Block 3002, Block Group 3, Census Tract 114.36, Fulton County, Georgia,37,9,28,18,14,1,3,10
-1,131210114422003.000000000000000,Block 2003, Block Group 2, Census Tract 114.42, Fulton County, Georgia,37,2,35,31,15,0,0,4
-1,131210115081001.000000000000000,Block 1001, Block Group 1, Census Tract 115.08, Fulton County, Georgia,37,4,33,33,28,3,0,0
-1,131210115101031.000000000000000,Block 1031, Block Group 1, Census Tract 115.10, Fulton County, Georgia,37,0,37,33,21,12,0,4
-1,131210115102004.000000000000000,Block 2004, Block Group 2, Census Tract 115.10, Fulton County, Georgia,37,1,36,28,23,3,0,8
-1,131210116401007.000000000000000,Block 1007, Block Group 1, Census Tract 116.40, Fulton County, Georgia,37,2,35,29,14,3,1,6
-1,131210116473022.000000000000000,Block 3022, Block Group 3, Census Tract 116.47, Fulton County, Georgia,37,0,37,34,19,6,0,3
-1,131210116493021.000000000000000,Block 3021, Block Group 3, Census Tract 116.49, Fulton County, Georgia,37,5,32,32,20,1,0,0
-1,131210116552009.000000000000000,Block 2009, Block Group 2, Census Tract 116.55, Fulton County, Georgia,37,5,32,32,32,0,0,0
-1,131210116601015.000000000000000,Block 1015, Block Group 1, Census Tract 116.60, Fulton County, Georgia,37,6,31,30,25,1,1,1
-1,131210119011016.000000000000000,Block 1016, Block Group 1, Census Tract 119.01, Fulton County, Georgia,37,0,37,37,8,29,0,0
-1,131210123001008.000000000000000,Block 1008, Block Group 1, Census Tract 123, Fulton County, Georgia,37,1,36,33,5,27,1,3
-1,131210001001005.000000000000000,Block 1005, Block Group 1, Census Tract 1, Fulton County, Georgia,36,6,30,30,28,1,1,0
-1,131210001001009.000000000000000,Block 1009, Block Group 1, Census Tract 1, Fulton County, Georgia,36,0,36,34,33,0,1,2
-1,131210005022016.000000000000000,Block 2016, Block Group 2, Census Tract 5.02, Fulton County, Georgia,36,6,30,28,20,8,0,2
-1,131210006012005.000000000000000,Block 2005, Block Group 2, Census Tract 6.01, Fulton County, Georgia,36,9,27,22,9,8,0,5
-1,131210007001018.000000000000000,Block 1018, Block Group 1, Census Tract 7, Fulton County, Georgia,36,0,36,36,36,0,0,0
-1,131210018011008.000000000000000,Block 1008, Block Group 1, Census Tract 18.01, Fulton County, Georgia,36,0,36,30,17,13,0,6
-1,131210019021010.000000000000000,Block 1010, Block Group 1, Census Tract 19.02, Fulton County, Georgia,36,1,35,35,2,31,0,0
-1,131210025002004.000000000000000,Block 2004, Block Group 2, Census Tract 25, Fulton County, Georgia,36,2,34,34,0,33,1,0
-1,131210028021009.000000000000000,Block 1009, Block Group 1, Census Tract 28.02, Fulton County, Georgia,36,0,36,36,4,32,0,0
-1,131210039002010.000000000000000,Block 2010, Block Group 2, Census Tract 39, Fulton County, Georgia,36,2,34,34,4,30,0,0
-1,131210040002016.000000000000000,Block 2016, Block Group 2, Census Tract 40, Fulton County, Georgia,36,0,36,35,14,19,0,1
-1,131210041001008.000000000000000,Block 1008, Block Group 1, Census Tract 41, Fulton County, Georgia,36,2,34,34,4,28,2,0
-1,131210042002011.000000000000000,Block 2011, Block Group 2, Census Tract 42, Fulton County, Georgia,36,1,35,33,9,24,0,2
-1,131210044002014.000000000000000,Block 2014, Block Group 2, Census Tract 44, Fulton County, Georgia,36,0,36,36,0,30,1,0
-1,131210049001006.000000000000000,Block 1006, Block Group 1, Census Tract 49, Fulton County, Georgia,36,0,36,36,16,17,0,0
-1,131210049002013.000000000000000,Block 2013, Block Group 2, Census Tract 49, Fulton County, Georgia,36,1,35,27,25,2,0,8
-1,131210049002023.000000000000000,Block 2023, Block Group 2, Census Tract 49, Fulton County, Georgia,36,0,36,34,34,0,0,2
-1,131210055011025.000000000000000,Block 1025, Block Group 1, Census Tract 55.01, Fulton County, Georgia,36,2,34,25,16,6,0,9
-1,131210055041010.000000000000000,Block 1010, Block Group 1, Census Tract 55.04, Fulton County, Georgia,36,0,36,35,0,34,0,1
-1,131210060001001.000000000000000,Block 1001, Block Group 1, Census Tract 60, Fulton County, Georgia,36,1,35,30,14,16,0,5
-1,131210066021005.000000000000000,Block 1005, Block Group 1, Census Tract 66.02, Fulton County, Georgia,36,5,31,30,8,22,0,1
-1,131210067021035.000000000000000,Block 1035, Block Group 1, Census Tract 67.02, Fulton County, Georgia,36,0,36,36,10,26,0,0
-1,131210067022014.000000000000000,Block 2014, Block Group 2, Census Tract 67.02, Fulton County, Georgia,36,4,32,29,9,18,0,3
-1,131210070012009.000000000000000,Block 2009, Block Group 2, Census Tract 70.01, Fulton County, Georgia,36,5,31,30,5,24,1,1
-1,131210071001006.000000000000000,Block 1006, Block Group 1, Census Tract 71, Fulton County, Georgia,36,2,34,30,4,24,0,4
-1,131210071001015.000000000000000,Block 1015, Block Group 1, Census Tract 71, Fulton County, Georgia,36,1,35,35,0,34,0,0
-1,131210071002010.000000000000000,Block 2010, Block Group 2, Census Tract 71, Fulton County, Georgia,36,3,33,32,0,31,0,1
-1,131210074002008.000000000000000,Block 2008, Block Group 2, Census Tract 74, Fulton County, Georgia,36,0,36,35,5,29,0,1
-1,131210075003009.000000000000000,Block 3009, Block Group 3, Census Tract 75, Fulton County, Georgia,36,7,29,28,0,26,2,1
-1,131210077053023.000000000000000,Block 3023, Block Group 3, Census Tract 77.05, Fulton County, Georgia,36,6,30,29,1,28,0,1
-1,131210077072011.000000000000000,Block 2011, Block Group 2, Census Tract 77.07, Fulton County, Georgia,36,2,34,34,0,34,0,0
-1,131210077082003.000000000000000,Block 2003, Block Group 2, Census Tract 77.08, Fulton County, Georgia,36,1,35,35,0,33,2,0
-1,131210077082007.000000000000000,Block 2007, Block Group 2, Census Tract 77.08, Fulton County, Georgia,36,10,26,26,0,24,2,0
-1,131210077091001.000000000000000,Block 1001, Block Group 1, Census Tract 77.09, Fulton County, Georgia,36,10,26,19,0,17,0,7
-1,131210077111007.000000000000000,Block 1007, Block Group 1, Census Tract 77.11, Fulton County, Georgia,36,0,36,35,1,32,0,1
-1,131210078061012.000000000000000,Block 1012, Block Group 1, Census Tract 78.06, Fulton County, Georgia,36,0,36,36,0,36,0,0
-1,131210078092005.000000000000000,Block 2005, Block Group 2, Census Tract 78.09, Fulton County, Georgia,36,1,35,33,2,31,0,2
-1,131210080004019.000000000000000,Block 4019, Block Group 4, Census Tract 80, Fulton County, Georgia,36,2,34,33,0,30,1,1
-1,131210081041016.000000000000000,Block 1016, Block Group 1, Census Tract 81.04, Fulton County, Georgia,36,1,35,35,0,30,2,0
-1,131210086011005.000000000000000,Block 1005, Block Group 1, Census Tract 86.01, Fulton County, Georgia,36,13,23,23,0,21,2,0
-1,131210086012022.000000000000000,Block 2022, Block Group 2, Census Tract 86.01, Fulton County, Georgia,36,11,25,24,0,24,0,1
-1,131210087022015.000000000000000,Block 2015, Block Group 2, Census Tract 87.02, Fulton County, Georgia,36,0,36,36,0,36,0,0
-1,131210088011015.000000000000000,Block 1015, Block Group 1, Census Tract 88.01, Fulton County, Georgia,36,4,32,19,8,9,2,13
-1,131210088021022.000000000000000,Block 1022, Block Group 1, Census Tract 88.02, Fulton County, Georgia,36,9,27,23,15,3,0,4
-1,131210088021028.000000000000000,Block 1028, Block Group 1, Census Tract 88.02, Fulton County, Georgia,36,2,34,34,34,0,0,0
-1,131210088022008.000000000000000,Block 2008, Block Group 2, Census Tract 88.02, Fulton County, Georgia,36,6,30,30,20,10,0,0
-1,131210089062011.000000000000000,Block 2011, Block Group 2, Census Tract 89.06, Fulton County, Georgia,36,2,34,34,34,0,0,0
-1,131210091033005.000000000000000,Block 3005, Block Group 3, Census Tract 91.03, Fulton County, Georgia,36,2,34,33,24,9,0,1
-1,131210093011005.000000000000000,Block 1005, Block Group 1, Census Tract 93.01, Fulton County, Georgia,36,6,30,29,27,0,0,1
-1,131210095042001.000000000000000,Block 2001, Block Group 2, Census Tract 95.04, Fulton County, Georgia,36,4,32,31,29,0,1,1
-1,131210101332007.000000000000000,Block 2007, Block Group 2, Census Tract 101.33, Fulton County, Georgia,36,5,31,31,27,4,0,0
-1,131210102161001.000000000000000,Block 1001, Block Group 1, Census Tract 102.16, Fulton County, Georgia,36,7,29,27,13,7,0,2
-1,131210103051001.000000000000000,Block 1001, Block Group 1, Census Tract 103.05, Fulton County, Georgia,36,0,36,35,1,34,0,1
-1,131210103131008.000000000000000,Block 1008, Block Group 1, Census Tract 103.13, Fulton County, Georgia,36,0,36,35,0,31,4,1
-1,131210104011022.000000000000000,Block 1022, Block Group 1, Census Tract 104.01, Fulton County, Georgia,36,15,21,18,3,14,0,3
-1,131210104022002.000000000000000,Block 2002, Block Group 2, Census Tract 104.02, Fulton County, Georgia,36,5,31,31,24,7,0,0
-1,131210105081008.000000000000000,Block 1008, Block Group 1, Census Tract 105.08, Fulton County, Georgia,36,2,34,34,0,34,0,0
-1,131210105271006.000000000000000,Block 1006, Block Group 1, Census Tract 105.27, Fulton County, Georgia,36,11,25,24,4,19,0,1
-1,131210105273017.000000000000000,Block 3017, Block Group 3, Census Tract 105.27, Fulton County, Georgia,36,18,18,17,5,11,1,1
-1,131210105341012.000000000000000,Block 1012, Block Group 1, Census Tract 105.34, Fulton County, Georgia,36,1,35,34,8,26,0,1
-1,131210105352007.000000000000000,Block 2007, Block Group 2, Census Tract 105.35, Fulton County, Georgia,36,6,30,30,15,15,0,0
-1,131210106013014.000000000000000,Block 3014, Block Group 3, Census Tract 106.01, Fulton County, Georgia,36,7,29,26,11,15,0,3
-1,131210106031013.000000000000000,Block 1013, Block Group 1, Census Tract 106.03, Fulton County, Georgia,36,9,27,27,0,27,0,0
-1,131210110001014.000000000000000,Block 1014, Block Group 1, Census Tract 110, Fulton County, Georgia,36,31,5,5,5,0,0,0
-1,131210110002008.000000000000000,Block 2008, Block Group 2, Census Tract 110, Fulton County, Georgia,36,4,32,29,0,29,0,3
-1,131210111002010.000000000000000,Block 2010, Block Group 2, Census Tract 111, Fulton County, Georgia,36,7,29,26,12,14,0,3
-1,131210111002031.000000000000000,Block 2031, Block Group 2, Census Tract 111, Fulton County, Georgia,36,2,34,30,21,9,0,4
-1,131210111003001.000000000000000,Block 3001, Block Group 3, Census Tract 111, Fulton County, Georgia,36,3,33,32,17,15,0,1
-1,131210111003008.000000000000000,Block 3008, Block Group 3, Census Tract 111, Fulton County, Georgia,36,4,32,32,14,17,0,0
-1,131210112022004.000000000000000,Block 2004, Block Group 2, Census Tract 112.02, Fulton County, Georgia,36,15,21,19,3,14,0,2
-1,131210112024004.000000000000000,Block 4004, Block Group 4, Census Tract 112.02, Fulton County, Georgia,36,6,30,30,14,14,2,0
-1,131210112025011.000000000000000,Block 5011, Block Group 5, Census Tract 112.02, Fulton County, Georgia,36,0,36,34,11,23,0,2
-1,131210113013009.000000000000000,Block 3009, Block Group 3, Census Tract 113.01, Fulton County, Georgia,36,4,32,30,5,24,1,2
-1,131210113062008.000000000000000,Block 2008, Block Group 2, Census Tract 113.06, Fulton County, Georgia,36,1,35,33,0,33,0,2
-1,131210113102000.000000000000000,Block 2000, Block Group 2, Census Tract 113.10, Fulton County, Georgia,36,3,33,32,7,22,1,1
-1,131210114192008.000000000000000,Block 2008, Block Group 2, Census Tract 114.19, Fulton County, Georgia,36,7,29,29,14,1,1,0
-1,131210114194007.000000000000000,Block 4007, Block Group 4, Census Tract 114.19, Fulton County, Georgia,36,8,28,28,20,6,0,0
-1,131210114194021.000000000000000,Block 4021, Block Group 4, Census Tract 114.19, Fulton County, Georgia,36,0,36,33,32,1,0,3
-1,131210114353009.000000000000000,Block 3009, Block Group 3, Census Tract 114.35, Fulton County, Georgia,36,3,33,24,22,1,0,9
-1,131210114383008.000000000000000,Block 3008, Block Group 3, Census Tract 114.38, Fulton County, Georgia,36,10,26,16,13,3,0,10
-1,131210114461002.000000000000000,Block 1002, Block Group 1, Census Tract 114.46, Fulton County, Georgia,36,2,34,26,25,0,0,8
-1,131210115091019.000000000000000,Block 1019, Block Group 1, Census Tract 115.09, Fulton County, Georgia,36,2,34,34,34,0,0,0
-1,131210115101021.000000000000000,Block 1021, Block Group 1, Census Tract 115.10, Fulton County, Georgia,36,1,35,33,26,4,0,2
-1,131210115102009.000000000000000,Block 2009, Block Group 2, Census Tract 115.10, Fulton County, Georgia,36,4,32,26,26,0,0,6
-1,131210116241005.000000000000000,Block 1005, Block Group 1, Census Tract 116.24, Fulton County, Georgia,36,10,26,22,10,6,5,4
-1,131210116353011.000000000000000,Block 3011, Block Group 3, Census Tract 116.35, Fulton County, Georgia,36,4,32,29,14,0,0,3
-1,131210116401011.000000000000000,Block 1011, Block Group 1, Census Tract 116.40, Fulton County, Georgia,36,3,33,32,24,2,1,1
-1,131210116462004.000000000000000,Block 2004, Block Group 2, Census Tract 116.46, Fulton County, Georgia,36,5,31,28,20,7,1,3
-1,131210116482003.000000000000000,Block 2003, Block Group 2, Census Tract 116.48, Fulton County, Georgia,36,4,32,29,0,1,0,3
-1,131210116552011.000000000000000,Block 2011, Block Group 2, Census Tract 116.55, Fulton County, Georgia,36,8,28,25,25,0,0,3
-1,131210116582002.000000000000000,Block 2002, Block Group 2, Census Tract 116.58, Fulton County, Georgia,36,3,33,28,23,0,2,5
-1,131210116592003.000000000000000,Block 2003, Block Group 2, Census Tract 116.59, Fulton County, Georgia,36,4,32,19,19,0,0,13
-1,131210120003045.000000000000000,Block 3045, Block Group 3, Census Tract 120, Fulton County, Georgia,36,2,34,32,6,25,1,2
-1,131210006013005.000000000000000,Block 3005, Block Group 3, Census Tract 6.01, Fulton County, Georgia,35,0,35,27,17,1,0,8
-1,131210018011006.000000000000000,Block 1006, Block Group 1, Census Tract 18.01, Fulton County, Georgia,35,3,32,28,12,15,1,4
-1,131210032002002.000000000000000,Block 2002, Block Group 2, Census Tract 32, Fulton County, Georgia,35,4,31,30,27,3,0,1
-1,131210032002009.000000000000000,Block 2009, Block Group 2, Census Tract 32, Fulton County, Georgia,35,5,30,23,16,7,0,7
-1,131210041003016.000000000000000,Block 3016, Block Group 3, Census Tract 41, Fulton County, Georgia,35,0,35,34,1,30,0,1
-1,131210044002015.000000000000000,Block 2015, Block Group 2, Census Tract 44, Fulton County, Georgia,35,2,33,32,6,24,0,1
-1,131210049002015.000000000000000,Block 2015, Block Group 2, Census Tract 49, Fulton County, Georgia,35,0,35,34,32,0,0,1
-1,131210049002028.000000000000000,Block 2028, Block Group 2, Census Tract 49, Fulton County, Georgia,35,4,31,31,28,2,0,0
-1,131210052003015.000000000000000,Block 3015, Block Group 3, Census Tract 52, Fulton County, Georgia,35,5,30,26,25,0,0,4
-1,131210055041011.000000000000000,Block 1011, Block Group 1, Census Tract 55.04, Fulton County, Georgia,35,4,31,31,3,28,0,0
-1,131210055041020.000000000000000,Block 1020, Block Group 1, Census Tract 55.04, Fulton County, Georgia,35,0,35,33,9,24,0,2
-1,131210057002015.000000000000000,Block 2015, Block Group 2, Census Tract 57, Fulton County, Georgia,35,2,33,33,10,23,0,0
-1,131210058001038.000000000000000,Block 1038, Block Group 1, Census Tract 58, Fulton County, Georgia,35,3,32,31,3,26,0,1
-1,131210058001042.000000000000000,Block 1042, Block Group 1, Census Tract 58, Fulton County, Georgia,35,2,33,33,14,18,0,0
-1,131210060001008.000000000000000,Block 1008, Block Group 1, Census Tract 60, Fulton County, Georgia,35,1,34,32,8,24,0,2
-1,131210061001000.000000000000000,Block 1000, Block Group 1, Census Tract 61, Fulton County, Georgia,35,5,30,30,11,19,0,0
-1,131210062002009.000000000000000,Block 2009, Block Group 2, Census Tract 62, Fulton County, Georgia,35,4,31,31,13,17,0,0
-1,131210065003012.000000000000000,Block 3012, Block Group 3, Census Tract 65, Fulton County, Georgia,35,3,32,31,8,23,0,1
-1,131210065004014.000000000000000,Block 4014, Block Group 4, Census Tract 65, Fulton County, Georgia,35,4,31,29,8,21,0,2
-1,131210066021004.000000000000000,Block 1004, Block Group 1, Census Tract 66.02, Fulton County, Georgia,35,1,34,34,2,30,1,0
-1,131210066021007.000000000000000,Block 1007, Block Group 1, Census Tract 66.02, Fulton County, Georgia,35,0,35,34,3,31,0,1
-1,131210067021027.000000000000000,Block 1027, Block Group 1, Census Tract 67.02, Fulton County, Georgia,35,0,35,33,0,33,0,2
-1,131210069001005.000000000000000,Block 1005, Block Group 1, Census Tract 69, Fulton County, Georgia,35,4,31,23,12,10,0,8
-1,131210069001011.000000000000000,Block 1011, Block Group 1, Census Tract 69, Fulton County, Georgia,35,3,32,29,13,16,0,3
-1,131210070014016.000000000000000,Block 4016, Block Group 4, Census Tract 70.01, Fulton County, Georgia,35,4,31,30,11,19,0,1
-1,131210073022010.000000000000000,Block 2010, Block Group 2, Census Tract 73.02, Fulton County, Georgia,35,7,28,28,4,24,0,0
-1,131210076023001.000000000000000,Block 3001, Block Group 3, Census Tract 76.02, Fulton County, Georgia,35,3,32,29,0,28,0,3
-1,131210076041002.000000000000000,Block 1002, Block Group 1, Census Tract 76.04, Fulton County, Georgia,35,4,31,24,2,21,0,7
-1,131210077053003.000000000000000,Block 3003, Block Group 3, Census Tract 77.05, Fulton County, Georgia,35,1,34,32,1,31,0,2
-1,131210077072010.000000000000000,Block 2010, Block Group 2, Census Tract 77.07, Fulton County, Georgia,35,0,35,31,0,31,0,4
-1,131210078061003.000000000000000,Block 1003, Block Group 1, Census Tract 78.06, Fulton County, Georgia,35,3,32,29,2,27,0,3
-1,131210078062011.000000000000000,Block 2011, Block Group 2, Census Tract 78.06, Fulton County, Georgia,35,0,35,32,3,29,0,3
-1,131210079002000.000000000000000,Block 2000, Block Group 2, Census Tract 79, Fulton County, Georgia,35,0,35,34,0,34,0,1
-1,131210079002013.000000000000000,Block 2013, Block Group 2, Census Tract 79, Fulton County, Georgia,35,0,35,33,0,33,0,2
-1,131210080004003.000000000000000,Block 4003, Block Group 4, Census Tract 80, Fulton County, Georgia,35,2,33,30,0,30,0,3
-1,131210080004008.000000000000000,Block 4008, Block Group 4, Census Tract 80, Fulton County, Georgia,35,0,35,35,1,34,0,0
-1,131210080005010.000000000000000,Block 5010, Block Group 5, Census Tract 80, Fulton County, Georgia,35,0,35,35,4,31,0,0
-1,131210082032001.000000000000000,Block 2001, Block Group 2, Census Tract 82.03, Fulton County, Georgia,35,3,32,31,3,27,0,1
-1,131210082043013.000000000000000,Block 3013, Block Group 3, Census Tract 82.04, Fulton County, Georgia,35,2,33,31,0,31,0,2
-1,131210083021010.000000000000000,Block 1010, Block Group 1, Census Tract 83.02, Fulton County, Georgia,35,2,33,32,3,29,0,1
-1,131210084001002.000000000000000,Block 1002, Block Group 1, Census Tract 84, Fulton County, Georgia,35,1,34,34,5,29,0,0
-1,131210084001012.000000000000000,Block 1012, Block Group 1, Census Tract 84, Fulton County, Georgia,35,1,34,33,4,29,0,1
-1,131210085002023.000000000000000,Block 2023, Block Group 2, Census Tract 85, Fulton County, Georgia,35,5,30,24,0,24,0,6
-1,131210087022017.000000000000000,Block 2017, Block Group 2, Census Tract 87.02, Fulton County, Georgia,35,4,31,29,11,16,2,2
-1,131210088021011.000000000000000,Block 1011, Block Group 1, Census Tract 88.02, Fulton County, Georgia,35,5,30,28,21,3,0,2
-1,131210088021038.000000000000000,Block 1038, Block Group 1, Census Tract 88.02, Fulton County, Georgia,35,3,32,32,27,5,0,0
-1,131210088022014.000000000000000,Block 2014, Block Group 2, Census Tract 88.02, Fulton County, Georgia,35,10,25,24,15,9,0,1
-1,131210089051005.000000000000000,Block 1005, Block Group 1, Census Tract 89.05, Fulton County, Georgia,35,1,34,34,24,2,0,0
-1,131210089053001.000000000000000,Block 3001, Block Group 3, Census Tract 89.05, Fulton County, Georgia,35,8,27,24,18,3,0,3
-1,131210092032016.000000000000000,Block 2016, Block Group 2, Census Tract 92.03, Fulton County, Georgia,35,4,31,31,31,0,0,0
-1,131210093012011.000000000000000,Block 2011, Block Group 2, Census Tract 93.01, Fulton County, Georgia,35,3,32,32,31,0,0,0
-1,131210094101005.000000000000000,Block 1005, Block Group 1, Census Tract 94.10, Fulton County, Georgia,35,3,32,27,19,2,0,5
-1,131210097003024.000000000000000,Block 3024, Block Group 3, Census Tract 97, Fulton County, Georgia,35,0,35,30,27,0,1,5
-1,131210098021000.000000000000000,Block 1000, Block Group 1, Census Tract 98.02, Fulton County, Georgia,35,1,34,32,31,0,0,2
-1,131210098021009.000000000000000,Block 1009, Block Group 1, Census Tract 98.02, Fulton County, Georgia,35,4,31,31,29,0,0,0
-1,131210098021023.000000000000000,Block 1023, Block Group 1, Census Tract 98.02, Fulton County, Georgia,35,4,31,27,25,2,0,4
-1,131210101072001.000000000000000,Block 2001, Block Group 2, Census Tract 101.07, Fulton County, Georgia,35,3,32,24,15,2,0,8
-1,131210101083002.000000000000000,Block 3002, Block Group 3, Census Tract 101.08, Fulton County, Georgia,35,7,28,20,15,3,0,8
-1,131210101271007.000000000000000,Block 1007, Block Group 1, Census Tract 101.27, Fulton County, Georgia,35,0,35,34,19,6,2,1
-1,131210101271008.000000000000000,Block 1008, Block Group 1, Census Tract 101.27, Fulton County, Georgia,35,6,29,26,19,1,0,3
-1,131210101362001.000000000000000,Block 2001, Block Group 2, Census Tract 101.36, Fulton County, Georgia,35,11,24,20,15,0,5,4
-1,131210101362016.000000000000000,Block 2016, Block Group 2, Census Tract 101.36, Fulton County, Georgia,35,1,34,31,30,1,0,3
-1,131210103051010.000000000000000,Block 1010, Block Group 1, Census Tract 103.05, Fulton County, Georgia,35,0,35,34,0,34,0,1
-1,131210105082004.000000000000000,Block 2004, Block Group 2, Census Tract 105.08, Fulton County, Georgia,35,0,35,35,0,35,0,0
-1,131210105083003.000000000000000,Block 3003, Block Group 3, Census Tract 105.08, Fulton County, Georgia,35,1,34,31,2,28,0,3
-1,131210105083015.000000000000000,Block 3015, Block Group 3, Census Tract 105.08, Fulton County, Georgia,35,0,35,35,0,35,0,0
-1,131210105212015.000000000000000,Block 2015, Block Group 2, Census Tract 105.21, Fulton County, Georgia,35,2,33,33,0,33,0,0
-1,131210105293012.000000000000000,Block 3012, Block Group 3, Census Tract 105.29, Fulton County, Georgia,35,0,35,34,0,34,0,1
-1,131210105371002.000000000000000,Block 1002, Block Group 1, Census Tract 105.37, Fulton County, Georgia,35,6,29,27,0,27,0,2
-1,131210106011016.000000000000000,Block 1016, Block Group 1, Census Tract 106.01, Fulton County, Georgia,35,4,31,31,13,17,0,0
-1,131210106014008.000000000000000,Block 4008, Block Group 4, Census Tract 106.01, Fulton County, Georgia,35,0,35,29,10,19,0,6
-1,131210108013017.000000000000000,Block 3017, Block Group 3, Census Tract 108.01, Fulton County, Georgia,35,2,33,32,17,15,0,1
-1,131210111001026.000000000000000,Block 1026, Block Group 1, Census Tract 111, Fulton County, Georgia,35,0,35,30,16,14,0,5
-1,131210111003007.000000000000000,Block 3007, Block Group 3, Census Tract 111, Fulton County, Georgia,35,6,29,25,25,0,0,4
-1,131210111003011.000000000000000,Block 3011, Block Group 3, Census Tract 111, Fulton County, Georgia,35,14,21,17,4,13,0,4
-1,131210112024007.000000000000000,Block 4007, Block Group 4, Census Tract 112.02, Fulton County, Georgia,35,4,31,27,8,16,0,4
-1,131210112031016.000000000000000,Block 1016, Block Group 1, Census Tract 112.03, Fulton County, Georgia,35,10,25,25,3,22,0,0
-1,131210113016006.000000000000000,Block 6006, Block Group 6, Census Tract 113.01, Fulton County, Georgia,35,4,31,26,8,17,0,5
-1,131210114172006.000000000000000,Block 2006, Block Group 2, Census Tract 114.17, Fulton County, Georgia,35,3,32,24,24,0,0,8
-1,131210114194019.000000000000000,Block 4019, Block Group 4, Census Tract 114.19, Fulton County, Georgia,35,3,32,32,27,2,0,0
-1,131210114194024.000000000000000,Block 4024, Block Group 4, Census Tract 114.19, Fulton County, Georgia,35,5,30,26,19,4,0,4
-1,131210114242002.000000000000000,Block 2002, Block Group 2, Census Tract 114.24, Fulton County, Georgia,35,3,32,27,13,5,0,5
-1,131210114363014.000000000000000,Block 3014, Block Group 3, Census Tract 114.36, Fulton County, Georgia,35,2,33,29,24,0,0,4
-1,131210114392005.000000000000000,Block 2005, Block Group 2, Census Tract 114.39, Fulton County, Georgia,35,10,25,16,0,16,0,9
-1,131210116321010.000000000000000,Block 1010, Block Group 1, Census Tract 116.32, Fulton County, Georgia,35,4,31,30,0,7,0,1
-1,131210116423002.000000000000000,Block 3002, Block Group 3, Census Tract 116.42, Fulton County, Georgia,35,10,25,24,9,7,0,1
-1,131210116452003.000000000000000,Block 2003, Block Group 2, Census Tract 116.45, Fulton County, Georgia,35,10,25,24,0,7,0,1
-1,131210116582005.000000000000000,Block 2005, Block Group 2, Census Tract 116.58, Fulton County, Georgia,35,7,28,27,8,5,2,1
-1,131210118021028.000000000000000,Block 1028, Block Group 1, Census Tract 118.02, Fulton County, Georgia,35,0,35,31,0,31,0,4
-1,131210120002009.000000000000000,Block 2009, Block Group 2, Census Tract 120, Fulton County, Georgia,35,1,34,32,0,30,2,2
-1,131210123004003.000000000000000,Block 4003, Block Group 4, Census Tract 123, Fulton County, Georgia,35,14,21,21,0,20,1,0
-1,131210001005002.000000000000000,Block 5002, Block Group 5, Census Tract 1, Fulton County, Georgia,34,9,25,23,17,2,1,2
-1,131210005022023.000000000000000,Block 2023, Block Group 2, Census Tract 5.02, Fulton County, Georgia,34,4,30,25,22,0,0,5
-1,131210007001017.000000000000000,Block 1017, Block Group 1, Census Tract 7, Fulton County, Georgia,34,1,33,32,29,1,0,1
-1,131210010011004.000000000000000,Block 1004, Block Group 1, Census Tract 10.01, Fulton County, Georgia,34,5,29,14,10,2,0,15
-1,131210013022004.000000000000000,Block 2004, Block Group 2, Census Tract 13.02, Fulton County, Georgia,34,2,32,29,22,1,2,3
-1,131210016002003.000000000000000,Block 2003, Block Group 2, Census Tract 16, Fulton County, Georgia,34,4,30,27,20,1,2,3
-1,131210023001011.000000000000000,Block 1011, Block Group 1, Census Tract 23, Fulton County, Georgia,34,2,32,32,1,31,0,0
-1,131210023003009.000000000000000,Block 3009, Block Group 3, Census Tract 23, Fulton County, Georgia,34,0,34,32,0,32,0,2
-1,131210028011005.000000000000000,Block 1005, Block Group 1, Census Tract 28.01, Fulton County, Georgia,34,13,21,9,8,1,0,12
-1,131210032001000.000000000000000,Block 1000, Block Group 1, Census Tract 32, Fulton County, Georgia,34,3,31,23,17,5,0,8
-1,131210035002032.000000000000000,Block 2032, Block Group 2, Census Tract 35, Fulton County, Georgia,34,2,32,31,16,10,0,1
-1,131210040003006.000000000000000,Block 3006, Block Group 3, Census Tract 40, Fulton County, Georgia,34,1,33,32,2,29,0,1
-1,131210049002022.000000000000000,Block 2022, Block Group 2, Census Tract 49, Fulton County, Georgia,34,0,34,30,22,7,0,4
-1,131210050002006.000000000000000,Block 2006, Block Group 2, Census Tract 50, Fulton County, Georgia,34,2,32,30,28,0,0,2
-1,131210053001017.000000000000000,Block 1017, Block Group 1, Census Tract 53, Fulton County, Georgia,34,1,33,32,27,1,0,1
-1,131210053002001.000000000000000,Block 2001, Block Group 2, Census Tract 53, Fulton County, Georgia,34,2,32,30,29,1,0,2
-1,131210055041025.000000000000000,Block 1025, Block Group 1, Census Tract 55.04, Fulton County, Georgia,34,3,31,27,2,24,0,4
-1,131210061003011.000000000000000,Block 3011, Block Group 3, Census Tract 61, Fulton County, Georgia,34,4,30,29,2,27,0,1
-1,131210063002017.000000000000000,Block 2017, Block Group 2, Census Tract 63, Fulton County, Georgia,34,0,34,34,4,30,0,0
-1,131210067022007.000000000000000,Block 2007, Block Group 2, Census Tract 67.02, Fulton County, Georgia,34,0,34,30,4,25,1,4
-1,131210069003009.000000000000000,Block 3009, Block Group 3, Census Tract 69, Fulton County, Georgia,34,1,33,33,16,15,2,0
-1,131210069003024.000000000000000,Block 3024, Block Group 3, Census Tract 69, Fulton County, Georgia,34,4,30,28,25,3,0,2
-1,131210070012003.000000000000000,Block 2003, Block Group 2, Census Tract 70.01, Fulton County, Georgia,34,2,32,30,0,28,1,2
-1,131210070023003.000000000000000,Block 3003, Block Group 3, Census Tract 70.02, Fulton County, Georgia,34,11,23,21,4,17,0,2
-1,131210073012001.000000000000000,Block 2001, Block Group 2, Census Tract 73.01, Fulton County, Georgia,34,3,31,26,0,26,0,5
-1,131210073022007.000000000000000,Block 2007, Block Group 2, Census Tract 73.02, Fulton County, Georgia,34,4,30,23,0,22,1,7
-1,131210076031007.000000000000000,Block 1007, Block Group 1, Census Tract 76.03, Fulton County, Georgia,34,2,32,32,0,31,0,0
-1,131210080004015.000000000000000,Block 4015, Block Group 4, Census Tract 80, Fulton County, Georgia,34,4,30,30,4,26,0,0
-1,131210082043004.000000000000000,Block 3004, Block Group 3, Census Tract 82.04, Fulton County, Georgia,34,4,30,30,0,30,0,0
-1,131210083011005.000000000000000,Block 1005, Block Group 1, Census Tract 83.01, Fulton County, Georgia,34,1,33,33,3,30,0,0
-1,131210088011022.000000000000000,Block 1022, Block Group 1, Census Tract 88.01, Fulton County, Georgia,34,8,26,23,21,2,0,3
-1,131210088021041.000000000000000,Block 1041, Block Group 1, Census Tract 88.02, Fulton County, Georgia,34,2,32,32,29,1,0,0
-1,131210089052011.000000000000000,Block 2011, Block Group 2, Census Tract 89.05, Fulton County, Georgia,34,6,28,28,20,5,0,0
-1,131210089054018.000000000000000,Block 4018, Block Group 4, Census Tract 89.05, Fulton County, Georgia,34,2,32,29,21,6,0,3
-1,131210089062012.000000000000000,Block 2012, Block Group 2, Census Tract 89.06, Fulton County, Georgia,34,4,30,24,18,4,0,6
-1,131210090022015.000000000000000,Block 2015, Block Group 2, Census Tract 90.02, Fulton County, Georgia,34,1,33,32,30,0,1,1
-1,131210097003018.000000000000000,Block 3018, Block Group 3, Census Tract 97, Fulton County, Georgia,34,4,30,30,28,2,0,0
-1,131210099001011.000000000000000,Block 1011, Block Group 1, Census Tract 99, Fulton County, Georgia,34,2,32,30,22,2,0,2
-1,131210100071010.000000000000000,Block 1010, Block Group 1, Census Tract 100.07, Fulton County, Georgia,34,0,34,33,30,2,1,1
-1,131210101371001.000000000000000,Block 1001, Block Group 1, Census Tract 101.37, Fulton County, Georgia,34,3,31,17,13,4,0,14
-1,131210103051003.000000000000000,Block 1003, Block Group 1, Census Tract 103.05, Fulton County, Georgia,34,0,34,30,0,29,0,4
-1,131210103051031.000000000000000,Block 1031, Block Group 1, Census Tract 103.05, Fulton County, Georgia,34,0,34,33,0,31,2,1
-1,131210103071005.000000000000000,Block 1005, Block Group 1, Census Tract 103.07, Fulton County, Georgia,34,1,33,31,6,22,0,2
-1,131210103073006.000000000000000,Block 3006, Block Group 3, Census Tract 103.07, Fulton County, Georgia,34,0,34,33,0,33,0,1
-1,131210103081006.000000000000000,Block 1006, Block Group 1, Census Tract 103.08, Fulton County, Georgia,34,10,24,23,0,23,0,1
-1,131210104013005.000000000000000,Block 3005, Block Group 3, Census Tract 104.01, Fulton County, Georgia,34,0,34,34,10,24,0,0
-1,131210104022041.000000000000000,Block 2041, Block Group 2, Census Tract 104.02, Fulton County, Georgia,34,0,34,34,27,7,0,0
-1,131210105182004.000000000000000,Block 2004, Block Group 2, Census Tract 105.18, Fulton County, Georgia,34,4,30,30,0,29,1,0
-1,131210105211014.000000000000000,Block 1014, Block Group 1, Census Tract 105.21, Fulton County, Georgia,34,2,32,30,2,28,0,2
-1,131210105212014.000000000000000,Block 2014, Block Group 2, Census Tract 105.21, Fulton County, Georgia,34,0,34,32,0,30,0,2
-1,131210105264010.000000000000000,Block 4010, Block Group 4, Census Tract 105.26, Fulton County, Georgia,34,3,31,28,0,26,2,3
-1,131210105283017.000000000000000,Block 3017, Block Group 3, Census Tract 105.28, Fulton County, Georgia,34,1,33,33,0,33,0,0
-1,131210105343009.000000000000000,Block 3009, Block Group 3, Census Tract 105.34, Fulton County, Georgia,34,1,33,33,0,29,3,0
-1,131210105401017.000000000000000,Block 1017, Block Group 1, Census Tract 105.40, Fulton County, Georgia,34,1,33,33,0,33,0,0
-1,131210108013015.000000000000000,Block 3015, Block Group 3, Census Tract 108.01, Fulton County, Georgia,34,4,30,30,7,19,0,0
-1,131210110001004.000000000000000,Block 1004, Block Group 1, Census Tract 110, Fulton County, Georgia,34,29,5,5,4,0,0,0
-1,131210111001021.000000000000000,Block 1021, Block Group 1, Census Tract 111, Fulton County, Georgia,34,5,29,28,20,7,0,1
-1,131210111002003.000000000000000,Block 2003, Block Group 2, Census Tract 111, Fulton County, Georgia,34,4,30,29,22,7,0,1
-1,131210111002033.000000000000000,Block 2033, Block Group 2, Census Tract 111, Fulton County, Georgia,34,8,26,25,19,6,0,1
-1,131210112022002.000000000000000,Block 2002, Block Group 2, Census Tract 112.02, Fulton County, Georgia,34,0,34,31,3,28,0,3
-1,131210112023032.000000000000000,Block 3032, Block Group 3, Census Tract 112.02, Fulton County, Georgia,34,13,21,19,1,18,0,2
-1,131210112032003.000000000000000,Block 2003, Block Group 2, Census Tract 112.03, Fulton County, Georgia,34,6,28,27,7,20,0,1
-1,131210113093002.000000000000000,Block 3002, Block Group 3, Census Tract 113.09, Fulton County, Georgia,34,4,30,29,1,24,1,1
-1,131210113102006.000000000000000,Block 2006, Block Group 2, Census Tract 113.10, Fulton County, Georgia,34,4,30,30,2,28,0,0
-1,131210114172009.000000000000000,Block 2009, Block Group 2, Census Tract 114.17, Fulton County, Georgia,34,8,26,24,15,0,0,2
-1,131210114223011.000000000000000,Block 3011, Block Group 3, Census Tract 114.22, Fulton County, Georgia,34,1,33,33,27,3,0,0
-1,131210114294006.000000000000000,Block 4006, Block Group 4, Census Tract 114.29, Fulton County, Georgia,34,0,34,27,0,0,0,7
-1,131210114422004.000000000000000,Block 2004, Block Group 2, Census Tract 114.42, Fulton County, Georgia,34,8,26,24,12,9,0,2
-1,131210115101003.000000000000000,Block 1003, Block Group 1, Census Tract 115.10, Fulton County, Georgia,34,8,26,22,16,6,0,4
-1,131210115102032.000000000000000,Block 2032, Block Group 2, Census Tract 115.10, Fulton County, Georgia,34,4,30,28,16,0,0,2
-1,131210115122026.000000000000000,Block 2026, Block Group 2, Census Tract 115.12, Fulton County, Georgia,34,3,31,28,28,0,0,3
-1,131210116281001.000000000000000,Block 1001, Block Group 1, Census Tract 116.28, Fulton County, Georgia,34,1,33,24,3,6,1,9
-1,131210116503003.000000000000000,Block 3003, Block Group 3, Census Tract 116.50, Fulton County, Georgia,34,8,26,25,11,5,0,1
-1,131210116542006.000000000000000,Block 2006, Block Group 2, Census Tract 116.54, Fulton County, Georgia,34,12,22,18,18,0,0,4
-1,131210116562012.000000000000000,Block 2012, Block Group 2, Census Tract 116.56, Fulton County, Georgia,34,7,27,19,13,6,0,8
-1,131210116581004.000000000000000,Block 1004, Block Group 1, Census Tract 116.58, Fulton County, Georgia,34,7,27,22,13,7,0,5
-1,131210116602002.000000000000000,Block 2002, Block Group 2, Census Tract 116.60, Fulton County, Georgia,34,14,20,16,6,3,5,4
-1,131210120002021.000000000000000,Block 2021, Block Group 2, Census Tract 120, Fulton County, Georgia,34,0,34,34,0,34,0,0
-1,131210002012001.000000000000000,Block 2001, Block Group 2, Census Tract 2.01, Fulton County, Georgia,33,3,30,29,27,0,1,1
-1,131210005012011.000000000000000,Block 2011, Block Group 2, Census Tract 5.01, Fulton County, Georgia,33,11,22,22,7,6,1,0
-1,131210006013014.000000000000000,Block 3014, Block Group 3, Census Tract 6.01, Fulton County, Georgia,33,2,31,31,28,1,2,0
-1,131210012051007.000000000000000,Block 1007, Block Group 1, Census Tract 12.05, Fulton County, Georgia,33,4,29,27,26,0,1,2
-1,131210017012005.000000000000000,Block 2005, Block Group 2, Census Tract 17.01, Fulton County, Georgia,33,0,33,32,2,28,0,1
-1,131210024002002.000000000000000,Block 2002, Block Group 2, Census Tract 24, Fulton County, Georgia,33,0,33,30,1,27,0,3
-1,131210026002021.000000000000000,Block 2021, Block Group 2, Census Tract 26, Fulton County, Georgia,33,5,28,27,1,24,0,1
-1,131210035001015.000000000000000,Block 1015, Block Group 1, Census Tract 35, Fulton County, Georgia,33,2,31,22,1,15,6,9
-1,131210038001004.000000000000000,Block 1004, Block Group 1, Census Tract 38, Fulton County, Georgia,33,0,33,28,6,21,0,5
-1,131210039001008.000000000000000,Block 1008, Block Group 1, Census Tract 39, Fulton County, Georgia,33,0,33,33,0,31,2,0
-1,131210040001020.000000000000000,Block 1020, Block Group 1, Census Tract 40, Fulton County, Georgia,33,0,33,31,4,27,0,2
-1,131210040002015.000000000000000,Block 2015, Block Group 2, Census Tract 40, Fulton County, Georgia,33,5,28,27,14,12,1,1
-1,131210052004004.000000000000000,Block 4004, Block Group 4, Census Tract 52, Fulton County, Georgia,33,4,29,22,15,7,0,7
-1,131210053003000.000000000000000,Block 3000, Block Group 3, Census Tract 53, Fulton County, Georgia,33,5,28,24,21,3,0,4
-1,131210055011023.000000000000000,Block 1023, Block Group 1, Census Tract 55.01, Fulton County, Georgia,33,0,33,28,4,15,0,5
-1,131210055041017.000000000000000,Block 1017, Block Group 1, Census Tract 55.04, Fulton County, Georgia,33,1,32,31,14,17,0,1
-1,131210057001011.000000000000000,Block 1011, Block Group 1, Census Tract 57, Fulton County, Georgia,33,3,30,30,2,28,0,0
-1,131210060004009.000000000000000,Block 4009, Block Group 4, Census Tract 60, Fulton County, Georgia,33,0,33,32,14,17,0,1
-1,131210061002001.000000000000000,Block 2001, Block Group 2, Census Tract 61, Fulton County, Georgia,33,2,31,31,0,31,0,0
-1,131210063002011.000000000000000,Block 2011, Block Group 2, Census Tract 63, Fulton County, Georgia,33,6,27,25,7,18,0,2
-1,131210063002016.000000000000000,Block 2016, Block Group 2, Census Tract 63, Fulton County, Georgia,33,3,30,30,0,30,0,0
-1,131210065004003.000000000000000,Block 4003, Block Group 4, Census Tract 65, Fulton County, Georgia,33,2,31,30,6,23,0,1
-1,131210067011001.000000000000000,Block 1001, Block Group 1, Census Tract 67.01, Fulton County, Georgia,33,0,33,33,3,30,0,0
-1,131210071001004.000000000000000,Block 1004, Block Group 1, Census Tract 71, Fulton County, Georgia,33,0,33,32,2,30,0,1
-1,131210072001001.000000000000000,Block 1001, Block Group 1, Census Tract 72, Fulton County, Georgia,33,5,28,22,0,22,0,6
-1,131210073011002.000000000000000,Block 1002, Block Group 1, Census Tract 73.01, Fulton County, Georgia,33,1,32,29,0,29,0,3
-1,131210074002002.000000000000000,Block 2002, Block Group 2, Census Tract 74, Fulton County, Georgia,33,6,27,22,1,21,0,5
-1,131210076021001.000000000000000,Block 1001, Block Group 1, Census Tract 76.02, Fulton County, Georgia,33,2,31,28,3,22,0,3
-1,131210077082009.000000000000000,Block 2009, Block Group 2, Census Tract 77.08, Fulton County, Georgia,33,2,31,20,0,15,1,11
-1,131210077111005.000000000000000,Block 1005, Block Group 1, Census Tract 77.11, Fulton County, Georgia,33,8,25,25,2,23,0,0
-1,131210077112004.000000000000000,Block 2004, Block Group 2, Census Tract 77.11, Fulton County, Georgia,33,0,33,31,1,26,2,2
-1,131210078061008.000000000000000,Block 1008, Block Group 1, Census Tract 78.06, Fulton County, Georgia,33,2,31,30,0,30,0,1
-1,131210078094001.000000000000000,Block 4001, Block Group 4, Census Tract 78.09, Fulton County, Georgia,33,3,30,26,6,19,0,4
-1,131210082022004.000000000000000,Block 2004, Block Group 2, Census Tract 82.02, Fulton County, Georgia,33,8,25,25,0,25,0,0
-1,131210082022008.000000000000000,Block 2008, Block Group 2, Census Tract 82.02, Fulton County, Georgia,33,1,32,29,0,29,0,3
-1,131210082042003.000000000000000,Block 2003, Block Group 2, Census Tract 82.04, Fulton County, Georgia,33,2,31,30,0,29,0,1
-1,131210082042004.000000000000000,Block 2004, Block Group 2, Census Tract 82.04, Fulton County, Georgia,33,1,32,32,2,30,0,0
-1,131210082042013.000000000000000,Block 2013, Block Group 2, Census Tract 82.04, Fulton County, Georgia,33,1,32,31,1,30,0,1
-1,131210083012006.000000000000000,Block 2006, Block Group 2, Census Tract 83.01, Fulton County, Georgia,33,0,33,32,0,31,0,1
-1,131210085002020.000000000000000,Block 2020, Block Group 2, Census Tract 85, Fulton County, Georgia,33,0,33,33,1,32,0,0
-1,131210085003037.000000000000000,Block 3037, Block Group 3, Census Tract 85, Fulton County, Georgia,33,2,31,31,0,31,0,0
-1,131210087021008.000000000000000,Block 1008, Block Group 1, Census Tract 87.02, Fulton County, Georgia,33,0,33,31,22,8,0,2
-1,131210088021001.000000000000000,Block 1001, Block Group 1, Census Tract 88.02, Fulton County, Georgia,33,21,12,10,2,4,2,2
-1,131210089091003.000000000000000,Block 1003, Block Group 1, Census Tract 89.09, Fulton County, Georgia,33,1,32,30,21,9,0,2
-1,131210090022013.000000000000000,Block 2013, Block Group 2, Census Tract 90.02, Fulton County, Georgia,33,2,31,29,29,0,0,2
-1,131210093022005.000000000000000,Block 2005, Block Group 2, Census Tract 93.02, Fulton County, Georgia,33,0,33,31,30,0,1,2
-1,131210097002013.000000000000000,Block 2013, Block Group 2, Census Tract 97, Fulton County, Georgia,33,0,33,33,24,5,1,0
-1,131210098023009.000000000000000,Block 3009, Block Group 3, Census Tract 98.02, Fulton County, Georgia,33,2,31,30,23,1,2,1
-1,131210101063002.000000000000000,Block 3002, Block Group 3, Census Tract 101.06, Fulton County, Georgia,33,0,33,30,25,1,0,3
-1,131210101351001.000000000000000,Block 1001, Block Group 1, Census Tract 101.35, Fulton County, Georgia,33,0,33,30,26,3,0,3
-1,131210102042002.000000000000000,Block 2002, Block Group 2, Census Tract 102.04, Fulton County, Georgia,33,5,28,27,3,12,0,1
-1,131210103051011.000000000000000,Block 1011, Block Group 1, Census Tract 103.05, Fulton County, Georgia,33,0,33,30,2,28,0,3
-1,131210103083001.000000000000000,Block 3001, Block Group 3, Census Tract 103.08, Fulton County, Georgia,33,0,33,31,2,29,0,2
-1,131210103083004.000000000000000,Block 3004, Block Group 3, Census Tract 103.08, Fulton County, Georgia,33,1,32,30,0,30,0,2
-1,131210103131011.000000000000000,Block 1011, Block Group 1, Census Tract 103.13, Fulton County, Georgia,33,2,31,24,1,18,0,7
-1,131210103151002.000000000000000,Block 1002, Block Group 1, Census Tract 103.15, Fulton County, Georgia,33,0,33,33,0,33,0,0
-1,131210104012017.000000000000000,Block 2017, Block Group 2, Census Tract 104.01, Fulton County, Georgia,33,5,28,28,3,25,0,0
-1,131210104021016.000000000000000,Block 1016, Block Group 1, Census Tract 104.02, Fulton County, Georgia,33,5,28,28,26,2,0,0
-1,131210104023054.000000000000000,Block 3054, Block Group 3, Census Tract 104.02, Fulton County, Georgia,33,0,33,31,31,0,0,2
-1,131210105081000.000000000000000,Block 1000, Block Group 1, Census Tract 105.08, Fulton County, Georgia,33,1,32,31,0,28,0,1
-1,131210105283015.000000000000000,Block 3015, Block Group 3, Census Tract 105.28, Fulton County, Georgia,33,2,31,28,12,11,3,3
-1,131210105293022.000000000000000,Block 3022, Block Group 3, Census Tract 105.29, Fulton County, Georgia,33,0,33,30,0,30,0,3
-1,131210105302008.000000000000000,Block 2008, Block Group 2, Census Tract 105.30, Fulton County, Georgia,33,2,31,30,0,25,2,1
-1,131210105321003.000000000000000,Block 1003, Block Group 1, Census Tract 105.32, Fulton County, Georgia,33,1,32,30,2,28,0,2
-1,131210105381014.000000000000000,Block 1014, Block Group 1, Census Tract 105.38, Fulton County, Georgia,33,2,31,31,6,25,0,0
-1,131210105401027.000000000000000,Block 1027, Block Group 1, Census Tract 105.40, Fulton County, Georgia,33,4,29,27,0,27,0,2
-1,131210111002030.000000000000000,Block 2030, Block Group 2, Census Tract 111, Fulton County, Georgia,33,1,32,28,20,8,0,4
-1,131210111002037.000000000000000,Block 2037, Block Group 2, Census Tract 111, Fulton County, Georgia,33,2,31,30,12,18,0,1
-1,131210111003004.000000000000000,Block 3004, Block Group 3, Census Tract 111, Fulton County, Georgia,33,3,30,29,9,20,0,1
-1,131210112023026.000000000000000,Block 3026, Block Group 3, Census Tract 112.02, Fulton County, Georgia,33,4,29,29,3,26,0,0
-1,131210112032008.000000000000000,Block 2008, Block Group 2, Census Tract 112.03, Fulton County, Georgia,33,2,31,31,0,27,3,0
-1,131210112032009.000000000000000,Block 2009, Block Group 2, Census Tract 112.03, Fulton County, Georgia,33,4,29,28,0,28,0,1
-1,131210112032022.000000000000000,Block 2022, Block Group 2, Census Tract 112.03, Fulton County, Georgia,33,5,28,27,4,22,0,1
-1,131210112042003.000000000000000,Block 2003, Block Group 2, Census Tract 112.04, Fulton County, Georgia,33,5,28,16,1,15,0,12
-1,131210113013004.000000000000000,Block 3004, Block Group 3, Census Tract 113.01, Fulton County, Georgia,33,11,22,21,8,13,0,1
-1,131210113105009.000000000000000,Block 5009, Block Group 5, Census Tract 113.10, Fulton County, Georgia,33,15,18,18,4,14,0,0
-1,131210114241002.000000000000000,Block 1002, Block Group 1, Census Tract 114.24, Fulton County, Georgia,33,7,26,13,11,0,1,13
-1,131210114261004.000000000000000,Block 1004, Block Group 1, Census Tract 114.26, Fulton County, Georgia,33,10,23,17,13,0,1,6
-1,131210114321003.000000000000000,Block 1003, Block Group 1, Census Tract 114.32, Fulton County, Georgia,33,4,29,28,15,6,0,1
-1,131210114321005.000000000000000,Block 1005, Block Group 1, Census Tract 114.32, Fulton County, Georgia,33,6,27,20,7,10,0,7
-1,131210114382011.000000000000000,Block 2011, Block Group 2, Census Tract 114.38, Fulton County, Georgia,33,3,30,26,20,5,0,4
-1,131210114442013.000000000000000,Block 2013, Block Group 2, Census Tract 114.44, Fulton County, Georgia,33,2,31,29,13,6,3,2
-1,131210115082010.000000000000000,Block 2010, Block Group 2, Census Tract 115.08, Fulton County, Georgia,33,4,29,21,16,5,0,8
-1,131210115092013.000000000000000,Block 2013, Block Group 2, Census Tract 115.09, Fulton County, Georgia,33,8,25,25,22,0,0,0
-1,131210115121008.000000000000000,Block 1008, Block Group 1, Census Tract 115.12, Fulton County, Georgia,33,2,31,31,28,3,0,0
-1,131210115142007.000000000000000,Block 2007, Block Group 2, Census Tract 115.14, Fulton County, Georgia,33,2,31,23,21,2,0,8
-1,131210115142019.000000000000000,Block 2019, Block Group 2, Census Tract 115.14, Fulton County, Georgia,33,7,26,23,19,0,1,3
-1,131210116242000.000000000000000,Block 2000, Block Group 2, Census Tract 116.24, Fulton County, Georgia,33,5,28,21,3,9,2,7
-1,131210116372014.000000000000000,Block 2014, Block Group 2, Census Tract 116.37, Fulton County, Georgia,33,2,31,29,11,2,0,2
-1,131210116391007.000000000000000,Block 1007, Block Group 1, Census Tract 116.39, Fulton County, Georgia,33,4,29,21,13,4,1,8
-1,131210116401009.000000000000000,Block 1009, Block Group 1, Census Tract 116.40, Fulton County, Georgia,33,10,23,17,10,7,0,6
-1,131210116402007.000000000000000,Block 2007, Block Group 2, Census Tract 116.40, Fulton County, Georgia,33,1,32,29,18,2,0,3
-1,131210116461015.000000000000000,Block 1015, Block Group 1, Census Tract 116.46, Fulton County, Georgia,33,11,22,17,4,5,2,5
-1,131210116493019.000000000000000,Block 3019, Block Group 3, Census Tract 116.49, Fulton County, Georgia,33,8,25,21,6,0,2,4
-1,131210118021030.000000000000000,Block 1030, Block Group 1, Census Tract 118.02, Fulton County, Georgia,33,2,31,27,0,27,0,4
-1,131210119022009.000000000000000,Block 2009, Block Group 2, Census Tract 119.02, Fulton County, Georgia,33,1,32,31,23,7,0,1
-1,131210123004027.000000000000000,Block 4027, Block Group 4, Census Tract 123, Fulton County, Georgia,33,3,30,26,4,22,0,4
-1,131210002011003.000000000000000,Block 1003, Block Group 1, Census Tract 2.01, Fulton County, Georgia,32,2,30,29,28,1,0,1
-1,131210002012000.000000000000000,Block 2000, Block Group 2, Census Tract 2.01, Fulton County, Georgia,32,6,26,22,18,4,0,4
-1,131210006013001.000000000000000,Block 3001, Block Group 3, Census Tract 6.01, Fulton County, Georgia,32,1,31,30,27,3,0,1
-1,131210006013006.000000000000000,Block 3006, Block Group 3, Census Tract 6.01, Fulton County, Georgia,32,0,32,31,16,2,0,1
-1,131210007001013.000000000000000,Block 1013, Block Group 1, Census Tract 7, Fulton County, Georgia,32,2,30,29,20,5,1,1
-1,131210023003012.000000000000000,Block 3012, Block Group 3, Census Tract 23, Fulton County, Georgia,32,3,29,29,0,29,0,0
-1,131210025001010.000000000000000,Block 1010, Block Group 1, Census Tract 25, Fulton County, Georgia,32,1,31,30,0,30,0,1
-1,131210026001004.000000000000000,Block 1004, Block Group 1, Census Tract 26, Fulton County, Georgia,32,2,30,27,0,27,0,3
-1,131210035002023.000000000000000,Block 2023, Block Group 2, Census Tract 35, Fulton County, Georgia,32,2,30,30,0,27,3,0
-1,131210039001021.000000000000000,Block 1021, Block Group 1, Census Tract 39, Fulton County, Georgia,32,0,32,32,0,32,0,0
-1,131210039002001.000000000000000,Block 2001, Block Group 2, Census Tract 39, Fulton County, Georgia,32,1,31,30,0,30,0,1
-1,131210050001004.000000000000000,Block 1004, Block Group 1, Census Tract 50, Fulton County, Georgia,32,9,23,21,19,0,2,2
-1,131210052003014.000000000000000,Block 3014, Block Group 3, Census Tract 52, Fulton County, Georgia,32,3,29,29,27,2,0,0
-1,131210053002005.000000000000000,Block 2005, Block Group 2, Census Tract 53, Fulton County, Georgia,32,4,28,28,18,10,0,0
-1,131210055011010.000000000000000,Block 1010, Block Group 1, Census Tract 55.01, Fulton County, Georgia,32,7,25,23,0,22,1,2
-1,131210055011018.000000000000000,Block 1018, Block Group 1, Census Tract 55.01, Fulton County, Georgia,32,2,30,29,20,9,0,1
-1,131210057001003.000000000000000,Block 1003, Block Group 1, Census Tract 57, Fulton County, Georgia,32,0,32,32,4,28,0,0
-1,131210063002004.000000000000000,Block 2004, Block Group 2, Census Tract 63, Fulton County, Georgia,32,0,32,31,5,23,0,1
-1,131210065001010.000000000000000,Block 1010, Block Group 1, Census Tract 65, Fulton County, Georgia,32,0,32,32,2,30,0,0
-1,131210065004009.000000000000000,Block 4009, Block Group 4, Census Tract 65, Fulton County, Georgia,32,0,32,31,12,18,0,1
-1,131210066012004.000000000000000,Block 2004, Block Group 2, Census Tract 66.01, Fulton County, Georgia,32,0,32,32,5,27,0,0
-1,131210077032012.000000000000000,Block 2012, Block Group 2, Census Tract 77.03, Fulton County, Georgia,32,6,26,26,0,26,0,0
-1,131210077051001.000000000000000,Block 1001, Block Group 1, Census Tract 77.05, Fulton County, Georgia,32,3,29,27,0,27,0,2
-1,131210077053004.000000000000000,Block 3004, Block Group 3, Census Tract 77.05, Fulton County, Georgia,32,2,30,28,0,26,1,2
-1,131210077082010.000000000000000,Block 2010, Block Group 2, Census Tract 77.08, Fulton County, Georgia,32,2,30,29,3,26,0,1
-1,131210078093000.000000000000000,Block 3000, Block Group 3, Census Tract 78.09, Fulton County, Georgia,32,3,29,25,0,25,0,4
-1,131210079002001.000000000000000,Block 2001, Block Group 2, Census Tract 79, Fulton County, Georgia,32,5,27,24,0,22,2,3
-1,131210079003001.000000000000000,Block 3001, Block Group 3, Census Tract 79, Fulton County, Georgia,32,1,31,31,1,30,0,0
-1,131210080004017.000000000000000,Block 4017, Block Group 4, Census Tract 80, Fulton County, Georgia,32,0,32,32,10,22,0,0
-1,131210080005003.000000000000000,Block 5003, Block Group 5, Census Tract 80, Fulton County, Georgia,32,2,30,26,4,21,0,4
-1,131210080005011.000000000000000,Block 5011, Block Group 5, Census Tract 80, Fulton County, Georgia,32,0,32,32,1,31,0,0
-1,131210081043021.000000000000000,Block 3021, Block Group 3, Census Tract 81.04, Fulton County, Georgia,32,1,31,31,0,31,0,0
-1,131210082021005.000000000000000,Block 1005, Block Group 1, Census Tract 82.02, Fulton County, Georgia,32,7,25,24,1,23,0,1
-1,131210082032002.000000000000000,Block 2002, Block Group 2, Census Tract 82.03, Fulton County, Georgia,32,1,31,30,0,30,0,1
-1,131210083022007.000000000000000,Block 2007, Block Group 2, Census Tract 83.02, Fulton County, Georgia,32,1,31,31,1,26,2,0
-1,131210084001010.000000000000000,Block 1010, Block Group 1, Census Tract 84, Fulton County, Georgia,32,0,32,30,3,27,0,2
-1,131210084004002.000000000000000,Block 4002, Block Group 4, Census Tract 84, Fulton County, Georgia,32,2,30,26,1,25,0,4
-1,131210085003001.000000000000000,Block 3001, Block Group 3, Census Tract 85, Fulton County, Georgia,32,0,32,29,5,23,1,3
-1,131210085003026.000000000000000,Block 3026, Block Group 3, Census Tract 85, Fulton County, Georgia,32,1,31,29,2,26,1,2
-1,131210088011036.000000000000000,Block 1036, Block Group 1, Census Tract 88.01, Fulton County, Georgia,32,4,28,22,18,4,0,6
-1,131210089052007.000000000000000,Block 2007, Block Group 2, Census Tract 89.05, Fulton County, Georgia,32,8,24,22,16,6,0,2
-1,131210089062008.000000000000000,Block 2008, Block Group 2, Census Tract 89.06, Fulton County, Georgia,32,0,32,30,20,4,0,2
-1,131210095012010.000000000000000,Block 2010, Block Group 2, Census Tract 95.01, Fulton County, Georgia,32,0,32,27,27,0,0,5
-1,131210095041007.000000000000000,Block 1007, Block Group 1, Census Tract 95.04, Fulton County, Georgia,32,4,28,24,14,5,0,4
-1,131210100041004.000000000000000,Block 1004, Block Group 1, Census Tract 100.04, Fulton County, Georgia,32,3,29,28,21,7,0,1
-1,131210101293006.000000000000000,Block 3006, Block Group 3, Census Tract 101.29, Fulton County, Georgia,32,9,23,18,18,0,0,5
-1,131210101343004.000000000000000,Block 3004, Block Group 3, Census Tract 101.34, Fulton County, Georgia,32,9,23,18,11,2,0,5
-1,131210102111004.000000000000000,Block 1004, Block Group 1, Census Tract 102.11, Fulton County, Georgia,32,5,27,24,14,5,0,3
-1,131210102233007.000000000000000,Block 3007, Block Group 3, Census Tract 102.23, Fulton County, Georgia,32,1,31,24,22,1,0,7
-1,131210103051026.000000000000000,Block 1026, Block Group 1, Census Tract 103.05, Fulton County, Georgia,32,1,31,26,0,26,0,5
-1,131210103074004.000000000000000,Block 4004, Block Group 4, Census Tract 103.07, Fulton County, Georgia,32,0,32,31,3,28,0,1
-1,131210103093009.000000000000000,Block 3009, Block Group 3, Census Tract 103.09, Fulton County, Georgia,32,2,30,30,5,25,0,0
-1,131210104011020.000000000000000,Block 1020, Block Group 1, Census Tract 104.01, Fulton County, Georgia,32,1,31,31,28,3,0,0
-1,131210104013020.000000000000000,Block 3020, Block Group 3, Census Tract 104.01, Fulton County, Georgia,32,1,31,27,25,1,0,4
-1,131210104022042.000000000000000,Block 2042, Block Group 2, Census Tract 104.02, Fulton County, Georgia,32,3,29,26,11,13,0,3
-1,131210104023013.000000000000000,Block 3013, Block Group 3, Census Tract 104.02, Fulton County, Georgia,32,0,32,32,20,12,0,0
-1,131210105083016.000000000000000,Block 3016, Block Group 3, Census Tract 105.08, Fulton County, Georgia,32,10,22,21,1,20,0,1
-1,131210105172003.000000000000000,Block 2003, Block Group 2, Census Tract 105.17, Fulton County, Georgia,32,1,31,31,0,28,3,0
-1,131210105183004.000000000000000,Block 3004, Block Group 3, Census Tract 105.18, Fulton County, Georgia,32,0,32,27,0,27,0,5
-1,131210105192014.000000000000000,Block 2014, Block Group 2, Census Tract 105.19, Fulton County, Georgia,32,1,31,30,2,26,2,1
-1,131210105223000.000000000000000,Block 3000, Block Group 3, Census Tract 105.22, Fulton County, Georgia,32,3,29,29,0,28,1,0
-1,131210105271014.000000000000000,Block 1014, Block Group 1, Census Tract 105.27, Fulton County, Georgia,32,7,25,25,0,24,0,0
-1,131210105352015.000000000000000,Block 2015, Block Group 2, Census Tract 105.35, Fulton County, Georgia,32,7,25,19,13,5,1,6
-1,131210105381001.000000000000000,Block 1001, Block Group 1, Census Tract 105.38, Fulton County, Georgia,32,2,30,29,22,7,0,1
-1,131210105401021.000000000000000,Block 1021, Block Group 1, Census Tract 105.40, Fulton County, Georgia,32,7,25,24,0,22,0,1
-1,131210106011015.000000000000000,Block 1015, Block Group 1, Census Tract 106.01, Fulton County, Georgia,32,5,27,26,10,16,0,1
-1,131210108024008.000000000000000,Block 4008, Block Group 4, Census Tract 108.02, Fulton County, Georgia,32,11,21,20,10,8,0,1
-1,131210108024019.000000000000000,Block 4019, Block Group 4, Census Tract 108.02, Fulton County, Georgia,32,15,17,17,10,4,1,0
-1,131210110002012.000000000000000,Block 2012, Block Group 2, Census Tract 110, Fulton County, Georgia,32,11,21,21,0,21,0,0
-1,131210111001014.000000000000000,Block 1014, Block Group 1, Census Tract 111, Fulton County, Georgia,32,12,20,20,4,15,0,0
-1,131210111002000.000000000000000,Block 2000, Block Group 2, Census Tract 111, Fulton County, Georgia,32,4,28,28,6,22,0,0
-1,131210111002002.000000000000000,Block 2002, Block Group 2, Census Tract 111, Fulton County, Georgia,32,1,31,30,22,5,3,1
-1,131210111002028.000000000000000,Block 2028, Block Group 2, Census Tract 111, Fulton County, Georgia,32,2,30,30,17,12,0,0
-1,131210112023030.000000000000000,Block 3030, Block Group 3, Census Tract 112.02, Fulton County, Georgia,32,4,28,28,20,8,0,0
-1,131210112025002.000000000000000,Block 5002, Block Group 5, Census Tract 112.02, Fulton County, Georgia,32,13,19,18,2,15,0,1
-1,131210112026005.000000000000000,Block 6005, Block Group 6, Census Tract 112.02, Fulton County, Georgia,32,4,28,27,6,20,0,1
-1,131210112031017.000000000000000,Block 1017, Block Group 1, Census Tract 112.03, Fulton County, Georgia,32,6,26,25,9,16,0,1
-1,131210113012008.000000000000000,Block 2008, Block Group 2, Census Tract 113.01, Fulton County, Georgia,32,5,27,26,3,20,0,1
-1,131210113093006.000000000000000,Block 3006, Block Group 3, Census Tract 113.09, Fulton County, Georgia,32,3,29,22,0,17,0,7
-1,131210113102012.000000000000000,Block 2012, Block Group 2, Census Tract 113.10, Fulton County, Georgia,32,3,29,27,8,19,0,2
-1,131210114192018.000000000000000,Block 2018, Block Group 2, Census Tract 114.19, Fulton County, Georgia,32,3,29,24,12,0,1,5
-1,131210114194022.000000000000000,Block 4022, Block Group 4, Census Tract 114.19, Fulton County, Georgia,32,2,30,29,28,0,0,1
-1,131210114413003.000000000000000,Block 3003, Block Group 3, Census Tract 114.41, Fulton County, Georgia,32,7,25,23,22,0,0,2
-1,131210115092005.000000000000000,Block 2005, Block Group 2, Census Tract 115.09, Fulton County, Georgia,32,2,30,27,26,0,0,3
-1,131210115101010.000000000000000,Block 1010, Block Group 1, Census Tract 115.10, Fulton County, Georgia,32,8,24,21,15,0,2,3
-1,131210115101012.000000000000000,Block 1012, Block Group 1, Census Tract 115.10, Fulton County, Georgia,32,6,26,22,19,2,0,4
-1,131210115101013.000000000000000,Block 1013, Block Group 1, Census Tract 115.10, Fulton County, Georgia,32,1,31,29,29,0,0,2
-1,131210115102030.000000000000000,Block 2030, Block Group 2, Census Tract 115.10, Fulton County, Georgia,32,6,26,23,19,0,0,3
-1,131210115122007.000000000000000,Block 2007, Block Group 2, Census Tract 115.12, Fulton County, Georgia,32,2,30,23,23,0,0,7
-1,131210115151008.000000000000000,Block 1008, Block Group 1, Census Tract 115.15, Fulton County, Georgia,32,5,27,26,18,7,0,1
-1,131210116281010.000000000000000,Block 1010, Block Group 1, Census Tract 116.28, Fulton County, Georgia,32,3,29,22,15,3,0,7
-1,131210116292001.000000000000000,Block 2001, Block Group 2, Census Tract 116.29, Fulton County, Georgia,32,4,28,23,1,6,0,5
-1,131210116353009.000000000000000,Block 3009, Block Group 3, Census Tract 116.35, Fulton County, Georgia,32,5,27,23,1,10,1,4
-1,131210116372023.000000000000000,Block 2023, Block Group 2, Census Tract 116.37, Fulton County, Georgia,32,1,31,31,30,0,0,0
-1,131210116401013.000000000000000,Block 1013, Block Group 1, Census Tract 116.40, Fulton County, Georgia,32,5,27,27,25,2,0,0
-1,131210116474012.000000000000000,Block 4012, Block Group 4, Census Tract 116.47, Fulton County, Georgia,32,3,29,28,24,1,0,1
-1,131210116581011.000000000000000,Block 1011, Block Group 1, Census Tract 116.58, Fulton County, Georgia,32,4,28,20,0,16,2,8
-1,131210116582009.000000000000000,Block 2009, Block Group 2, Census Tract 116.58, Fulton County, Georgia,32,5,27,24,17,0,1,3
-1,131210123001001.000000000000000,Block 1001, Block Group 1, Census Tract 123, Fulton County, Georgia,32,1,31,31,10,19,2,0
-1,131210123003010.000000000000000,Block 3010, Block Group 3, Census Tract 123, Fulton County, Georgia,32,0,32,29,13,12,1,3
-1,131210123004025.000000000000000,Block 4025, Block Group 4, Census Tract 123, Fulton County, Georgia,32,2,30,28,10,18,0,2
-1,131210001004004.000000000000000,Block 4004, Block Group 4, Census Tract 1, Fulton County, Georgia,31,3,28,26,23,1,0,2
-1,131210029001022.000000000000000,Block 1022, Block Group 1, Census Tract 29, Fulton County, Georgia,31,3,28,28,0,27,0,0
-1,131210032001016.000000000000000,Block 1016, Block Group 1, Census Tract 32, Fulton County, Georgia,31,1,30,25,16,9,0,5
-1,131210038002013.000000000000000,Block 2013, Block Group 2, Census Tract 38, Fulton County, Georgia,31,0,31,29,4,25,0,2
-1,131210039001018.000000000000000,Block 1018, Block Group 1, Census Tract 39, Fulton County, Georgia,31,0,31,31,0,31,0,0
-1,131210041003002.000000000000000,Block 3002, Block Group 3, Census Tract 41, Fulton County, Georgia,31,1,30,29,3,25,1,1
-1,131210052002004.000000000000000,Block 2004, Block Group 2, Census Tract 52, Fulton County, Georgia,31,2,29,21,18,2,0,8
-1,131210053002002.000000000000000,Block 2002, Block Group 2, Census Tract 53, Fulton County, Georgia,31,0,31,30,30,0,0,1
-1,131210053002018.000000000000000,Block 2018, Block Group 2, Census Tract 53, Fulton County, Georgia,31,4,27,26,18,8,0,1
-1,131210055041003.000000000000000,Block 1003, Block Group 1, Census Tract 55.04, Fulton County, Georgia,31,0,31,29,0,29,0,2
-1,131210055041012.000000000000000,Block 1012, Block Group 1, Census Tract 55.04, Fulton County, Georgia,31,2,29,23,3,20,0,6
-1,131210063002013.000000000000000,Block 2013, Block Group 2, Census Tract 63, Fulton County, Georgia,31,1,30,30,2,26,2,0
-1,131210066011011.000000000000000,Block 1011, Block Group 1, Census Tract 66.01, Fulton County, Georgia,31,2,29,25,4,19,0,4
-1,131210069003006.000000000000000,Block 3006, Block Group 3, Census Tract 69, Fulton County, Georgia,31,0,31,31,30,1,0,0
-1,131210069003012.000000000000000,Block 3012, Block Group 3, Census Tract 69, Fulton County, Georgia,31,2,29,27,25,0,0,2
-1,131210070024007.000000000000000,Block 4007, Block Group 4, Census Tract 70.02, Fulton County, Georgia,31,1,30,30,4,24,0,0
-1,131210071001014.000000000000000,Block 1014, Block Group 1, Census Tract 71, Fulton County, Georgia,31,3,28,28,0,28,0,0
-1,131210073011016.000000000000000,Block 1016, Block Group 1, Census Tract 73.01, Fulton County, Georgia,31,3,28,28,0,28,0,0
-1,131210074002016.000000000000000,Block 2016, Block Group 2, Census Tract 74, Fulton County, Georgia,31,3,28,25,3,22,0,3
-1,131210075003015.000000000000000,Block 3015, Block Group 3, Census Tract 75, Fulton County, Georgia,31,3,28,27,5,22,0,1
-1,131210077053009.000000000000000,Block 3009, Block Group 3, Census Tract 77.05, Fulton County, Georgia,31,1,30,30,3,27,0,0
-1,131210082043016.000000000000000,Block 3016, Block Group 3, Census Tract 82.04, Fulton County, Georgia,31,3,28,28,0,28,0,0
-1,131210083011000.000000000000000,Block 1000, Block Group 1, Census Tract 83.01, Fulton County, Georgia,31,0,31,27,0,25,2,4
-1,131210085002007.000000000000000,Block 2007, Block Group 2, Census Tract 85, Fulton County, Georgia,31,0,31,31,5,26,0,0
-1,131210085002022.000000000000000,Block 2022, Block Group 2, Census Tract 85, Fulton County, Georgia,31,2,29,29,5,24,0,0
-1,131210086012008.000000000000000,Block 2008, Block Group 2, Census Tract 86.01, Fulton County, Georgia,31,1,30,30,1,29,0,0
-1,131210086013002.000000000000000,Block 3002, Block Group 3, Census Tract 86.01, Fulton County, Georgia,31,7,24,24,2,20,0,0
-1,131210086013006.000000000000000,Block 3006, Block Group 3, Census Tract 86.01, Fulton County, Georgia,31,6,25,23,1,22,0,2
-1,131210086014008.000000000000000,Block 4008, Block Group 4, Census Tract 86.01, Fulton County, Georgia,31,5,26,25,0,25,0,1
-1,131210089052002.000000000000000,Block 2002, Block Group 2, Census Tract 89.05, Fulton County, Georgia,31,9,22,22,19,2,0,0
-1,131210089054004.000000000000000,Block 4004, Block Group 4, Census Tract 89.05, Fulton County, Georgia,31,3,28,25,14,9,0,3
-1,131210090021020.000000000000000,Block 1020, Block Group 1, Census Tract 90.02, Fulton County, Georgia,31,0,31,29,21,7,0,2
-1,131210093012000.000000000000000,Block 2000, Block Group 2, Census Tract 93.01, Fulton County, Georgia,31,4,27,27,27,0,0,0
-1,131210095011008.000000000000000,Block 1008, Block Group 1, Census Tract 95.01, Fulton County, Georgia,31,2,29,28,28,0,0,1
-1,131210095011010.000000000000000,Block 1010, Block Group 1, Census Tract 95.01, Fulton County, Georgia,31,0,31,30,30,0,0,1
-1,131210095012016.000000000000000,Block 2016, Block Group 2, Census Tract 95.01, Fulton County, Georgia,31,1,30,29,29,0,0,1
-1,131210097003015.000000000000000,Block 3015, Block Group 3, Census Tract 97, Fulton County, Georgia,31,2,29,29,27,0,1,0
-1,131210098021010.000000000000000,Block 1010, Block Group 1, Census Tract 98.02, Fulton County, Georgia,31,4,27,25,25,0,0,2
-1,131210098022000.000000000000000,Block 2000, Block Group 2, Census Tract 98.02, Fulton County, Georgia,31,0,31,30,26,0,4,1
-1,131210099002000.000000000000000,Block 2000, Block Group 2, Census Tract 99, Fulton County, Georgia,31,4,27,24,23,0,1,3
-1,131210100051002.000000000000000,Block 1002, Block Group 1, Census Tract 100.05, Fulton County, Georgia,31,3,28,25,24,0,1,3
-1,131210101302000.000000000000000,Block 2000, Block Group 2, Census Tract 101.30, Fulton County, Georgia,31,4,27,24,7,10,5,3
-1,131210101323003.000000000000000,Block 3003, Block Group 3, Census Tract 101.32, Fulton County, Georgia,31,1,30,30,13,1,0,0
-1,131210102042012.000000000000000,Block 2012, Block Group 2, Census Tract 102.04, Fulton County, Georgia,31,0,31,28,27,0,0,3
-1,131210102114015.000000000000000,Block 4015, Block Group 4, Census Tract 102.11, Fulton County, Georgia,31,3,28,25,25,0,0,3
-1,131210102233006.000000000000000,Block 3006, Block Group 3, Census Tract 102.23, Fulton County, Georgia,31,4,27,21,17,4,0,6
-1,131210103052003.000000000000000,Block 2003, Block Group 2, Census Tract 103.05, Fulton County, Georgia,31,4,27,25,2,23,0,2
-1,131210103081010.000000000000000,Block 1010, Block Group 1, Census Tract 103.08, Fulton County, Georgia,31,1,30,26,0,24,0,4
-1,131210103111012.000000000000000,Block 1012, Block Group 1, Census Tract 103.11, Fulton County, Georgia,31,3,28,21,5,13,0,7
-1,131210103153004.000000000000000,Block 3004, Block Group 3, Census Tract 103.15, Fulton County, Georgia,31,2,29,29,1,27,1,0
-1,131210104013035.000000000000000,Block 3035, Block Group 3, Census Tract 104.01, Fulton County, Georgia,31,2,29,29,23,5,0,0
-1,131210104021023.000000000000000,Block 1023, Block Group 1, Census Tract 104.02, Fulton County, Georgia,31,0,31,28,18,10,0,3
-1,131210104021031.000000000000000,Block 1031, Block Group 1, Census Tract 104.02, Fulton County, Georgia,31,2,29,29,26,2,1,0
-1,131210105083006.000000000000000,Block 3006, Block Group 3, Census Tract 105.08, Fulton County, Georgia,31,1,30,30,0,30,0,0
-1,131210105183002.000000000000000,Block 3002, Block Group 3, Census Tract 105.18, Fulton County, Georgia,31,0,31,30,0,28,2,1
-1,131210105212011.000000000000000,Block 2011, Block Group 2, Census Tract 105.21, Fulton County, Georgia,31,2,29,29,0,29,0,0
-1,131210105241011.000000000000000,Block 1011, Block Group 1, Census Tract 105.24, Fulton County, Georgia,31,8,23,21,18,1,0,2
-1,131210105261030.000000000000000,Block 1030, Block Group 1, Census Tract 105.26, Fulton County, Georgia,31,1,30,27,4,23,0,3
-1,131210105282003.000000000000000,Block 2003, Block Group 2, Census Tract 105.28, Fulton County, Georgia,31,12,19,19,0,18,1,0
-1,131210105391021.000000000000000,Block 1021, Block Group 1, Census Tract 105.39, Fulton County, Georgia,31,0,31,26,4,22,0,5
-1,131210105392008.000000000000000,Block 2008, Block Group 2, Census Tract 105.39, Fulton County, Georgia,31,0,31,28,2,26,0,3
-1,131210106013013.000000000000000,Block 3013, Block Group 3, Census Tract 106.01, Fulton County, Georgia,31,4,27,25,0,25,0,2
-1,131210106014013.000000000000000,Block 4013, Block Group 4, Census Tract 106.01, Fulton County, Georgia,31,3,28,28,8,18,0,0
-1,131210106014015.000000000000000,Block 4015, Block Group 4, Census Tract 106.01, Fulton County, Georgia,31,1,30,29,15,14,0,1
-1,131210106032004.000000000000000,Block 2004, Block Group 2, Census Tract 106.03, Fulton County, Georgia,31,9,22,20,0,20,0,2
-1,131210108023005.000000000000000,Block 3005, Block Group 3, Census Tract 108.02, Fulton County, Georgia,31,20,11,10,4,0,0,1
-1,131210110003004.000000000000000,Block 3004, Block Group 3, Census Tract 110, Fulton County, Georgia,31,7,24,23,3,15,0,1
-1,131210111002029.000000000000000,Block 2029, Block Group 2, Census Tract 111, Fulton County, Georgia,31,3,28,28,13,12,0,0
-1,131210112031021.000000000000000,Block 1021, Block Group 1, Census Tract 112.03, Fulton County, Georgia,31,8,23,22,11,7,2,1
-1,131210113081008.000000000000000,Block 1008, Block Group 1, Census Tract 113.08, Fulton County, Georgia,31,2,29,25,0,25,0,4
-1,131210114292011.000000000000000,Block 2011, Block Group 2, Census Tract 114.29, Fulton County, Georgia,31,6,25,21,10,4,0,4
-1,131210115091013.000000000000000,Block 1013, Block Group 1, Census Tract 115.09, Fulton County, Georgia,31,10,21,18,15,3,0,3
-1,131210115142009.000000000000000,Block 2009, Block Group 2, Census Tract 115.14, Fulton County, Georgia,31,10,21,14,9,2,3,7
-1,131210115151003.000000000000000,Block 1003, Block Group 1, Census Tract 115.15, Fulton County, Georgia,31,4,27,22,22,0,0,5
-1,131210116121007.000000000000000,Block 1007, Block Group 1, Census Tract 116.12, Fulton County, Georgia,31,5,26,26,20,3,0,0
-1,131210116402030.000000000000000,Block 2030, Block Group 2, Census Tract 116.40, Fulton County, Georgia,31,11,20,18,6,2,0,2
-1,131210116412005.000000000000000,Block 2005, Block Group 2, Census Tract 116.41, Fulton County, Georgia,31,4,27,24,20,0,0,3
-1,131210116422003.000000000000000,Block 2003, Block Group 2, Census Tract 116.42, Fulton County, Georgia,31,9,22,22,4,6,7,0
-1,131210118021042.000000000000000,Block 1042, Block Group 1, Census Tract 118.02, Fulton County, Georgia,31,0,31,27,0,26,1,4
-1,131210120002012.000000000000000,Block 2012, Block Group 2, Census Tract 120, Fulton County, Georgia,31,1,30,29,3,25,1,1
-1,131210123001024.000000000000000,Block 1024, Block Group 1, Census Tract 123, Fulton County, Georgia,31,1,30,30,15,9,0,0
-1,131210123004007.000000000000000,Block 4007, Block Group 4, Census Tract 123, Fulton County, Georgia,31,3,28,25,6,19,0,3
-1,131210006011014.000000000000000,Block 1014, Block Group 1, Census Tract 6.01, Fulton County, Georgia,30,9,21,15,10,3,0,6
-1,131210023003011.000000000000000,Block 3011, Block Group 3, Census Tract 23, Fulton County, Georgia,30,1,29,26,0,26,0,3
-1,131210026001001.000000000000000,Block 1001, Block Group 1, Census Tract 26, Fulton County, Georgia,30,1,29,20,0,18,2,9
-1,131210039001007.000000000000000,Block 1007, Block Group 1, Census Tract 39, Fulton County, Georgia,30,0,30,29,0,21,8,1
-1,131210040001001.000000000000000,Block 1001, Block Group 1, Census Tract 40, Fulton County, Georgia,30,0,30,30,8,22,0,0
-1,131210040001023.000000000000000,Block 1023, Block Group 1, Census Tract 40, Fulton County, Georgia,30,5,25,23,2,21,0,2
-1,131210041002006.000000000000000,Block 2006, Block Group 2, Census Tract 41, Fulton County, Georgia,30,2,28,20,5,14,0,8
-1,131210041003006.000000000000000,Block 3006, Block Group 3, Census Tract 41, Fulton County, Georgia,30,7,23,21,4,17,0,2
-1,131210044002018.000000000000000,Block 2018, Block Group 2, Census Tract 44, Fulton County, Georgia,30,0,30,30,3,26,0,0
-1,131210050002023.000000000000000,Block 2023, Block Group 2, Census Tract 50, Fulton County, Georgia,30,2,28,28,21,7,0,0
-1,131210052004012.000000000000000,Block 4012, Block Group 4, Census Tract 52, Fulton County, Georgia,30,1,29,21,13,5,3,8
-1,131210060004006.000000000000000,Block 4006, Block Group 4, Census Tract 60, Fulton County, Georgia,30,5,25,24,3,21,0,1
-1,131210063001017.000000000000000,Block 1017, Block Group 1, Census Tract 63, Fulton County, Georgia,30,3,27,25,0,25,0,2
-1,131210069001007.000000000000000,Block 1007, Block Group 1, Census Tract 69, Fulton County, Georgia,30,4,26,24,15,6,0,2
-1,131210069002003.000000000000000,Block 2003, Block Group 2, Census Tract 69, Fulton County, Georgia,30,8,22,17,16,0,0,5
-1,131210069002007.000000000000000,Block 2007, Block Group 2, Census Tract 69, Fulton County, Georgia,30,15,15,15,1,8,0,0
-1,131210069003008.000000000000000,Block 3008, Block Group 3, Census Tract 69, Fulton County, Georgia,30,7,23,20,20,0,0,3
-1,131210070023001.000000000000000,Block 3001, Block Group 3, Census Tract 70.02, Fulton County, Georgia,30,0,30,30,14,16,0,0
-1,131210071002009.000000000000000,Block 2009, Block Group 2, Census Tract 71, Fulton County, Georgia,30,0,30,30,1,29,0,0
-1,131210073011014.000000000000000,Block 1014, Block Group 1, Census Tract 73.01, Fulton County, Georgia,30,6,24,24,0,24,0,0
-1,131210077092004.000000000000000,Block 2004, Block Group 2, Census Tract 77.09, Fulton County, Georgia,30,3,27,25,2,22,0,2
-1,131210078061006.000000000000000,Block 1006, Block Group 1, Census Tract 78.06, Fulton County, Georgia,30,8,22,21,0,21,0,1
-1,131210078092002.000000000000000,Block 2002, Block Group 2, Census Tract 78.09, Fulton County, Georgia,30,0,30,27,0,27,0,3
-1,131210079003022.000000000000000,Block 3022, Block Group 3, Census Tract 79, Fulton County, Georgia,30,0,30,30,0,28,2,0
-1,131210080002001.000000000000000,Block 2001, Block Group 2, Census Tract 80, Fulton County, Georgia,30,0,30,30,2,24,4,0
-1,131210080005005.000000000000000,Block 5005, Block Group 5, Census Tract 80, Fulton County, Georgia,30,0,30,30,0,30,0,0
-1,131210081031006.000000000000000,Block 1006, Block Group 1, Census Tract 81.03, Fulton County, Georgia,30,5,25,24,2,21,1,1
-1,131210081043004.000000000000000,Block 3004, Block Group 3, Census Tract 81.04, Fulton County, Georgia,30,0,30,28,1,27,0,2
-1,131210082042015.000000000000000,Block 2015, Block Group 2, Census Tract 82.04, Fulton County, Georgia,30,1,29,27,0,26,0,2
-1,131210085002012.000000000000000,Block 2012, Block Group 2, Census Tract 85, Fulton County, Georgia,30,4,26,26,0,26,0,0
-1,131210085002027.000000000000000,Block 2027, Block Group 2, Census Tract 85, Fulton County, Georgia,30,3,27,22,10,12,0,5
-1,131210087013008.000000000000000,Block 3008, Block Group 3, Census Tract 87.01, Fulton County, Georgia,30,10,20,14,0,10,0,6
-1,131210087022008.000000000000000,Block 2008, Block Group 2, Census Tract 87.02, Fulton County, Georgia,30,3,27,25,4,16,2,2
-1,131210088021023.000000000000000,Block 1023, Block Group 1, Census Tract 88.02, Fulton County, Georgia,30,4,26,25,17,8,0,1
-1,131210089071005.000000000000000,Block 1005, Block Group 1, Census Tract 89.07, Fulton County, Georgia,30,3,27,24,24,0,0,3
-1,131210089091004.000000000000000,Block 1004, Block Group 1, Census Tract 89.09, Fulton County, Georgia,30,3,27,21,17,1,3,6
-1,131210093021007.000000000000000,Block 1007, Block Group 1, Census Tract 93.02, Fulton County, Georgia,30,2,28,21,18,0,1,7
-1,131210094111006.000000000000000,Block 1006, Block Group 1, Census Tract 94.11, Fulton County, Georgia,30,2,28,17,17,0,0,11
-1,131210094112007.000000000000000,Block 2007, Block Group 2, Census Tract 94.11, Fulton County, Georgia,30,6,24,17,11,0,0,7
-1,131210096041001.000000000000000,Block 1001, Block Group 1, Census Tract 96.04, Fulton County, Georgia,30,4,26,24,16,3,0,2
-1,131210097001010.000000000000000,Block 1010, Block Group 1, Census Tract 97, Fulton County, Georgia,30,0,30,22,13,0,0,8
-1,131210098021020.000000000000000,Block 1020, Block Group 1, Census Tract 98.02, Fulton County, Georgia,30,0,30,24,21,0,0,6
-1,131210101071001.000000000000000,Block 1001, Block Group 1, Census Tract 101.07, Fulton County, Georgia,30,1,29,28,28,0,0,1
-1,131210101321011.000000000000000,Block 1011, Block Group 1, Census Tract 101.32, Fulton County, Georgia,30,5,25,21,15,4,0,4
-1,131210101362002.000000000000000,Block 2002, Block Group 2, Census Tract 101.36, Fulton County, Georgia,30,6,24,23,21,0,0,1
-1,131210103101005.000000000000000,Block 1005, Block Group 1, Census Tract 103.10, Fulton County, Georgia,30,1,29,26,0,21,5,3
-1,131210103103007.000000000000000,Block 3007, Block Group 3, Census Tract 103.10, Fulton County, Georgia,30,1,29,28,0,28,0,1
-1,131210103131010.000000000000000,Block 1010, Block Group 1, Census Tract 103.13, Fulton County, Georgia,30,2,28,20,0,20,0,8
-1,131210103152006.000000000000000,Block 2006, Block Group 2, Census Tract 103.15, Fulton County, Georgia,30,0,30,30,2,24,0,0
-1,131210104012004.000000000000000,Block 2004, Block Group 2, Census Tract 104.01, Fulton County, Georgia,30,2,28,26,0,26,0,2
-1,131210104013007.000000000000000,Block 3007, Block Group 3, Census Tract 104.01, Fulton County, Georgia,30,2,28,28,19,9,0,0
-1,131210104013011.000000000000000,Block 3011, Block Group 3, Census Tract 104.01, Fulton County, Georgia,30,5,25,23,3,20,0,2
-1,131210104013049.000000000000000,Block 3049, Block Group 3, Census Tract 104.01, Fulton County, Georgia,30,2,28,24,19,5,0,4
-1,131210104021000.000000000000000,Block 1000, Block Group 1, Census Tract 104.02, Fulton County, Georgia,30,0,30,30,30,0,0,0
-1,131210104021038.000000000000000,Block 1038, Block Group 1, Census Tract 104.02, Fulton County, Georgia,30,5,25,25,5,20,0,0
-1,131210104022010.000000000000000,Block 2010, Block Group 2, Census Tract 104.02, Fulton County, Georgia,30,5,25,23,22,1,0,2
-1,131210104023022.000000000000000,Block 3022, Block Group 3, Census Tract 104.02, Fulton County, Georgia,30,0,30,30,30,0,0,0
-1,131210105221001.000000000000000,Block 1001, Block Group 1, Census Tract 105.22, Fulton County, Georgia,30,5,25,24,2,22,0,1
-1,131210105293020.000000000000000,Block 3020, Block Group 3, Census Tract 105.29, Fulton County, Georgia,30,3,27,26,0,26,0,1
-1,131210105323007.000000000000000,Block 3007, Block Group 3, Census Tract 105.32, Fulton County, Georgia,30,8,22,22,0,22,0,0
-1,131210105341007.000000000000000,Block 1007, Block Group 1, Census Tract 105.34, Fulton County, Georgia,30,1,29,28,4,23,0,1
-1,131210105362017.000000000000000,Block 2017, Block Group 2, Census Tract 105.36, Fulton County, Georgia,30,1,29,27,3,22,0,2
-1,131210105402016.000000000000000,Block 2016, Block Group 2, Census Tract 105.40, Fulton County, Georgia,30,5,25,19,15,3,0,6
-1,131210106013012.000000000000000,Block 3012, Block Group 3, Census Tract 106.01, Fulton County, Georgia,30,5,25,25,3,22,0,0
-1,131210108023017.000000000000000,Block 3017, Block Group 3, Census Tract 108.02, Fulton County, Georgia,30,9,21,21,19,2,0,0
-1,131210110003010.000000000000000,Block 3010, Block Group 3, Census Tract 110, Fulton County, Georgia,30,6,24,24,1,21,0,0
-1,131210112021003.000000000000000,Block 1003, Block Group 1, Census Tract 112.02, Fulton County, Georgia,30,5,25,22,7,14,0,3
-1,131210112022011.000000000000000,Block 2011, Block Group 2, Census Tract 112.02, Fulton County, Georgia,30,12,18,18,4,14,0,0
-1,131210112023025.000000000000000,Block 3025, Block Group 3, Census Tract 112.02, Fulton County, Georgia,30,10,20,20,10,10,0,0
-1,131210112024011.000000000000000,Block 4011, Block Group 4, Census Tract 112.02, Fulton County, Georgia,30,7,23,23,3,20,0,0
-1,131210112041010.000000000000000,Block 1010, Block Group 1, Census Tract 112.04, Fulton County, Georgia,30,4,26,24,1,23,0,2
-1,131210113014012.000000000000000,Block 4012, Block Group 4, Census Tract 113.01, Fulton County, Georgia,30,0,30,30,6,24,0,0
-1,131210113016002.000000000000000,Block 6002, Block Group 6, Census Tract 113.01, Fulton County, Georgia,30,6,24,23,0,23,0,1
-1,131210113093003.000000000000000,Block 3003, Block Group 3, Census Tract 113.09, Fulton County, Georgia,30,5,25,25,0,25,0,0
-1,131210113105007.000000000000000,Block 5007, Block Group 5, Census Tract 113.10, Fulton County, Georgia,30,16,14,14,0,14,0,0
-1,131210114192002.000000000000000,Block 2002, Block Group 2, Census Tract 114.19, Fulton County, Georgia,30,3,27,26,22,4,0,1
-1,131210114232009.000000000000000,Block 2009, Block Group 2, Census Tract 114.23, Fulton County, Georgia,30,6,24,16,15,0,1,8
-1,131210114261001.000000000000000,Block 1001, Block Group 1, Census Tract 114.26, Fulton County, Georgia,30,1,29,24,19,0,5,5
-1,131210114262001.000000000000000,Block 2001, Block Group 2, Census Tract 114.26, Fulton County, Georgia,30,10,20,19,16,0,0,1
-1,131210115091010.000000000000000,Block 1010, Block Group 1, Census Tract 115.09, Fulton County, Georgia,30,7,23,19,15,4,0,4
-1,131210115121009.000000000000000,Block 1009, Block Group 1, Census Tract 115.12, Fulton County, Georgia,30,7,23,20,17,2,0,3
-1,131210115142017.000000000000000,Block 2017, Block Group 2, Census Tract 115.14, Fulton County, Georgia,30,0,30,28,28,0,0,2
-1,131210116121008.000000000000000,Block 1008, Block Group 1, Census Tract 116.12, Fulton County, Georgia,30,5,25,19,8,11,0,6
-1,131210116512019.000000000000000,Block 2019, Block Group 2, Census Tract 116.51, Fulton County, Georgia,30,3,27,24,3,8,0,3
-1,131210116602019.000000000000000,Block 2019, Block Group 2, Census Tract 116.60, Fulton County, Georgia,30,4,26,24,10,1,0,2
-1,131210119013017.000000000000000,Block 3017, Block Group 3, Census Tract 119.01, Fulton County, Georgia,30,1,29,25,0,25,0,4
-1,131210119022011.000000000000000,Block 2011, Block Group 2, Census Tract 119.02, Fulton County, Georgia,30,3,27,24,8,16,0,3
-1,131210120001017.000000000000000,Block 1017, Block Group 1, Census Tract 120, Fulton County, Georgia,30,0,30,28,9,19,0,2
-1,131210123004028.000000000000000,Block 4028, Block Group 4, Census Tract 123, Fulton County, Georgia,30,9,21,18,5,13,0,3
-1,131210001002007.000000000000000,Block 2007, Block Group 2, Census Tract 1, Fulton County, Georgia,29,1,28,27,22,1,1,1
-1,131210001004002.000000000000000,Block 4002, Block Group 4, Census Tract 1, Fulton County, Georgia,29,3,26,25,23,1,0,1
-1,131210002012005.000000000000000,Block 2005, Block Group 2, Census Tract 2.01, Fulton County, Georgia,29,2,27,24,12,5,0,3
-1,131210005011010.000000000000000,Block 1010, Block Group 1, Census Tract 5.01, Fulton County, Georgia,29,8,21,13,0,5,3,8
-1,131210005011013.000000000000000,Block 1013, Block Group 1, Census Tract 5.01, Fulton County, Georgia,29,3,26,26,18,0,0,0
-1,131210005012004.000000000000000,Block 2004, Block Group 2, Census Tract 5.01, Fulton County, Georgia,29,3,26,25,8,16,0,1
-1,131210007001026.000000000000000,Block 1026, Block Group 1, Census Tract 7, Fulton County, Georgia,29,0,29,29,15,14,0,0
-1,131210010021017.000000000000000,Block 1017, Block Group 1, Census Tract 10.02, Fulton County, Georgia,29,1,28,22,15,5,0,6
-1,131210012062002.000000000000000,Block 2002, Block Group 2, Census Tract 12.06, Fulton County, Georgia,29,15,14,9,0,0,0,5
-1,131210018011007.000000000000000,Block 1007, Block Group 1, Census Tract 18.01, Fulton County, Georgia,29,4,25,16,2,10,3,9
-1,131210025001014.000000000000000,Block 1014, Block Group 1, Census Tract 25, Fulton County, Georgia,29,5,24,24,0,24,0,0
-1,131210025002008.000000000000000,Block 2008, Block Group 2, Census Tract 25, Fulton County, Georgia,29,7,22,20,0,19,1,2
-1,131210025003001.000000000000000,Block 3001, Block Group 3, Census Tract 25, Fulton County, Georgia,29,0,29,29,0,29,0,0
-1,131210026002017.000000000000000,Block 2017, Block Group 2, Census Tract 26, Fulton County, Georgia,29,2,27,25,2,21,0,2
-1,131210030001009.000000000000000,Block 1009, Block Group 1, Census Tract 30, Fulton County, Georgia,29,1,28,27,20,7,0,1
-1,131210030001030.000000000000000,Block 1030, Block Group 1, Census Tract 30, Fulton County, Georgia,29,8,21,21,17,0,0,0
-1,131210031001005.000000000000000,Block 1005, Block Group 1, Census Tract 31, Fulton County, Georgia,29,7,22,16,12,4,0,6
-1,131210031001020.000000000000000,Block 1020, Block Group 1, Census Tract 31, Fulton County, Georgia,29,0,29,29,26,3,0,0
-1,131210031002011.000000000000000,Block 2011, Block Group 2, Census Tract 31, Fulton County, Georgia,29,1,28,22,13,5,0,6
-1,131210037001002.000000000000000,Block 1002, Block Group 1, Census Tract 37, Fulton County, Georgia,29,0,29,20,0,20,0,9
-1,131210043003008.000000000000000,Block 3008, Block Group 3, Census Tract 43, Fulton County, Georgia,29,6,23,21,0,21,0,2
-1,131210049002024.000000000000000,Block 2024, Block Group 2, Census Tract 49, Fulton County, Georgia,29,1,28,27,21,6,0,1
-1,131210052001008.000000000000000,Block 1008, Block Group 1, Census Tract 52, Fulton County, Georgia,29,2,27,25,24,1,0,2
-1,131210052004002.000000000000000,Block 4002, Block Group 4, Census Tract 52, Fulton County, Georgia,29,4,25,24,16,8,0,1
-1,131210055012001.000000000000000,Block 2001, Block Group 2, Census Tract 55.01, Fulton County, Georgia,29,3,26,24,12,11,0,2
-1,131210055012021.000000000000000,Block 2021, Block Group 2, Census Tract 55.01, Fulton County, Georgia,29,1,28,28,3,24,0,0
-1,131210061003017.000000000000000,Block 3017, Block Group 3, Census Tract 61, Fulton County, Georgia,29,2,27,19,0,19,0,8
-1,131210062002005.000000000000000,Block 2005, Block Group 2, Census Tract 62, Fulton County, Georgia,29,2,27,27,1,26,0,0
-1,131210063001009.000000000000000,Block 1009, Block Group 1, Census Tract 63, Fulton County, Georgia,29,1,28,28,0,28,0,0
-1,131210063001015.000000000000000,Block 1015, Block Group 1, Census Tract 63, Fulton County, Georgia,29,0,29,28,8,20,0,1
-1,131210063001018.000000000000000,Block 1018, Block Group 1, Census Tract 63, Fulton County, Georgia,29,0,29,27,0,27,0,2
-1,131210063001031.000000000000000,Block 1031, Block Group 1, Census Tract 63, Fulton County, Georgia,29,0,29,29,1,25,3,0
-1,131210068021002.000000000000000,Block 1002, Block Group 1, Census Tract 68.02, Fulton County, Georgia,29,3,26,21,1,19,0,5
-1,131210072001003.000000000000000,Block 1003, Block Group 1, Census Tract 72, Fulton County, Georgia,29,1,28,28,3,25,0,0
-1,131210075001002.000000000000000,Block 1002, Block Group 1, Census Tract 75, Fulton County, Georgia,29,6,23,23,0,22,0,0
-1,131210077071007.000000000000000,Block 1007, Block Group 1, Census Tract 77.07, Fulton County, Georgia,29,2,27,27,1,24,0,0
-1,131210078051034.000000000000000,Block 1034, Block Group 1, Census Tract 78.05, Fulton County, Georgia,29,3,26,23,2,20,0,3
-1,131210078062010.000000000000000,Block 2010, Block Group 2, Census Tract 78.06, Fulton County, Georgia,29,0,29,25,0,25,0,4
-1,131210080004012.000000000000000,Block 4012, Block Group 4, Census Tract 80, Fulton County, Georgia,29,0,29,27,0,27,0,2
-1,131210081031007.000000000000000,Block 1007, Block Group 1, Census Tract 81.03, Fulton County, Georgia,29,1,28,19,0,16,3,9
-1,131210082032006.000000000000000,Block 2006, Block Group 2, Census Tract 82.03, Fulton County, Georgia,29,0,29,26,0,26,0,3
-1,131210088011004.000000000000000,Block 1004, Block Group 1, Census Tract 88.01, Fulton County, Georgia,29,4,25,22,17,5,0,3
-1,131210088011035.000000000000000,Block 1035, Block Group 1, Census Tract 88.01, Fulton County, Georgia,29,4,25,22,20,2,0,3
-1,131210088021045.000000000000000,Block 1045, Block Group 1, Census Tract 88.02, Fulton County, Georgia,29,4,25,24,20,4,0,1
-1,131210089051002.000000000000000,Block 1002, Block Group 1, Census Tract 89.05, Fulton County, Georgia,29,4,25,19,18,1,0,6
-1,131210090021007.000000000000000,Block 1007, Block Group 1, Census Tract 90.02, Fulton County, Georgia,29,4,25,23,23,0,0,2
-1,131210091051006.000000000000000,Block 1006, Block Group 1, Census Tract 91.05, Fulton County, Georgia,29,3,26,25,24,0,1,1
-1,131210097002019.000000000000000,Block 2019, Block Group 2, Census Tract 97, Fulton County, Georgia,29,0,29,28,24,0,0,1
-1,131210097003007.000000000000000,Block 3007, Block Group 3, Census Tract 97, Fulton County, Georgia,29,0,29,24,19,2,1,5
-1,131210098041004.000000000000000,Block 1004, Block Group 1, Census Tract 98.04, Fulton County, Georgia,29,2,27,27,26,1,0,0
-1,131210101152016.000000000000000,Block 2016, Block Group 2, Census Tract 101.15, Fulton County, Georgia,29,9,20,19,13,4,0,1
-1,131210102162001.000000000000000,Block 2001, Block Group 2, Census Tract 102.16, Fulton County, Georgia,29,3,26,23,18,2,0,3
-1,131210103083002.000000000000000,Block 3002, Block Group 3, Census Tract 103.08, Fulton County, Georgia,29,2,27,25,0,25,0,2
-1,131210104023032.000000000000000,Block 3032, Block Group 3, Census Tract 104.02, Fulton County, Georgia,29,1,28,27,26,1,0,1
-1,131210104023033.000000000000000,Block 3033, Block Group 3, Census Tract 104.02, Fulton County, Georgia,29,1,28,28,22,6,0,0
-1,131210105081009.000000000000000,Block 1009, Block Group 1, Census Tract 105.08, Fulton County, Georgia,29,5,24,24,0,22,2,0
-1,131210105191038.000000000000000,Block 1038, Block Group 1, Census Tract 105.19, Fulton County, Georgia,29,7,22,22,4,17,0,0
-1,131210105221009.000000000000000,Block 1009, Block Group 1, Census Tract 105.22, Fulton County, Georgia,29,5,24,21,0,20,1,3
-1,131210105273008.000000000000000,Block 3008, Block Group 3, Census Tract 105.27, Fulton County, Georgia,29,4,25,22,0,20,0,3
-1,131210105332007.000000000000000,Block 2007, Block Group 2, Census Tract 105.33, Fulton County, Georgia,29,2,27,24,3,18,1,3
-1,131210105381003.000000000000000,Block 1003, Block Group 1, Census Tract 105.38, Fulton County, Georgia,29,0,29,29,13,16,0,0
-1,131210105382022.000000000000000,Block 2022, Block Group 2, Census Tract 105.38, Fulton County, Georgia,29,2,27,22,2,20,0,5
-1,131210105401023.000000000000000,Block 1023, Block Group 1, Census Tract 105.40, Fulton County, Georgia,29,4,25,19,0,19,0,6
-1,131210106012003.000000000000000,Block 2003, Block Group 2, Census Tract 106.01, Fulton County, Georgia,29,3,26,21,0,20,0,5
-1,131210106013002.000000000000000,Block 3002, Block Group 3, Census Tract 106.01, Fulton County, Georgia,29,4,25,25,7,15,2,0
-1,131210106013006.000000000000000,Block 3006, Block Group 3, Census Tract 106.01, Fulton County, Georgia,29,4,25,25,20,5,0,0
-1,131210106013008.000000000000000,Block 3008, Block Group 3, Census Tract 106.01, Fulton County, Georgia,29,6,23,20,13,7,0,3
-1,131210106014005.000000000000000,Block 4005, Block Group 4, Census Tract 106.01, Fulton County, Georgia,29,4,25,21,9,12,0,4
-1,131210106014007.000000000000000,Block 4007, Block Group 4, Census Tract 106.01, Fulton County, Georgia,29,0,29,28,15,13,0,1
-1,131210106014014.000000000000000,Block 4014, Block Group 4, Census Tract 106.01, Fulton County, Georgia,29,1,28,26,15,10,0,2
-1,131210108024017.000000000000000,Block 4017, Block Group 4, Census Tract 108.02, Fulton County, Georgia,29,7,22,19,11,8,0,3
-1,131210110001013.000000000000000,Block 1013, Block Group 1, Census Tract 110, Fulton County, Georgia,29,16,13,11,0,11,0,2
-1,131210111001001.000000000000000,Block 1001, Block Group 1, Census Tract 111, Fulton County, Georgia,29,4,25,24,0,24,0,1
-1,131210111002025.000000000000000,Block 2025, Block Group 2, Census Tract 111, Fulton County, Georgia,29,3,26,25,1,24,0,1
-1,131210111003015.000000000000000,Block 3015, Block Group 3, Census Tract 111, Fulton County, Georgia,29,14,15,14,3,11,0,1
-1,131210112022001.000000000000000,Block 2001, Block Group 2, Census Tract 112.02, Fulton County, Georgia,29,2,27,25,5,16,0,2
-1,131210112026007.000000000000000,Block 6007, Block Group 6, Census Tract 112.02, Fulton County, Georgia,29,7,22,20,14,6,0,2
-1,131210112031011.000000000000000,Block 1011, Block Group 1, Census Tract 112.03, Fulton County, Georgia,29,4,25,19,7,12,0,6
-1,131210114191005.000000000000000,Block 1005, Block Group 1, Census Tract 114.19, Fulton County, Georgia,29,0,29,29,25,2,2,0
-1,131210114282004.000000000000000,Block 2004, Block Group 2, Census Tract 114.28, Fulton County, Georgia,29,7,22,18,13,0,1,4
-1,131210114291001.000000000000000,Block 1001, Block Group 1, Census Tract 114.29, Fulton County, Georgia,29,4,25,18,1,2,3,7
-1,131210114422013.000000000000000,Block 2013, Block Group 2, Census Tract 114.42, Fulton County, Georgia,29,4,25,22,10,10,0,3
-1,131210114451001.000000000000000,Block 1001, Block Group 1, Census Tract 114.45, Fulton County, Georgia,29,3,26,22,22,0,0,4
-1,131210114451003.000000000000000,Block 1003, Block Group 1, Census Tract 114.45, Fulton County, Georgia,29,0,29,29,27,0,0,0
-1,131210115071005.000000000000000,Block 1005, Block Group 1, Census Tract 115.07, Fulton County, Georgia,29,3,26,25,19,4,2,1
-1,131210115081009.000000000000000,Block 1009, Block Group 1, Census Tract 115.08, Fulton County, Georgia,29,3,26,25,23,2,0,1
-1,131210115112004.000000000000000,Block 2004, Block Group 2, Census Tract 115.11, Fulton County, Georgia,29,8,21,20,17,0,0,1
-1,131210115121012.000000000000000,Block 1012, Block Group 1, Census Tract 115.12, Fulton County, Georgia,29,1,28,28,27,0,0,0
-1,131210116321004.000000000000000,Block 1004, Block Group 1, Census Tract 116.32, Fulton County, Georgia,29,6,23,21,7,2,0,2
-1,131210116361013.000000000000000,Block 1013, Block Group 1, Census Tract 116.36, Fulton County, Georgia,29,8,21,13,4,2,5,8
-1,131210116402039.000000000000000,Block 2039, Block Group 2, Census Tract 116.40, Fulton County, Georgia,29,1,28,26,22,2,1,2
-1,131210116421005.000000000000000,Block 1005, Block Group 1, Census Tract 116.42, Fulton County, Georgia,29,8,21,19,10,9,0,2
-1,131210116474007.000000000000000,Block 4007, Block Group 4, Census Tract 116.47, Fulton County, Georgia,29,8,21,14,12,0,0,7
-1,131210116541003.000000000000000,Block 1003, Block Group 1, Census Tract 116.54, Fulton County, Georgia,29,8,21,19,3,4,1,2
-1,131210116602026.000000000000000,Block 2026, Block Group 2, Census Tract 116.60, Fulton County, Georgia,29,5,24,18,12,0,0,6
-1,131210118022011.000000000000000,Block 2011, Block Group 2, Census Tract 118.02, Fulton County, Georgia,29,0,29,28,2,25,1,1
-1,131210120002017.000000000000000,Block 2017, Block Group 2, Census Tract 120, Fulton County, Georgia,29,2,27,26,4,22,0,1
-1,131210123003008.000000000000000,Block 3008, Block Group 3, Census Tract 123, Fulton County, Georgia,29,0,29,29,4,25,0,0
-1,131210123003023.000000000000000,Block 3023, Block Group 3, Census Tract 123, Fulton County, Georgia,29,1,28,24,1,23,0,4
-1,131210005011012.000000000000000,Block 1012, Block Group 1, Census Tract 5.01, Fulton County, Georgia,28,3,25,23,12,6,0,2
-1,131210006013010.000000000000000,Block 3010, Block Group 3, Census Tract 6.01, Fulton County, Georgia,28,1,27,27,23,3,0,0
-1,131210018011005.000000000000000,Block 1005, Block Group 1, Census Tract 18.01, Fulton County, Georgia,28,1,27,25,8,14,0,2
-1,131210023003000.000000000000000,Block 3000, Block Group 3, Census Tract 23, Fulton County, Georgia,28,0,28,28,5,23,0,0
-1,131210025002001.000000000000000,Block 2001, Block Group 2, Census Tract 25, Fulton County, Georgia,28,0,28,27,4,23,0,1
-1,131210025002012.000000000000000,Block 2012, Block Group 2, Census Tract 25, Fulton County, Georgia,28,1,27,25,0,23,0,2
-1,131210028021003.000000000000000,Block 1003, Block Group 1, Census Tract 28.02, Fulton County, Georgia,28,1,27,23,12,3,5,4
-1,131210029001000.000000000000000,Block 1000, Block Group 1, Census Tract 29, Fulton County, Georgia,28,3,25,21,16,5,0,4
-1,131210031001008.000000000000000,Block 1008, Block Group 1, Census Tract 31, Fulton County, Georgia,28,0,28,28,21,7,0,0
-1,131210032001012.000000000000000,Block 1012, Block Group 1, Census Tract 32, Fulton County, Georgia,28,4,24,23,14,6,3,1
-1,131210032002006.000000000000000,Block 2006, Block Group 2, Census Tract 32, Fulton County, Georgia,28,2,26,20,17,0,0,6
-1,131210032002010.000000000000000,Block 2010, Block Group 2, Census Tract 32, Fulton County, Georgia,28,5,23,19,16,0,0,4
-1,131210040001019.000000000000000,Block 1019, Block Group 1, Census Tract 40, Fulton County, Georgia,28,0,28,24,8,16,0,4
-1,131210041003008.000000000000000,Block 3008, Block Group 3, Census Tract 41, Fulton County, Georgia,28,3,25,24,0,24,0,1
-1,131210049002004.000000000000000,Block 2004, Block Group 2, Census Tract 49, Fulton County, Georgia,28,1,27,18,16,2,0,9
-1,131210052002010.000000000000000,Block 2010, Block Group 2, Census Tract 52, Fulton County, Georgia,28,0,28,27,24,3,0,1
-1,131210052003002.000000000000000,Block 3002, Block Group 3, Census Tract 52, Fulton County, Georgia,28,8,20,16,13,3,0,4
-1,131210053002021.000000000000000,Block 2021, Block Group 2, Census Tract 53, Fulton County, Georgia,28,3,25,21,17,4,0,4
-1,131210057001004.000000000000000,Block 1004, Block Group 1, Census Tract 57, Fulton County, Georgia,28,8,20,20,0,20,0,0
-1,131210057001006.000000000000000,Block 1006, Block Group 1, Census Tract 57, Fulton County, Georgia,28,1,27,27,5,17,0,0
-1,131210058001033.000000000000000,Block 1033, Block Group 1, Census Tract 58, Fulton County, Georgia,28,1,27,25,11,10,0,2
-1,131210062001012.000000000000000,Block 1012, Block Group 1, Census Tract 62, Fulton County, Georgia,28,0,28,28,1,24,0,0
-1,131210063002001.000000000000000,Block 2001, Block Group 2, Census Tract 63, Fulton County, Georgia,28,0,28,28,6,22,0,0
-1,131210063002010.000000000000000,Block 2010, Block Group 2, Census Tract 63, Fulton County, Georgia,28,1,27,27,3,24,0,0
-1,131210066012003.000000000000000,Block 2003, Block Group 2, Census Tract 66.01, Fulton County, Georgia,28,3,25,22,8,12,2,3
-1,131210066021009.000000000000000,Block 1009, Block Group 1, Census Tract 66.02, Fulton County, Georgia,28,5,23,21,0,21,0,2
-1,131210066021015.000000000000000,Block 1015, Block Group 1, Census Tract 66.02, Fulton County, Georgia,28,3,25,21,0,21,0,4
-1,131210069003027.000000000000000,Block 3027, Block Group 3, Census Tract 69, Fulton County, Georgia,28,0,28,26,19,0,1,2
-1,131210070023002.000000000000000,Block 3002, Block Group 3, Census Tract 70.02, Fulton County, Georgia,28,0,28,23,0,23,0,5
-1,131210071002014.000000000000000,Block 2014, Block Group 2, Census Tract 71, Fulton County, Georgia,28,2,26,26,0,24,2,0
-1,131210073011013.000000000000000,Block 1013, Block Group 1, Census Tract 73.01, Fulton County, Georgia,28,5,23,23,2,21,0,0
-1,131210077033011.000000000000000,Block 3011, Block Group 3, Census Tract 77.03, Fulton County, Georgia,28,0,28,21,0,21,0,7
-1,131210077033013.000000000000000,Block 3013, Block Group 3, Census Tract 77.03, Fulton County, Georgia,28,4,24,21,0,21,0,3
-1,131210079004009.000000000000000,Block 4009, Block Group 4, Census Tract 79, Fulton County, Georgia,28,0,28,28,0,28,0,0
-1,131210083013001.000000000000000,Block 3001, Block Group 3, Census Tract 83.01, Fulton County, Georgia,28,1,27,24,0,24,0,3
-1,131210083021003.000000000000000,Block 1003, Block Group 1, Census Tract 83.02, Fulton County, Georgia,28,1,27,27,1,26,0,0
-1,131210086011001.000000000000000,Block 1001, Block Group 1, Census Tract 86.01, Fulton County, Georgia,28,2,26,25,0,25,0,1
-1,131210087011001.000000000000000,Block 1001, Block Group 1, Census Tract 87.01, Fulton County, Georgia,28,4,24,22,8,12,0,2
-1,131210088022015.000000000000000,Block 2015, Block Group 2, Census Tract 88.02, Fulton County, Georgia,28,0,28,26,21,4,0,2
-1,131210089071003.000000000000000,Block 1003, Block Group 1, Census Tract 89.07, Fulton County, Georgia,28,5,23,21,11,5,0,2
-1,131210091032002.000000000000000,Block 2002, Block Group 2, Census Tract 91.03, Fulton County, Georgia,28,4,24,20,12,8,0,4
-1,131210100071013.000000000000000,Block 1013, Block Group 1, Census Tract 100.07, Fulton County, Georgia,28,2,26,23,22,0,0,3
-1,131210101071009.000000000000000,Block 1009, Block Group 1, Census Tract 101.07, Fulton County, Georgia,28,3,25,24,21,1,0,1
-1,131210101311008.000000000000000,Block 1008, Block Group 1, Census Tract 101.31, Fulton County, Georgia,28,3,25,22,21,0,1,3
-1,131210101361009.000000000000000,Block 1009, Block Group 1, Census Tract 101.36, Fulton County, Georgia,28,14,14,9,5,0,1,5
-1,131210102121002.000000000000000,Block 1002, Block Group 1, Census Tract 102.12, Fulton County, Georgia,28,7,21,17,9,4,4,4
-1,131210102203004.000000000000000,Block 3004, Block Group 3, Census Tract 102.20, Fulton County, Georgia,28,4,24,22,16,0,0,2
-1,131210103062002.000000000000000,Block 2002, Block Group 2, Census Tract 103.06, Fulton County, Georgia,28,6,22,20,2,15,3,2
-1,131210103072022.000000000000000,Block 2022, Block Group 2, Census Tract 103.07, Fulton County, Georgia,28,3,25,18,0,16,0,7
-1,131210103091034.000000000000000,Block 1034, Block Group 1, Census Tract 103.09, Fulton County, Georgia,28,2,26,24,0,23,0,2
-1,131210103103006.000000000000000,Block 3006, Block Group 3, Census Tract 103.10, Fulton County, Georgia,28,0,28,28,1,27,0,0
-1,131210104013030.000000000000000,Block 3030, Block Group 3, Census Tract 104.01, Fulton County, Georgia,28,10,18,18,9,9,0,0
-1,131210104023052.000000000000000,Block 3052, Block Group 3, Census Tract 104.02, Fulton County, Georgia,28,1,27,27,17,8,2,0
-1,131210105211007.000000000000000,Block 1007, Block Group 1, Census Tract 105.21, Fulton County, Georgia,28,0,28,26,0,26,0,2
-1,131210105261006.000000000000000,Block 1006, Block Group 1, Census Tract 105.26, Fulton County, Georgia,28,2,26,25,1,24,0,1
-1,131210105264005.000000000000000,Block 4005, Block Group 4, Census Tract 105.26, Fulton County, Georgia,28,6,22,21,10,10,1,1
-1,131210105273010.000000000000000,Block 3010, Block Group 3, Census Tract 105.27, Fulton County, Georgia,28,13,15,14,3,10,1,1
-1,131210105322001.000000000000000,Block 2001, Block Group 2, Census Tract 105.32, Fulton County, Georgia,28,2,26,23,5,14,0,3
-1,131210105323012.000000000000000,Block 3012, Block Group 3, Census Tract 105.32, Fulton County, Georgia,28,7,21,19,0,19,0,2
-1,131210105391000.000000000000000,Block 1000, Block Group 1, Census Tract 105.39, Fulton County, Georgia,28,0,28,24,11,13,0,4
-1,131210105391030.000000000000000,Block 1030, Block Group 1, Census Tract 105.39, Fulton County, Georgia,28,0,28,28,0,26,0,0
-1,131210106013007.000000000000000,Block 3007, Block Group 3, Census Tract 106.01, Fulton County, Georgia,28,0,28,28,15,12,0,0
-1,131210108013032.000000000000000,Block 3032, Block Group 3, Census Tract 108.01, Fulton County, Georgia,28,1,27,24,18,6,0,3
-1,131210110002013.000000000000000,Block 2013, Block Group 2, Census Tract 110, Fulton County, Georgia,28,8,20,20,0,20,0,0
-1,131210111001030.000000000000000,Block 1030, Block Group 1, Census Tract 111, Fulton County, Georgia,28,1,27,27,0,24,0,0
-1,131210112024008.000000000000000,Block 4008, Block Group 4, Census Tract 112.02, Fulton County, Georgia,28,3,25,25,0,25,0,0
-1,131210112031006.000000000000000,Block 1006, Block Group 1, Census Tract 112.03, Fulton County, Georgia,28,2,26,24,2,22,0,2
-1,131210112042006.000000000000000,Block 2006, Block Group 2, Census Tract 112.04, Fulton County, Georgia,28,4,24,16,2,12,0,8
-1,131210113016012.000000000000000,Block 6012, Block Group 6, Census Tract 113.01, Fulton County, Georgia,28,2,26,19,1,18,0,7
-1,131210114172008.000000000000000,Block 2008, Block Group 2, Census Tract 114.17, Fulton County, Georgia,28,4,24,21,17,0,0,3
-1,131210114173005.000000000000000,Block 3005, Block Group 3, Census Tract 114.17, Fulton County, Georgia,28,1,27,26,21,0,4,1
-1,131210114192011.000000000000000,Block 2011, Block Group 2, Census Tract 114.19, Fulton County, Georgia,28,0,28,26,26,0,0,2
-1,131210114221006.000000000000000,Block 1006, Block Group 1, Census Tract 114.22, Fulton County, Georgia,28,18,10,9,5,0,2,1
-1,131210114233002.000000000000000,Block 3002, Block Group 3, Census Tract 114.23, Fulton County, Georgia,28,3,25,8,0,6,0,17
-1,131210114352006.000000000000000,Block 2006, Block Group 2, Census Tract 114.35, Fulton County, Georgia,28,5,23,18,11,0,0,5
-1,131210114352011.000000000000000,Block 2011, Block Group 2, Census Tract 114.35, Fulton County, Georgia,28,5,23,20,14,0,0,3
-1,131210114422005.000000000000000,Block 2005, Block Group 2, Census Tract 114.42, Fulton County, Georgia,28,3,25,25,20,1,0,0
-1,131210114451004.000000000000000,Block 1004, Block Group 1, Census Tract 114.45, Fulton County, Georgia,28,0,28,24,17,4,1,4
-1,131210115082003.000000000000000,Block 2003, Block Group 2, Census Tract 115.08, Fulton County, Georgia,28,5,23,21,21,0,0,2
-1,131210115082020.000000000000000,Block 2020, Block Group 2, Census Tract 115.08, Fulton County, Georgia,28,6,22,13,10,0,0,9
-1,131210115142006.000000000000000,Block 2006, Block Group 2, Census Tract 115.14, Fulton County, Georgia,28,5,23,23,20,1,1,0
-1,131210116341002.000000000000000,Block 1002, Block Group 1, Census Tract 116.34, Fulton County, Georgia,28,8,20,20,9,10,1,0
-1,131210116443002.000000000000000,Block 3002, Block Group 3, Census Tract 116.44, Fulton County, Georgia,28,4,24,16,6,4,0,8
-1,131210118021012.000000000000000,Block 1012, Block Group 1, Census Tract 118.02, Fulton County, Georgia,28,0,28,27,0,26,0,1
-1,131210119011018.000000000000000,Block 1018, Block Group 1, Census Tract 119.01, Fulton County, Georgia,28,1,27,27,16,9,2,0
-1,131210001004009.000000000000000,Block 4009, Block Group 4, Census Tract 1, Fulton County, Georgia,27,2,25,12,12,0,0,13
-1,131210007001024.000000000000000,Block 1024, Block Group 1, Census Tract 7, Fulton County, Georgia,27,0,27,23,8,15,0,4
-1,131210011022010.000000000000000,Block 2010, Block Group 2, Census Tract 11.02, Fulton County, Georgia,27,5,22,11,6,4,0,11
-1,131210017022013.000000000000000,Block 2013, Block Group 2, Census Tract 17.02, Fulton County, Georgia,27,9,18,15,12,2,0,3
-1,131210023002016.000000000000000,Block 2016, Block Group 2, Census Tract 23, Fulton County, Georgia,27,0,27,18,1,16,0,9
-1,131210024002004.000000000000000,Block 2004, Block Group 2, Census Tract 24, Fulton County, Georgia,27,1,26,26,0,26,0,0
-1,131210024002015.000000000000000,Block 2015, Block Group 2, Census Tract 24, Fulton County, Georgia,27,0,27,26,0,26,0,1
-1,131210026001013.000000000000000,Block 1013, Block Group 1, Census Tract 26, Fulton County, Georgia,27,6,21,20,4,16,0,1
-1,131210031002001.000000000000000,Block 2001, Block Group 2, Census Tract 31, Fulton County, Georgia,27,4,23,18,13,0,0,5
-1,131210041003003.000000000000000,Block 3003, Block Group 3, Census Tract 41, Fulton County, Georgia,27,1,26,25,2,20,0,1
-1,131210041003010.000000000000000,Block 3010, Block Group 3, Census Tract 41, Fulton County, Georgia,27,0,27,24,7,16,0,3
-1,131210049002002.000000000000000,Block 2002, Block Group 2, Census Tract 49, Fulton County, Georgia,27,4,23,20,20,0,0,3
-1,131210049002031.000000000000000,Block 2031, Block Group 2, Census Tract 49, Fulton County, Georgia,27,4,23,23,20,0,0,0
-1,131210052001009.000000000000000,Block 1009, Block Group 1, Census Tract 52, Fulton County, Georgia,27,4,23,22,19,3,0,1
-1,131210055011017.000000000000000,Block 1017, Block Group 1, Census Tract 55.01, Fulton County, Georgia,27,0,27,25,17,7,0,2
-1,131210055032002.000000000000000,Block 2002, Block Group 2, Census Tract 55.03, Fulton County, Georgia,27,1,26,23,0,23,0,3
-1,131210057002014.000000000000000,Block 2014, Block Group 2, Census Tract 57, Fulton County, Georgia,27,1,26,26,0,25,0,0
-1,131210061003009.000000000000000,Block 3009, Block Group 3, Census Tract 61, Fulton County, Georgia,27,0,27,24,4,20,0,3
-1,131210061003010.000000000000000,Block 3010, Block Group 3, Census Tract 61, Fulton County, Georgia,27,0,27,26,3,23,0,1
-1,131210062001007.000000000000000,Block 1007, Block Group 1, Census Tract 62, Fulton County, Georgia,27,0,27,27,2,25,0,0
-1,131210062002004.000000000000000,Block 2004, Block Group 2, Census Tract 62, Fulton County, Georgia,27,2,25,25,5,19,0,0
-1,131210063001032.000000000000000,Block 1032, Block Group 1, Census Tract 63, Fulton County, Georgia,27,6,21,19,1,18,0,2
-1,131210070023012.000000000000000,Block 3012, Block Group 3, Census Tract 70.02, Fulton County, Georgia,27,2,25,25,3,22,0,0
-1,131210073021007.000000000000000,Block 1007, Block Group 1, Census Tract 73.02, Fulton County, Georgia,27,0,27,20,0,19,1,7
-1,131210077112002.000000000000000,Block 2002, Block Group 2, Census Tract 77.11, Fulton County, Georgia,27,1,26,17,0,17,0,9
-1,131210078101005.000000000000000,Block 1005, Block Group 1, Census Tract 78.10, Fulton County, Georgia,27,2,25,24,0,24,0,1
-1,131210081043003.000000000000000,Block 3003, Block Group 3, Census Tract 81.04, Fulton County, Georgia,27,4,23,23,2,21,0,0
-1,131210082041011.000000000000000,Block 1011, Block Group 1, Census Tract 82.04, Fulton County, Georgia,27,0,27,24,4,20,0,3
-1,131210082041012.000000000000000,Block 1012, Block Group 1, Census Tract 82.04, Fulton County, Georgia,27,0,27,21,2,18,1,6
-1,131210083021001.000000000000000,Block 1001, Block Group 1, Census Tract 83.02, Fulton County, Georgia,27,1,26,26,0,26,0,0
-1,131210083022006.000000000000000,Block 2006, Block Group 2, Census Tract 83.02, Fulton County, Georgia,27,1,26,25,0,25,0,1
-1,131210083022016.000000000000000,Block 2016, Block Group 2, Census Tract 83.02, Fulton County, Georgia,27,4,23,23,0,23,0,0
-1,131210085001012.000000000000000,Block 1012, Block Group 1, Census Tract 85, Fulton County, Georgia,27,3,24,24,1,23,0,0
-1,131210087011015.000000000000000,Block 1015, Block Group 1, Census Tract 87.01, Fulton County, Georgia,27,6,21,21,0,21,0,0
-1,131210087011019.000000000000000,Block 1019, Block Group 1, Census Tract 87.01, Fulton County, Georgia,27,2,25,25,0,23,0,0
-1,131210088021044.000000000000000,Block 1044, Block Group 1, Census Tract 88.02, Fulton County, Georgia,27,6,21,21,20,0,1,0
-1,131210094061004.000000000000000,Block 1004, Block Group 1, Census Tract 94.06, Fulton County, Georgia,27,13,14,9,0,3,2,5
-1,131210094111003.000000000000000,Block 1003, Block Group 1, Census Tract 94.11, Fulton County, Georgia,27,10,17,11,5,1,0,6
-1,131210098021022.000000000000000,Block 1022, Block Group 1, Census Tract 98.02, Fulton County, Georgia,27,1,26,22,22,0,0,4
-1,131210100051015.000000000000000,Block 1015, Block Group 1, Census Tract 100.05, Fulton County, Georgia,27,1,26,26,25,0,0,0
-1,131210101273004.000000000000000,Block 3004, Block Group 3, Census Tract 101.27, Fulton County, Georgia,27,7,20,17,9,4,0,3
-1,131210101331005.000000000000000,Block 1005, Block Group 1, Census Tract 101.33, Fulton County, Georgia,27,3,24,21,13,1,0,3
-1,131210101332002.000000000000000,Block 2002, Block Group 2, Census Tract 101.33, Fulton County, Georgia,27,7,20,18,12,0,6,2
-1,131210101372004.000000000000000,Block 2004, Block Group 2, Census Tract 101.37, Fulton County, Georgia,27,3,24,24,14,8,0,0
-1,131210102221000.000000000000000,Block 1000, Block Group 1, Census Tract 102.22, Fulton County, Georgia,27,4,23,22,10,8,0,1
-1,131210103051015.000000000000000,Block 1015, Block Group 1, Census Tract 103.05, Fulton County, Georgia,27,0,27,27,0,26,1,0
-1,131210104021032.000000000000000,Block 1032, Block Group 1, Census Tract 104.02, Fulton County, Georgia,27,4,23,22,22,0,0,1
-1,131210104023063.000000000000000,Block 3063, Block Group 3, Census Tract 104.02, Fulton County, Georgia,27,0,27,23,22,1,0,4
-1,131210105082005.000000000000000,Block 2005, Block Group 2, Census Tract 105.08, Fulton County, Georgia,27,6,21,21,0,21,0,0
-1,131210105171011.000000000000000,Block 1011, Block Group 1, Census Tract 105.17, Fulton County, Georgia,27,0,27,23,0,23,0,4
-1,131210105223005.000000000000000,Block 3005, Block Group 3, Census Tract 105.22, Fulton County, Georgia,27,4,23,19,0,19,0,4
-1,131210105271011.000000000000000,Block 1011, Block Group 1, Census Tract 105.27, Fulton County, Georgia,27,1,26,22,2,20,0,4
-1,131210105283018.000000000000000,Block 3018, Block Group 3, Census Tract 105.28, Fulton County, Georgia,27,3,24,22,18,4,0,2
-1,131210105301012.000000000000000,Block 1012, Block Group 1, Census Tract 105.30, Fulton County, Georgia,27,0,27,27,1,26,0,0
-1,131210105301018.000000000000000,Block 1018, Block Group 1, Census Tract 105.30, Fulton County, Georgia,27,0,27,25,0,23,2,2
-1,131210105341008.000000000000000,Block 1008, Block Group 1, Census Tract 105.34, Fulton County, Georgia,27,2,25,25,0,21,0,0
-1,131210105351008.000000000000000,Block 1008, Block Group 1, Census Tract 105.35, Fulton County, Georgia,27,0,27,26,11,15,0,1
-1,131210106014012.000000000000000,Block 4012, Block Group 4, Census Tract 106.01, Fulton County, Georgia,27,4,23,18,18,0,0,5
-1,131210106031006.000000000000000,Block 1006, Block Group 1, Census Tract 106.03, Fulton County, Georgia,27,0,27,23,1,22,0,4
-1,131210108011007.000000000000000,Block 1007, Block Group 1, Census Tract 108.01, Fulton County, Georgia,27,6,21,19,4,13,1,2
-1,131210108024011.000000000000000,Block 4011, Block Group 4, Census Tract 108.02, Fulton County, Georgia,27,10,17,17,10,6,0,0
-1,131210110003014.000000000000000,Block 3014, Block Group 3, Census Tract 110, Fulton County, Georgia,27,3,24,21,10,9,2,3
-1,131210111001023.000000000000000,Block 1023, Block Group 1, Census Tract 111, Fulton County, Georgia,27,1,26,24,21,2,0,2
-1,131210111002001.000000000000000,Block 2001, Block Group 2, Census Tract 111, Fulton County, Georgia,27,1,26,25,6,19,0,1
-1,131210111003000.000000000000000,Block 3000, Block Group 3, Census Tract 111, Fulton County, Georgia,27,1,26,26,14,11,0,0
-1,131210112024015.000000000000000,Block 4015, Block Group 4, Census Tract 112.02, Fulton County, Georgia,27,8,19,16,8,8,0,3
-1,131210113011006.000000000000000,Block 1006, Block Group 1, Census Tract 113.01, Fulton County, Georgia,27,5,22,21,2,19,0,1
-1,131210113013005.000000000000000,Block 3005, Block Group 3, Census Tract 113.01, Fulton County, Georgia,27,2,25,24,3,19,0,1
-1,131210114214009.000000000000000,Block 4009, Block Group 4, Census Tract 114.21, Fulton County, Georgia,27,6,21,13,6,4,0,8
-1,131210114331003.000000000000000,Block 1003, Block Group 1, Census Tract 114.33, Fulton County, Georgia,27,3,24,17,13,0,1,7
-1,131210114352009.000000000000000,Block 2009, Block Group 2, Census Tract 114.35, Fulton County, Georgia,27,8,19,14,14,0,0,5
-1,131210114383009.000000000000000,Block 3009, Block Group 3, Census Tract 114.38, Fulton County, Georgia,27,14,13,13,2,9,0,0
-1,131210115142003.000000000000000,Block 2003, Block Group 2, Census Tract 115.14, Fulton County, Georgia,27,8,19,18,18,0,0,1
-1,131210116293008.000000000000000,Block 3008, Block Group 3, Census Tract 116.29, Fulton County, Georgia,27,5,22,21,14,2,0,1
-1,131210116401012.000000000000000,Block 1012, Block Group 1, Census Tract 116.40, Fulton County, Georgia,27,3,24,23,23,0,0,1
-1,131210116441006.000000000000000,Block 1006, Block Group 1, Census Tract 116.44, Fulton County, Georgia,27,13,14,14,10,0,0,0
-1,131210116493012.000000000000000,Block 3012, Block Group 3, Census Tract 116.49, Fulton County, Georgia,27,4,23,23,14,1,0,0
-1,131210116551013.000000000000000,Block 1013, Block Group 1, Census Tract 116.55, Fulton County, Georgia,27,5,22,20,16,2,0,2
-1,131210123001021.000000000000000,Block 1021, Block Group 1, Census Tract 123, Fulton County, Georgia,27,2,25,24,8,16,0,1
-1,131210123002033.000000000000000,Block 2033, Block Group 2, Census Tract 123, Fulton County, Georgia,27,4,23,19,3,16,0,4
-1,131210006021000.000000000000000,Block 1000, Block Group 1, Census Tract 6.02, Fulton County, Georgia,26,1,25,25,14,10,0,0
-1,131210010022010.000000000000000,Block 2010, Block Group 2, Census Tract 10.02, Fulton County, Georgia,26,9,17,10,6,0,0,7
-1,131210018011002.000000000000000,Block 1002, Block Group 1, Census Tract 18.01, Fulton County, Georgia,26,8,18,12,3,9,0,6
-1,131210018021007.000000000000000,Block 1007, Block Group 1, Census Tract 18.02, Fulton County, Georgia,26,5,21,12,2,0,4,9
-1,131210023002018.000000000000000,Block 2018, Block Group 2, Census Tract 23, Fulton County, Georgia,26,1,25,25,0,24,1,0
-1,131210025001008.000000000000000,Block 1008, Block Group 1, Census Tract 25, Fulton County, Georgia,26,0,26,20,2,18,0,6
-1,131210029002011.000000000000000,Block 2011, Block Group 2, Census Tract 29, Fulton County, Georgia,26,3,23,21,4,7,2,2
-1,131210030003005.000000000000000,Block 3005, Block Group 3, Census Tract 30, Fulton County, Georgia,26,2,24,21,18,0,0,3
-1,131210031001006.000000000000000,Block 1006, Block Group 1, Census Tract 31, Fulton County, Georgia,26,3,23,17,15,0,0,6
-1,131210049002005.000000000000000,Block 2005, Block Group 2, Census Tract 49, Fulton County, Georgia,26,2,24,23,9,14,0,1
-1,131210053002004.000000000000000,Block 2004, Block Group 2, Census Tract 53, Fulton County, Georgia,26,1,25,20,20,0,0,5
-1,131210061002013.000000000000000,Block 2013, Block Group 2, Census Tract 61, Fulton County, Georgia,26,0,26,26,2,24,0,0
-1,131210062001001.000000000000000,Block 1001, Block Group 1, Census Tract 62, Fulton County, Georgia,26,2,24,24,5,19,0,0
-1,131210063002007.000000000000000,Block 2007, Block Group 2, Census Tract 63, Fulton County, Georgia,26,0,26,26,6,18,0,0
-1,131210066021016.000000000000000,Block 1016, Block Group 1, Census Tract 66.02, Fulton County, Georgia,26,0,26,26,6,19,1,0
-1,131210067021029.000000000000000,Block 1029, Block Group 1, Census Tract 67.02, Fulton County, Georgia,26,0,26,26,2,24,0,0
-1,131210067021042.000000000000000,Block 1042, Block Group 1, Census Tract 67.02, Fulton County, Georgia,26,1,25,22,0,22,0,3
-1,131210070012012.000000000000000,Block 2012, Block Group 2, Census Tract 70.01, Fulton County, Georgia,26,0,26,22,0,20,2,4
-1,131210078064003.000000000000000,Block 4003, Block Group 4, Census Tract 78.06, Fulton County, Georgia,26,2,24,22,2,20,0,2
-1,131210078092004.000000000000000,Block 2004, Block Group 2, Census Tract 78.09, Fulton County, Georgia,26,0,26,25,0,25,0,1
-1,131210079002012.000000000000000,Block 2012, Block Group 2, Census Tract 79, Fulton County, Georgia,26,0,26,25,0,25,0,1
-1,131210082042009.000000000000000,Block 2009, Block Group 2, Census Tract 82.04, Fulton County, Georgia,26,0,26,26,0,26,0,0
-1,131210086012025.000000000000000,Block 2025, Block Group 2, Census Tract 86.01, Fulton County, Georgia,26,4,22,22,0,22,0,0
-1,131210087011013.000000000000000,Block 1013, Block Group 1, Census Tract 87.01, Fulton County, Georgia,26,5,21,21,11,10,0,0
-1,131210088021036.000000000000000,Block 1036, Block Group 1, Census Tract 88.02, Fulton County, Georgia,26,8,18,12,9,3,0,6
-1,131210088021039.000000000000000,Block 1039, Block Group 1, Census Tract 88.02, Fulton County, Georgia,26,2,24,24,20,0,0,0
-1,131210089054003.000000000000000,Block 4003, Block Group 4, Census Tract 89.05, Fulton County, Georgia,26,0,26,17,10,5,0,9
-1,131210092031008.000000000000000,Block 1008, Block Group 1, Census Tract 92.03, Fulton County, Georgia,26,4,22,16,12,3,0,6
-1,131210093021000.000000000000000,Block 1000, Block Group 1, Census Tract 93.02, Fulton County, Georgia,26,3,23,22,22,0,0,1
-1,131210098021015.000000000000000,Block 1015, Block Group 1, Census Tract 98.02, Fulton County, Georgia,26,0,26,26,22,4,0,0
-1,131210099003004.000000000000000,Block 3004, Block Group 3, Census Tract 99, Fulton County, Georgia,26,3,23,23,23,0,0,0
-1,131210100031006.000000000000000,Block 1006, Block Group 1, Census Tract 100.03, Fulton County, Georgia,26,7,19,16,7,2,0,3
-1,131210100052018.000000000000000,Block 2018, Block Group 2, Census Tract 100.05, Fulton County, Georgia,26,0,26,24,15,0,5,2
-1,131210101202008.000000000000000,Block 2008, Block Group 2, Census Tract 101.20, Fulton County, Georgia,26,6,20,12,8,1,0,8
-1,131210101321008.000000000000000,Block 1008, Block Group 1, Census Tract 101.32, Fulton County, Georgia,26,0,26,20,20,0,0,6
-1,131210101323005.000000000000000,Block 3005, Block Group 3, Census Tract 101.32, Fulton County, Georgia,26,1,25,23,17,2,0,2
-1,131210101361007.000000000000000,Block 1007, Block Group 1, Census Tract 101.36, Fulton County, Georgia,26,0,26,25,14,1,0,1
-1,131210101373001.000000000000000,Block 3001, Block Group 3, Census Tract 101.37, Fulton County, Georgia,26,15,11,9,6,3,0,2
-1,131210102043003.000000000000000,Block 3003, Block Group 3, Census Tract 102.04, Fulton County, Georgia,26,8,18,12,8,2,0,6
-1,131210102201015.000000000000000,Block 1015, Block Group 1, Census Tract 102.20, Fulton County, Georgia,26,3,23,19,19,0,0,4
-1,131210102213006.000000000000000,Block 3006, Block Group 3, Census Tract 102.21, Fulton County, Georgia,26,7,19,16,8,4,0,3
-1,131210102222003.000000000000000,Block 2003, Block Group 2, Census Tract 102.22, Fulton County, Georgia,26,4,22,19,14,3,1,3
-1,131210102233004.000000000000000,Block 3004, Block Group 3, Census Tract 102.23, Fulton County, Georgia,26,5,21,13,9,0,0,8
-1,131210103052001.000000000000000,Block 2001, Block Group 2, Census Tract 103.05, Fulton County, Georgia,26,0,26,25,0,22,3,1
-1,131210103061001.000000000000000,Block 1001, Block Group 1, Census Tract 103.06, Fulton County, Georgia,26,0,26,22,0,20,2,4
-1,131210103074006.000000000000000,Block 4006, Block Group 4, Census Tract 103.07, Fulton County, Georgia,26,1,25,20,0,20,0,5
-1,131210103074008.000000000000000,Block 4008, Block Group 4, Census Tract 103.07, Fulton County, Georgia,26,1,25,24,5,19,0,1
-1,131210103082015.000000000000000,Block 2015, Block Group 2, Census Tract 103.08, Fulton County, Georgia,26,6,20,16,5,11,0,4
-1,131210103091009.000000000000000,Block 1009, Block Group 1, Census Tract 103.09, Fulton County, Georgia,26,1,25,21,7,11,0,4
-1,131210104012010.000000000000000,Block 2010, Block Group 2, Census Tract 104.01, Fulton County, Georgia,26,3,23,23,6,17,0,0
-1,131210104022051.000000000000000,Block 2051, Block Group 2, Census Tract 104.02, Fulton County, Georgia,26,2,24,23,6,12,0,1
-1,131210104022054.000000000000000,Block 2054, Block Group 2, Census Tract 104.02, Fulton County, Georgia,26,6,20,18,0,18,0,2
-1,131210105171003.000000000000000,Block 1003, Block Group 1, Census Tract 105.17, Fulton County, Georgia,26,1,25,25,0,25,0,0
-1,131210105263005.000000000000000,Block 3005, Block Group 3, Census Tract 105.26, Fulton County, Georgia,26,0,26,25,1,24,0,1
-1,131210105321004.000000000000000,Block 1004, Block Group 1, Census Tract 105.32, Fulton County, Georgia,26,1,25,22,0,20,0,3
-1,131210105391014.000000000000000,Block 1014, Block Group 1, Census Tract 105.39, Fulton County, Georgia,26,6,20,18,0,18,0,2
-1,131210105401028.000000000000000,Block 1028, Block Group 1, Census Tract 105.40, Fulton County, Georgia,26,2,24,20,2,13,4,4
-1,131210106011010.000000000000000,Block 1010, Block Group 1, Census Tract 106.01, Fulton County, Georgia,26,3,23,22,8,13,1,1
-1,131210106011013.000000000000000,Block 1013, Block Group 1, Census Tract 106.01, Fulton County, Georgia,26,0,26,26,15,11,0,0
-1,131210106011020.000000000000000,Block 1020, Block Group 1, Census Tract 106.01, Fulton County, Georgia,26,0,26,23,7,16,0,3
-1,131210106013000.000000000000000,Block 3000, Block Group 3, Census Tract 106.01, Fulton County, Georgia,26,2,24,24,21,3,0,0
-1,131210108021006.000000000000000,Block 1006, Block Group 1, Census Tract 108.02, Fulton County, Georgia,26,6,20,20,3,15,0,0
-1,131210108023014.000000000000000,Block 3014, Block Group 3, Census Tract 108.02, Fulton County, Georgia,26,15,11,10,6,3,0,1
-1,131210108024009.000000000000000,Block 4009, Block Group 4, Census Tract 108.02, Fulton County, Georgia,26,8,18,17,8,5,2,1
-1,131210111001024.000000000000000,Block 1024, Block Group 1, Census Tract 111, Fulton County, Georgia,26,4,22,20,11,7,1,2
-1,131210111001027.000000000000000,Block 1027, Block Group 1, Census Tract 111, Fulton County, Georgia,26,3,23,21,0,20,0,2
-1,131210111002009.000000000000000,Block 2009, Block Group 2, Census Tract 111, Fulton County, Georgia,26,0,26,23,16,7,0,3
-1,131210112026004.000000000000000,Block 6004, Block Group 6, Census Tract 112.02, Fulton County, Georgia,26,6,20,14,0,14,0,6
-1,131210112026016.000000000000000,Block 6016, Block Group 6, Census Tract 112.02, Fulton County, Georgia,26,0,26,26,10,16,0,0
-1,131210112032007.000000000000000,Block 2007, Block Group 2, Census Tract 112.03, Fulton County, Georgia,26,0,26,26,0,26,0,0
-1,131210112032016.000000000000000,Block 2016, Block Group 2, Census Tract 112.03, Fulton County, Georgia,26,4,22,20,8,12,0,2
-1,131210113093011.000000000000000,Block 3011, Block Group 3, Census Tract 113.09, Fulton County, Georgia,26,2,24,24,1,20,1,0
-1,131210114173008.000000000000000,Block 3008, Block Group 3, Census Tract 114.17, Fulton County, Georgia,26,0,26,25,22,0,1,1
-1,131210114191004.000000000000000,Block 1004, Block Group 1, Census Tract 114.19, Fulton County, Georgia,26,7,19,17,7,10,0,2
-1,131210114301005.000000000000000,Block 1005, Block Group 1, Census Tract 114.30, Fulton County, Georgia,26,10,16,8,6,0,0,8
-1,131210114422007.000000000000000,Block 2007, Block Group 2, Census Tract 114.42, Fulton County, Georgia,26,9,17,14,14,0,0,3
-1,131210114451014.000000000000000,Block 1014, Block Group 1, Census Tract 114.45, Fulton County, Georgia,26,2,24,24,20,4,0,0
-1,131210115082006.000000000000000,Block 2006, Block Group 2, Census Tract 115.08, Fulton County, Georgia,26,3,23,22,13,4,0,1
-1,131210115091002.000000000000000,Block 1002, Block Group 1, Census Tract 115.09, Fulton County, Georgia,26,1,25,20,20,0,0,5
-1,131210115142001.000000000000000,Block 2001, Block Group 2, Census Tract 115.14, Fulton County, Georgia,26,6,20,15,12,2,0,5
-1,131210115142014.000000000000000,Block 2014, Block Group 2, Census Tract 115.14, Fulton County, Georgia,26,0,26,24,18,3,1,2
-1,131210116321003.000000000000000,Block 1003, Block Group 1, Census Tract 116.32, Fulton County, Georgia,26,6,20,11,0,7,0,9
-1,131210116422001.000000000000000,Block 2001, Block Group 2, Census Tract 116.42, Fulton County, Georgia,26,9,17,13,4,2,0,4
-1,131210118022008.000000000000000,Block 2008, Block Group 2, Census Tract 118.02, Fulton County, Georgia,26,0,26,26,2,24,0,0
-1,131210118022010.000000000000000,Block 2010, Block Group 2, Census Tract 118.02, Fulton County, Georgia,26,5,21,18,0,17,0,3
-1,131210123001026.000000000000000,Block 1026, Block Group 1, Census Tract 123, Fulton County, Georgia,26,0,26,26,22,3,0,0
-1,131210001002003.000000000000000,Block 2003, Block Group 2, Census Tract 1, Fulton County, Georgia,25,1,24,22,20,0,0,2
-1,131210002011012.000000000000000,Block 1012, Block Group 1, Census Tract 2.01, Fulton County, Georgia,25,0,25,23,21,2,0,2
-1,131210006013015.000000000000000,Block 3015, Block Group 3, Census Tract 6.01, Fulton County, Georgia,25,1,24,24,14,4,0,0
-1,131210010011002.000000000000000,Block 1002, Block Group 1, Census Tract 10.01, Fulton County, Georgia,25,7,18,11,4,5,0,7
-1,131210023001000.000000000000000,Block 1000, Block Group 1, Census Tract 23, Fulton County, Georgia,25,2,23,23,0,23,0,0
-1,131210023003015.000000000000000,Block 3015, Block Group 3, Census Tract 23, Fulton County, Georgia,25,0,25,25,0,24,0,0
-1,131210024002012.000000000000000,Block 2012, Block Group 2, Census Tract 24, Fulton County, Georgia,25,0,25,25,0,25,0,0
-1,131210032001013.000000000000000,Block 1013, Block Group 1, Census Tract 32, Fulton County, Georgia,25,8,17,13,11,0,0,4
-1,131210044002016.000000000000000,Block 2016, Block Group 2, Census Tract 44, Fulton County, Georgia,25,1,24,21,7,14,0,3
-1,131210049002000.000000000000000,Block 2000, Block Group 2, Census Tract 49, Fulton County, Georgia,25,3,22,22,19,2,0,0
-1,131210053003008.000000000000000,Block 3008, Block Group 3, Census Tract 53, Fulton County, Georgia,25,2,23,21,13,8,0,2
-1,131210055011011.000000000000000,Block 1011, Block Group 1, Census Tract 55.01, Fulton County, Georgia,25,5,20,19,9,10,0,1
-1,131210055012016.000000000000000,Block 2016, Block Group 2, Census Tract 55.01, Fulton County, Georgia,25,2,23,22,9,12,0,1
-1,131210055041022.000000000000000,Block 1022, Block Group 1, Census Tract 55.04, Fulton County, Georgia,25,3,22,22,5,17,0,0
-1,131210060003007.000000000000000,Block 3007, Block Group 3, Census Tract 60, Fulton County, Georgia,25,0,25,20,9,11,0,5
-1,131210061003004.000000000000000,Block 3004, Block Group 3, Census Tract 61, Fulton County, Georgia,25,0,25,24,0,24,0,1
-1,131210064001016.000000000000000,Block 1016, Block Group 1, Census Tract 64, Fulton County, Georgia,25,3,22,21,5,16,0,1
-1,131210067021006.000000000000000,Block 1006, Block Group 1, Census Tract 67.02, Fulton County, Georgia,25,0,25,25,0,25,0,0
-1,131210070012004.000000000000000,Block 2004, Block Group 2, Census Tract 70.01, Fulton County, Georgia,25,3,22,22,0,20,0,0
-1,131210070023000.000000000000000,Block 3000, Block Group 3, Census Tract 70.02, Fulton County, Georgia,25,1,24,20,0,20,0,4
-1,131210077053012.000000000000000,Block 3012, Block Group 3, Census Tract 77.05, Fulton County, Georgia,25,0,25,25,0,25,0,0
-1,131210077053020.000000000000000,Block 3020, Block Group 3, Census Tract 77.05, Fulton County, Georgia,25,3,22,21,3,18,0,1
-1,131210081043007.000000000000000,Block 3007, Block Group 3, Census Tract 81.04, Fulton County, Georgia,25,4,21,21,5,14,0,0
-1,131210081043017.000000000000000,Block 3017, Block Group 3, Census Tract 81.04, Fulton County, Georgia,25,1,24,23,0,19,0,1
-1,131210082023000.000000000000000,Block 3000, Block Group 3, Census Tract 82.02, Fulton County, Georgia,25,3,22,22,0,22,0,0
-1,131210082031002.000000000000000,Block 1002, Block Group 1, Census Tract 82.03, Fulton County, Georgia,25,1,24,24,0,23,0,0
-1,131210083012009.000000000000000,Block 2009, Block Group 2, Census Tract 83.01, Fulton County, Georgia,25,3,22,22,4,18,0,0
-1,131210087021002.000000000000000,Block 1002, Block Group 1, Census Tract 87.02, Fulton County, Georgia,25,2,23,20,0,20,0,3
-1,131210087021016.000000000000000,Block 1016, Block Group 1, Census Tract 87.02, Fulton County, Georgia,25,2,23,20,14,6,0,3
-1,131210087022002.000000000000000,Block 2002, Block Group 2, Census Tract 87.02, Fulton County, Georgia,25,2,23,16,14,0,0,7
-1,131210089051007.000000000000000,Block 1007, Block Group 1, Census Tract 89.05, Fulton County, Georgia,25,2,23,20,17,1,0,3
-1,131210090022007.000000000000000,Block 2007, Block Group 2, Census Tract 90.02, Fulton County, Georgia,25,1,24,24,24,0,0,0
-1,131210092012002.000000000000000,Block 2002, Block Group 2, Census Tract 92.01, Fulton County, Georgia,25,5,20,16,16,0,0,4
-1,131210092012004.000000000000000,Block 2004, Block Group 2, Census Tract 92.01, Fulton County, Georgia,25,3,22,15,9,2,3,7
-1,131210098021011.000000000000000,Block 1011, Block Group 1, Census Tract 98.02, Fulton County, Georgia,25,4,21,17,17,0,0,4
-1,131210098023011.000000000000000,Block 3011, Block Group 3, Census Tract 98.02, Fulton County, Georgia,25,2,23,23,22,0,0,0
-1,131210098023013.000000000000000,Block 3013, Block Group 3, Census Tract 98.02, Fulton County, Georgia,25,2,23,20,19,0,0,3
-1,131210101252004.000000000000000,Block 2004, Block Group 2, Census Tract 101.25, Fulton County, Georgia,25,8,17,12,0,6,0,5
-1,131210101321000.000000000000000,Block 1000, Block Group 1, Census Tract 101.32, Fulton County, Georgia,25,12,13,13,7,6,0,0
-1,131210102114007.000000000000000,Block 4007, Block Group 4, Census Tract 102.11, Fulton County, Georgia,25,12,13,13,11,0,0,0
-1,131210102222004.000000000000000,Block 2004, Block Group 2, Census Tract 102.22, Fulton County, Georgia,25,3,22,19,7,5,1,3
-1,131210103051006.000000000000000,Block 1006, Block Group 1, Census Tract 103.05, Fulton County, Georgia,25,0,25,24,0,24,0,1
-1,131210103051016.000000000000000,Block 1016, Block Group 1, Census Tract 103.05, Fulton County, Georgia,25,0,25,25,0,25,0,0
-1,131210103092032.000000000000000,Block 2032, Block Group 2, Census Tract 103.09, Fulton County, Georgia,25,4,21,21,0,21,0,0
-1,131210103111028.000000000000000,Block 1028, Block Group 1, Census Tract 103.11, Fulton County, Georgia,25,2,23,18,0,17,0,5
-1,131210103131021.000000000000000,Block 1021, Block Group 1, Census Tract 103.13, Fulton County, Georgia,25,1,24,21,2,19,0,3
-1,131210105191001.000000000000000,Block 1001, Block Group 1, Census Tract 105.19, Fulton County, Georgia,25,0,25,24,6,18,0,1
-1,131210105203017.000000000000000,Block 3017, Block Group 3, Census Tract 105.20, Fulton County, Georgia,25,0,25,25,2,21,2,0
-1,131210105262002.000000000000000,Block 2002, Block Group 2, Census Tract 105.26, Fulton County, Georgia,25,0,25,22,6,14,1,3
-1,131210105301005.000000000000000,Block 1005, Block Group 1, Census Tract 105.30, Fulton County, Georgia,25,0,25,25,0,25,0,0
-1,131210105301006.000000000000000,Block 1006, Block Group 1, Census Tract 105.30, Fulton County, Georgia,25,0,25,18,0,18,0,7
-1,131210105331007.000000000000000,Block 1007, Block Group 1, Census Tract 105.33, Fulton County, Georgia,25,0,25,25,3,21,0,0
-1,131210105352010.000000000000000,Block 2010, Block Group 2, Census Tract 105.35, Fulton County, Georgia,25,2,23,22,3,18,0,1
-1,131210105362001.000000000000000,Block 2001, Block Group 2, Census Tract 105.36, Fulton County, Georgia,25,4,21,21,6,15,0,0
-1,131210106011004.000000000000000,Block 1004, Block Group 1, Census Tract 106.01, Fulton County, Georgia,25,1,24,21,13,8,0,3
-1,131210106011011.000000000000000,Block 1011, Block Group 1, Census Tract 106.01, Fulton County, Georgia,25,3,22,22,10,11,0,0
-1,131210106014010.000000000000000,Block 4010, Block Group 4, Census Tract 106.01, Fulton County, Georgia,25,1,24,24,11,13,0,0
-1,131210106014011.000000000000000,Block 4011, Block Group 4, Census Tract 106.01, Fulton County, Georgia,25,5,20,20,18,0,0,0
-1,131210106034007.000000000000000,Block 4007, Block Group 4, Census Tract 106.03, Fulton County, Georgia,25,0,25,24,8,12,0,1
-1,131210108012010.000000000000000,Block 2010, Block Group 2, Census Tract 108.01, Fulton County, Georgia,25,1,24,19,7,11,1,5
-1,131210108021007.000000000000000,Block 1007, Block Group 1, Census Tract 108.02, Fulton County, Georgia,25,21,4,4,0,0,4,0
-1,131210110001010.000000000000000,Block 1010, Block Group 1, Census Tract 110, Fulton County, Georgia,25,3,22,22,0,22,0,0
-1,131210110002000.000000000000000,Block 2000, Block Group 2, Census Tract 110, Fulton County, Georgia,25,7,18,18,0,18,0,0
-1,131210110002009.000000000000000,Block 2009, Block Group 2, Census Tract 110, Fulton County, Georgia,25,11,14,14,1,13,0,0
-1,131210111002036.000000000000000,Block 2036, Block Group 2, Census Tract 111, Fulton County, Georgia,25,2,23,22,7,13,0,1
-1,131210112024010.000000000000000,Block 4010, Block Group 4, Census Tract 112.02, Fulton County, Georgia,25,12,13,13,3,10,0,0
-1,131210113015005.000000000000000,Block 5005, Block Group 5, Census Tract 113.01, Fulton County, Georgia,25,0,25,24,2,22,0,1
-1,131210113016000.000000000000000,Block 6000, Block Group 6, Census Tract 113.01, Fulton County, Georgia,25,0,25,25,8,17,0,0
-1,131210113061031.000000000000000,Block 1031, Block Group 1, Census Tract 113.06, Fulton County, Georgia,25,1,24,18,0,18,0,6
-1,131210114194018.000000000000000,Block 4018, Block Group 4, Census Tract 114.19, Fulton County, Georgia,25,1,24,24,22,2,0,0
-1,131210114222003.000000000000000,Block 2003, Block Group 2, Census Tract 114.22, Fulton County, Georgia,25,2,23,22,18,4,0,1
-1,131210114223005.000000000000000,Block 3005, Block Group 3, Census Tract 114.22, Fulton County, Georgia,25,9,16,9,4,5,0,7
-1,131210114341004.000000000000000,Block 1004, Block Group 1, Census Tract 114.34, Fulton County, Georgia,25,4,21,19,0,3,0,2
-1,131210114412002.000000000000000,Block 2002, Block Group 2, Census Tract 114.41, Fulton County, Georgia,25,7,18,13,0,10,1,5
-1,131210115091011.000000000000000,Block 1011, Block Group 1, Census Tract 115.09, Fulton County, Georgia,25,3,22,22,21,0,0,0
-1,131210115102008.000000000000000,Block 2008, Block Group 2, Census Tract 115.10, Fulton County, Georgia,25,7,18,16,15,0,0,2
-1,131210115112018.000000000000000,Block 2018, Block Group 2, Census Tract 115.11, Fulton County, Georgia,25,0,25,22,12,9,0,3
-1,131210116351004.000000000000000,Block 1004, Block Group 1, Census Tract 116.35, Fulton County, Georgia,25,7,18,11,3,5,1,7
-1,131210116402025.000000000000000,Block 2025, Block Group 2, Census Tract 116.40, Fulton County, Georgia,25,2,23,23,17,0,0,0
-1,131210116473008.000000000000000,Block 3008, Block Group 3, Census Tract 116.47, Fulton County, Georgia,25,11,14,8,2,0,1,6
-1,131210116581010.000000000000000,Block 1010, Block Group 1, Census Tract 116.58, Fulton County, Georgia,25,8,17,12,3,1,0,5
-1,131210118021029.000000000000000,Block 1029, Block Group 1, Census Tract 118.02, Fulton County, Georgia,25,2,23,22,0,22,0,1
-1,131210119011019.000000000000000,Block 1019, Block Group 1, Census Tract 119.01, Fulton County, Georgia,25,5,20,17,9,4,0,3
-1,131210119021015.000000000000000,Block 1015, Block Group 1, Census Tract 119.02, Fulton County, Georgia,25,1,24,15,7,8,0,9
-1,131210123001015.000000000000000,Block 1015, Block Group 1, Census Tract 123, Fulton County, Georgia,25,3,22,22,6,14,2,0
-1,131210123001022.000000000000000,Block 1022, Block Group 1, Census Tract 123, Fulton County, Georgia,25,5,20,17,8,9,0,3
-1,131210123002053.000000000000000,Block 2053, Block Group 2, Census Tract 123, Fulton County, Georgia,25,2,23,23,1,21,1,0
-1,131210001004008.000000000000000,Block 4008, Block Group 4, Census Tract 1, Fulton County, Georgia,24,2,22,20,19,0,0,2
-1,131210006011012.000000000000000,Block 1012, Block Group 1, Census Tract 6.01, Fulton County, Georgia,24,6,18,9,4,3,0,9
-1,131210006021006.000000000000000,Block 1006, Block Group 1, Census Tract 6.02, Fulton County, Georgia,24,6,18,12,4,0,0,6
-1,131210023003005.000000000000000,Block 3005, Block Group 3, Census Tract 23, Fulton County, Georgia,24,1,23,22,0,21,0,1
-1,131210026002007.000000000000000,Block 2007, Block Group 2, Census Tract 26, Fulton County, Georgia,24,0,24,24,0,22,0,0
-1,131210030001025.000000000000000,Block 1025, Block Group 1, Census Tract 30, Fulton County, Georgia,24,0,24,21,19,0,0,3
-1,131210038001013.000000000000000,Block 1013, Block Group 1, Census Tract 38, Fulton County, Georgia,24,1,23,23,0,23,0,0
-1,131210039001022.000000000000000,Block 1022, Block Group 1, Census Tract 39, Fulton County, Georgia,24,0,24,21,1,20,0,3
-1,131210040003004.000000000000000,Block 3004, Block Group 3, Census Tract 40, Fulton County, Georgia,24,0,24,24,0,24,0,0
-1,131210050002011.000000000000000,Block 2011, Block Group 2, Census Tract 50, Fulton County, Georgia,24,1,23,18,9,8,1,5
-1,131210052003004.000000000000000,Block 3004, Block Group 3, Census Tract 52, Fulton County, Georgia,24,7,17,9,5,1,0,8
-1,131210053001004.000000000000000,Block 1004, Block Group 1, Census Tract 53, Fulton County, Georgia,24,0,24,24,18,5,0,0
-1,131210055041005.000000000000000,Block 1005, Block Group 1, Census Tract 55.04, Fulton County, Georgia,24,0,24,22,2,19,1,2
-1,131210055041009.000000000000000,Block 1009, Block Group 1, Census Tract 55.04, Fulton County, Georgia,24,0,24,22,0,22,0,2
-1,131210055041013.000000000000000,Block 1013, Block Group 1, Census Tract 55.04, Fulton County, Georgia,24,0,24,23,4,19,0,1
-1,131210055041021.000000000000000,Block 1021, Block Group 1, Census Tract 55.04, Fulton County, Georgia,24,0,24,22,5,17,0,2
-1,131210057001001.000000000000000,Block 1001, Block Group 1, Census Tract 57, Fulton County, Georgia,24,0,24,23,6,15,2,1
-1,131210063001023.000000000000000,Block 1023, Block Group 1, Census Tract 63, Fulton County, Georgia,24,1,23,22,0,22,0,1
-1,131210065001003.000000000000000,Block 1003, Block Group 1, Census Tract 65, Fulton County, Georgia,24,2,22,22,4,18,0,0
-1,131210067021003.000000000000000,Block 1003, Block Group 1, Census Tract 67.02, Fulton County, Georgia,24,2,22,22,0,22,0,0
-1,131210069002004.000000000000000,Block 2004, Block Group 2, Census Tract 69, Fulton County, Georgia,24,7,17,16,3,13,0,1
-1,131210070014014.000000000000000,Block 4014, Block Group 4, Census Tract 70.01, Fulton County, Georgia,24,2,22,22,0,22,0,0
-1,131210070023004.000000000000000,Block 3004, Block Group 3, Census Tract 70.02, Fulton County, Georgia,24,1,23,23,5,18,0,0
-1,131210070023008.000000000000000,Block 3008, Block Group 3, Census Tract 70.02, Fulton County, Georgia,24,0,24,23,0,22,0,1
-1,131210073011006.000000000000000,Block 1006, Block Group 1, Census Tract 73.01, Fulton County, Georgia,24,2,22,21,6,15,0,1
-1,131210077053008.000000000000000,Block 3008, Block Group 3, Census Tract 77.05, Fulton County, Georgia,24,2,22,20,0,20,0,2
-1,131210078052009.000000000000000,Block 2009, Block Group 2, Census Tract 78.05, Fulton County, Georgia,24,2,22,20,0,19,0,2
-1,131210078092001.000000000000000,Block 2001, Block Group 2, Census Tract 78.09, Fulton County, Georgia,24,0,24,24,3,21,0,0
-1,131210078092011.000000000000000,Block 2011, Block Group 2, Census Tract 78.09, Fulton County, Georgia,24,0,24,18,2,16,0,6
-1,131210078103011.000000000000000,Block 3011, Block Group 3, Census Tract 78.10, Fulton County, Georgia,24,1,23,21,0,21,0,2
-1,131210081043018.000000000000000,Block 3018, Block Group 3, Census Tract 81.04, Fulton County, Georgia,24,0,24,23,3,20,0,1
-1,131210082043007.000000000000000,Block 3007, Block Group 3, Census Tract 82.04, Fulton County, Georgia,24,0,24,20,0,20,0,4
-1,131210083022004.000000000000000,Block 2004, Block Group 2, Census Tract 83.02, Fulton County, Georgia,24,0,24,21,5,16,0,3
-1,131210085002005.000000000000000,Block 2005, Block Group 2, Census Tract 85, Fulton County, Georgia,24,3,21,19,0,19,0,2
-1,131210085003019.000000000000000,Block 3019, Block Group 3, Census Tract 85, Fulton County, Georgia,24,3,21,17,5,12,0,4
-1,131210085003024.000000000000000,Block 3024, Block Group 3, Census Tract 85, Fulton County, Georgia,24,0,24,23,2,18,0,1
-1,131210085003032.000000000000000,Block 3032, Block Group 3, Census Tract 85, Fulton County, Georgia,24,4,20,19,2,17,0,1
-1,131210086022007.000000000000000,Block 2007, Block Group 2, Census Tract 86.02, Fulton County, Georgia,24,4,20,18,0,16,0,2
-1,131210088021021.000000000000000,Block 1021, Block Group 1, Census Tract 88.02, Fulton County, Georgia,24,1,23,17,8,7,0,6
-1,131210088021040.000000000000000,Block 1040, Block Group 1, Census Tract 88.02, Fulton County, Georgia,24,0,24,23,18,4,0,1
-1,131210089052012.000000000000000,Block 2012, Block Group 2, Census Tract 89.05, Fulton County, Georgia,24,3,21,17,6,1,0,4
-1,131210095011017.000000000000000,Block 1017, Block Group 1, Census Tract 95.01, Fulton County, Georgia,24,2,22,19,19,0,0,3
-1,131210098041008.000000000000000,Block 1008, Block Group 1, Census Tract 98.04, Fulton County, Georgia,24,2,22,21,17,3,0,1
-1,131210098041015.000000000000000,Block 1015, Block Group 1, Census Tract 98.04, Fulton County, Georgia,24,1,23,16,15,0,1,7
-1,131210101305001.000000000000000,Block 5001, Block Group 5, Census Tract 101.30, Fulton County, Georgia,24,6,18,15,7,5,0,3
-1,131210101311001.000000000000000,Block 1001, Block Group 1, Census Tract 101.31, Fulton County, Georgia,24,3,21,15,15,0,0,6
-1,131210101361011.000000000000000,Block 1011, Block Group 1, Census Tract 101.36, Fulton County, Georgia,24,2,22,21,18,1,2,1
-1,131210102121006.000000000000000,Block 1006, Block Group 1, Census Tract 102.12, Fulton County, Georgia,24,2,22,17,10,3,1,5
-1,131210103063003.000000000000000,Block 3003, Block Group 3, Census Tract 103.06, Fulton County, Georgia,24,4,20,17,0,17,0,3
-1,131210103072019.000000000000000,Block 2019, Block Group 2, Census Tract 103.07, Fulton County, Georgia,24,1,23,23,5,18,0,0
-1,131210103091014.000000000000000,Block 1014, Block Group 1, Census Tract 103.09, Fulton County, Georgia,24,2,22,18,14,3,0,4
-1,131210103092021.000000000000000,Block 2021, Block Group 2, Census Tract 103.09, Fulton County, Georgia,24,1,23,23,4,16,2,0
-1,131210103101011.000000000000000,Block 1011, Block Group 1, Census Tract 103.10, Fulton County, Georgia,24,3,21,20,0,19,0,1
-1,131210103111003.000000000000000,Block 1003, Block Group 1, Census Tract 103.11, Fulton County, Georgia,24,4,20,18,0,18,0,2
-1,131210103112009.000000000000000,Block 2009, Block Group 2, Census Tract 103.11, Fulton County, Georgia,24,2,22,17,0,14,3,5
-1,131210103133019.000000000000000,Block 3019, Block Group 3, Census Tract 103.13, Fulton County, Georgia,24,0,24,20,0,20,0,4
-1,131210104013037.000000000000000,Block 3037, Block Group 3, Census Tract 104.01, Fulton County, Georgia,24,1,23,23,2,21,0,0
-1,131210104022008.000000000000000,Block 2008, Block Group 2, Census Tract 104.02, Fulton County, Georgia,24,0,24,24,15,8,1,0
-1,131210104022045.000000000000000,Block 2045, Block Group 2, Census Tract 104.02, Fulton County, Georgia,24,4,20,20,18,2,0,0
-1,131210105191035.000000000000000,Block 1035, Block Group 1, Census Tract 105.19, Fulton County, Georgia,24,5,19,19,7,11,1,0
-1,131210105191046.000000000000000,Block 1046, Block Group 1, Census Tract 105.19, Fulton County, Georgia,24,4,20,20,2,16,0,0
-1,131210105273004.000000000000000,Block 3004, Block Group 3, Census Tract 105.27, Fulton County, Georgia,24,11,13,12,3,9,0,1
-1,131210105283013.000000000000000,Block 3013, Block Group 3, Census Tract 105.28, Fulton County, Georgia,24,5,19,15,15,0,0,4
-1,131210105283016.000000000000000,Block 3016, Block Group 3, Census Tract 105.28, Fulton County, Georgia,24,5,19,19,19,0,0,0
-1,131210105312013.000000000000000,Block 2013, Block Group 2, Census Tract 105.31, Fulton County, Georgia,24,10,14,9,2,6,1,5
-1,131210105332008.000000000000000,Block 2008, Block Group 2, Census Tract 105.33, Fulton County, Georgia,24,1,23,22,2,15,0,1
-1,131210105343018.000000000000000,Block 3018, Block Group 3, Census Tract 105.34, Fulton County, Georgia,24,4,20,20,15,5,0,0
-1,131210105402020.000000000000000,Block 2020, Block Group 2, Census Tract 105.40, Fulton County, Georgia,24,4,20,15,7,7,0,5
-1,131210105402028.000000000000000,Block 2028, Block Group 2, Census Tract 105.40, Fulton County, Georgia,24,2,22,22,8,11,3,0
-1,131210106011017.000000000000000,Block 1017, Block Group 1, Census Tract 106.01, Fulton County, Georgia,24,2,22,22,19,3,0,0
-1,131210106011018.000000000000000,Block 1018, Block Group 1, Census Tract 106.01, Fulton County, Georgia,24,0,24,21,11,7,0,3
-1,131210106013004.000000000000000,Block 3004, Block Group 3, Census Tract 106.01, Fulton County, Georgia,24,4,20,18,1,17,0,2
-1,131210106031007.000000000000000,Block 1007, Block Group 1, Census Tract 106.03, Fulton County, Georgia,24,1,23,19,0,19,0,4
-1,131210110002014.000000000000000,Block 2014, Block Group 2, Census Tract 110, Fulton County, Georgia,24,6,18,18,0,18,0,0
-1,131210111002008.000000000000000,Block 2008, Block Group 2, Census Tract 111, Fulton County, Georgia,24,4,20,19,12,7,0,1
-1,131210111002039.000000000000000,Block 2039, Block Group 2, Census Tract 111, Fulton County, Georgia,24,4,20,19,8,11,0,1
-1,131210111002040.000000000000000,Block 2040, Block Group 2, Census Tract 111, Fulton County, Georgia,24,1,23,17,6,11,0,6
-1,131210112023003.000000000000000,Block 3003, Block Group 3, Census Tract 112.02, Fulton County, Georgia,24,2,22,22,5,17,0,0
-1,131210112026014.000000000000000,Block 6014, Block Group 6, Census Tract 112.02, Fulton County, Georgia,24,10,14,14,5,9,0,0
-1,131210112041003.000000000000000,Block 1003, Block Group 1, Census Tract 112.04, Fulton County, Georgia,24,4,20,17,4,13,0,3
-1,131210113015001.000000000000000,Block 5001, Block Group 5, Census Tract 113.01, Fulton County, Georgia,24,3,21,19,1,17,1,2
-1,131210113062005.000000000000000,Block 2005, Block Group 2, Census Tract 113.06, Fulton County, Georgia,24,6,18,16,0,16,0,2
-1,131210113102005.000000000000000,Block 2005, Block Group 2, Census Tract 113.10, Fulton County, Georgia,24,11,13,12,0,10,2,1
-1,131210114164001.000000000000000,Block 4001, Block Group 4, Census Tract 114.16, Fulton County, Georgia,24,5,19,15,8,0,3,4
-1,131210114192017.000000000000000,Block 2017, Block Group 2, Census Tract 114.19, Fulton County, Georgia,24,0,24,24,22,1,1,0
-1,131210114194010.000000000000000,Block 4010, Block Group 4, Census Tract 114.19, Fulton County, Georgia,24,5,19,12,11,0,0,7
-1,131210114223008.000000000000000,Block 3008, Block Group 3, Census Tract 114.22, Fulton County, Georgia,24,3,21,21,21,0,0,0
-1,131210114363016.000000000000000,Block 3016, Block Group 3, Census Tract 114.36, Fulton County, Georgia,24,2,22,17,11,6,0,5
-1,131210115071009.000000000000000,Block 1009, Block Group 1, Census Tract 115.07, Fulton County, Georgia,24,3,21,20,15,0,4,1
-1,131210115111010.000000000000000,Block 1010, Block Group 1, Census Tract 115.11, Fulton County, Georgia,24,11,13,13,13,0,0,0
-1,131210115121014.000000000000000,Block 1014, Block Group 1, Census Tract 115.12, Fulton County, Georgia,24,0,24,24,23,1,0,0
-1,131210115141013.000000000000000,Block 1013, Block Group 1, Census Tract 115.14, Fulton County, Georgia,24,4,20,17,16,0,1,3
-1,131210116452001.000000000000000,Block 2001, Block Group 2, Census Tract 116.45, Fulton County, Georgia,24,8,16,16,3,1,0,0
-1,131210116501000.000000000000000,Block 1000, Block Group 1, Census Tract 116.50, Fulton County, Georgia,24,1,23,21,5,0,2,2
-1,131210116521020.000000000000000,Block 1020, Block Group 1, Census Tract 116.52, Fulton County, Georgia,24,3,21,17,1,5,6,4
-1,131210116551006.000000000000000,Block 1006, Block Group 1, Census Tract 116.55, Fulton County, Georgia,24,2,22,21,21,0,0,1
-1,131210116582001.000000000000000,Block 2001, Block Group 2, Census Tract 116.58, Fulton County, Georgia,24,4,20,14,8,1,0,6
-1,131210116602021.000000000000000,Block 2021, Block Group 2, Census Tract 116.60, Fulton County, Georgia,24,4,20,19,4,5,0,1
-1,131210123001004.000000000000000,Block 1004, Block Group 1, Census Tract 123, Fulton County, Georgia,24,0,24,24,7,16,1,0
-1,131210123001025.000000000000000,Block 1025, Block Group 1, Census Tract 123, Fulton County, Georgia,24,1,23,20,1,19,0,3
-1,131210123002047.000000000000000,Block 2047, Block Group 2, Census Tract 123, Fulton County, Georgia,24,1,23,23,13,10,0,0
-1,131210123003015.000000000000000,Block 3015, Block Group 3, Census Tract 123, Fulton County, Georgia,24,1,23,23,7,14,0,0
-1,131210123004014.000000000000000,Block 4014, Block Group 4, Census Tract 123, Fulton County, Georgia,24,3,21,21,1,20,0,0
-1,131210123004026.000000000000000,Block 4026, Block Group 4, Census Tract 123, Fulton County, Georgia,24,1,23,20,0,20,0,3
-1,131210001005008.000000000000000,Block 5008, Block Group 5, Census Tract 1, Fulton County, Georgia,23,2,21,19,18,1,0,2
-1,131210002012012.000000000000000,Block 2012, Block Group 2, Census Tract 2.01, Fulton County, Georgia,23,1,22,9,2,0,0,13
-1,131210002023010.000000000000000,Block 3010, Block Group 3, Census Tract 2.02, Fulton County, Georgia,23,4,19,19,18,0,0,0
-1,131210007001021.000000000000000,Block 1021, Block Group 1, Census Tract 7, Fulton County, Georgia,23,1,22,22,20,0,0,0
-1,131210011013005.000000000000000,Block 3005, Block Group 3, Census Tract 11.01, Fulton County, Georgia,23,10,13,3,0,3,0,10
-1,131210014002002.000000000000000,Block 2002, Block Group 2, Census Tract 14, Fulton County, Georgia,23,1,22,16,6,7,0,6
-1,131210016002001.000000000000000,Block 2001, Block Group 2, Census Tract 16, Fulton County, Georgia,23,3,20,17,11,3,0,3
-1,131210021001001.000000000000000,Block 1001, Block Group 1, Census Tract 21, Fulton County, Georgia,23,8,15,14,1,7,4,1
-1,131210023003008.000000000000000,Block 3008, Block Group 3, Census Tract 23, Fulton County, Georgia,23,0,23,21,1,18,0,2
-1,131210025002007.000000000000000,Block 2007, Block Group 2, Census Tract 25, Fulton County, Georgia,23,1,22,21,0,21,0,1
-1,131210025003005.000000000000000,Block 3005, Block Group 3, Census Tract 25, Fulton County, Georgia,23,3,20,17,0,17,0,3
-1,131210029001019.000000000000000,Block 1019, Block Group 1, Census Tract 29, Fulton County, Georgia,23,3,20,16,7,8,0,4
-1,131210035002026.000000000000000,Block 2026, Block Group 2, Census Tract 35, Fulton County, Georgia,23,7,16,9,0,9,0,7
-1,131210040003011.000000000000000,Block 3011, Block Group 3, Census Tract 40, Fulton County, Georgia,23,0,23,23,3,20,0,0
-1,131210040003012.000000000000000,Block 3012, Block Group 3, Census Tract 40, Fulton County, Georgia,23,2,21,21,4,17,0,0
-1,131210044002008.000000000000000,Block 2008, Block Group 2, Census Tract 44, Fulton County, Georgia,23,3,20,11,0,11,0,9
-1,131210050002009.000000000000000,Block 2009, Block Group 2, Census Tract 50, Fulton County, Georgia,23,0,23,22,16,3,3,1
-1,131210053002020.000000000000000,Block 2020, Block Group 2, Census Tract 53, Fulton County, Georgia,23,5,18,17,17,0,0,1
-1,131210055011001.000000000000000,Block 1001, Block Group 1, Census Tract 55.01, Fulton County, Georgia,23,1,22,19,17,2,0,3
-1,131210055041004.000000000000000,Block 1004, Block Group 1, Census Tract 55.04, Fulton County, Georgia,23,2,21,20,6,14,0,1
-1,131210055041008.000000000000000,Block 1008, Block Group 1, Census Tract 55.04, Fulton County, Georgia,23,1,22,22,0,21,0,0
-1,131210055041015.000000000000000,Block 1015, Block Group 1, Census Tract 55.04, Fulton County, Georgia,23,1,22,22,0,22,0,0
-1,131210057002003.000000000000000,Block 2003, Block Group 2, Census Tract 57, Fulton County, Georgia,23,2,21,21,0,21,0,0
-1,131210058001032.000000000000000,Block 1032, Block Group 1, Census Tract 58, Fulton County, Georgia,23,1,22,21,0,19,0,1
-1,131210067021039.000000000000000,Block 1039, Block Group 1, Census Tract 67.02, Fulton County, Georgia,23,0,23,22,5,17,0,1
-1,131210067022015.000000000000000,Block 2015, Block Group 2, Census Tract 67.02, Fulton County, Georgia,23,4,19,14,0,12,2,5
-1,131210069003005.000000000000000,Block 3005, Block Group 3, Census Tract 69, Fulton County, Georgia,23,7,16,13,8,5,0,3
-1,131210076042001.000000000000000,Block 2001, Block Group 2, Census Tract 76.04, Fulton County, Georgia,23,3,20,18,5,13,0,2
-1,131210077032010.000000000000000,Block 2010, Block Group 2, Census Tract 77.03, Fulton County, Georgia,23,0,23,18,0,18,0,5
-1,131210077053017.000000000000000,Block 3017, Block Group 3, Census Tract 77.05, Fulton County, Georgia,23,0,23,21,2,19,0,2
-1,131210078101004.000000000000000,Block 1004, Block Group 1, Census Tract 78.10, Fulton County, Georgia,23,0,23,23,0,23,0,0
-1,131210078103009.000000000000000,Block 3009, Block Group 3, Census Tract 78.10, Fulton County, Georgia,23,3,20,17,1,15,1,3
-1,131210079001010.000000000000000,Block 1010, Block Group 1, Census Tract 79, Fulton County, Georgia,23,1,22,21,0,21,0,1
-1,131210079004016.000000000000000,Block 4016, Block Group 4, Census Tract 79, Fulton County, Georgia,23,0,23,23,0,23,0,0
-1,131210083011016.000000000000000,Block 1016, Block Group 1, Census Tract 83.01, Fulton County, Georgia,23,5,18,18,0,18,0,0
-1,131210083021004.000000000000000,Block 1004, Block Group 1, Census Tract 83.02, Fulton County, Georgia,23,0,23,22,0,22,0,1
-1,131210085002013.000000000000000,Block 2013, Block Group 2, Census Tract 85, Fulton County, Georgia,23,0,23,23,5,18,0,0
-1,131210085003034.000000000000000,Block 3034, Block Group 3, Census Tract 85, Fulton County, Georgia,23,2,21,20,1,19,0,1
-1,131210086014003.000000000000000,Block 4003, Block Group 4, Census Tract 86.01, Fulton County, Georgia,23,0,23,21,6,15,0,2
-1,131210087013004.000000000000000,Block 3004, Block Group 3, Census Tract 87.01, Fulton County, Georgia,23,3,20,18,0,17,0,2
-1,131210099001012.000000000000000,Block 1012, Block Group 1, Census Tract 99, Fulton County, Georgia,23,2,21,16,16,0,0,5
-1,131210099002008.000000000000000,Block 2008, Block Group 2, Census Tract 99, Fulton County, Georgia,23,0,23,15,12,0,0,8
-1,131210099003002.000000000000000,Block 3002, Block Group 3, Census Tract 99, Fulton County, Georgia,23,3,20,20,15,2,0,0
-1,131210100062001.000000000000000,Block 2001, Block Group 2, Census Tract 100.06, Fulton County, Georgia,23,3,20,12,5,6,1,8
-1,131210101211010.000000000000000,Block 1010, Block Group 1, Census Tract 101.21, Fulton County, Georgia,23,1,22,22,11,9,2,0
-1,131210101243000.000000000000000,Block 3000, Block Group 3, Census Tract 101.24, Fulton County, Georgia,23,11,12,11,6,1,0,1
-1,131210101251007.000000000000000,Block 1007, Block Group 1, Census Tract 101.25, Fulton County, Georgia,23,7,16,11,10,1,0,5
-1,131210102203013.000000000000000,Block 3013, Block Group 3, Census Tract 102.20, Fulton County, Georgia,23,0,23,17,9,0,0,6
-1,131210103051025.000000000000000,Block 1025, Block Group 1, Census Tract 103.05, Fulton County, Georgia,23,3,20,15,2,13,0,5
-1,131210103073002.000000000000000,Block 3002, Block Group 3, Census Tract 103.07, Fulton County, Georgia,23,0,23,23,0,22,0,0
-1,131210103103014.000000000000000,Block 3014, Block Group 3, Census Tract 103.10, Fulton County, Georgia,23,0,23,23,0,23,0,0
-1,131210103151010.000000000000000,Block 1010, Block Group 1, Census Tract 103.15, Fulton County, Georgia,23,1,22,21,1,20,0,1
-1,131210104021015.000000000000000,Block 1015, Block Group 1, Census Tract 104.02, Fulton County, Georgia,23,0,23,20,20,0,0,3
-1,131210104021051.000000000000000,Block 1051, Block Group 1, Census Tract 104.02, Fulton County, Georgia,23,8,15,15,13,2,0,0
-1,131210104023005.000000000000000,Block 3005, Block Group 3, Census Tract 104.02, Fulton County, Georgia,23,1,22,22,7,15,0,0
-1,131210104023010.000000000000000,Block 3010, Block Group 3, Census Tract 104.02, Fulton County, Georgia,23,0,23,22,22,0,0,1
-1,131210104023023.000000000000000,Block 3023, Block Group 3, Census Tract 104.02, Fulton County, Georgia,23,3,20,20,11,9,0,0
-1,131210105273018.000000000000000,Block 3018, Block Group 3, Census Tract 105.27, Fulton County, Georgia,23,8,15,13,9,3,0,2
-1,131210105292009.000000000000000,Block 2009, Block Group 2, Census Tract 105.29, Fulton County, Georgia,23,10,13,12,4,4,0,1
-1,131210105332009.000000000000000,Block 2009, Block Group 2, Census Tract 105.33, Fulton County, Georgia,23,0,23,20,0,18,0,3
-1,131210105343024.000000000000000,Block 3024, Block Group 3, Census Tract 105.34, Fulton County, Georgia,23,6,17,17,13,4,0,0
-1,131210105392009.000000000000000,Block 2009, Block Group 2, Census Tract 105.39, Fulton County, Georgia,23,1,22,17,2,15,0,5
-1,131210105401040.000000000000000,Block 1040, Block Group 1, Census Tract 105.40, Fulton County, Georgia,23,6,17,16,0,16,0,1
-1,131210106011002.000000000000000,Block 1002, Block Group 1, Census Tract 106.01, Fulton County, Georgia,23,8,15,11,5,5,0,4
-1,131210106011009.000000000000000,Block 1009, Block Group 1, Census Tract 106.01, Fulton County, Georgia,23,0,23,21,13,8,0,2
-1,131210106011021.000000000000000,Block 1021, Block Group 1, Census Tract 106.01, Fulton County, Georgia,23,3,20,17,3,14,0,3
-1,131210106014016.000000000000000,Block 4016, Block Group 4, Census Tract 106.01, Fulton County, Georgia,23,0,23,23,6,15,0,0
-1,131210108013038.000000000000000,Block 3038, Block Group 3, Census Tract 108.01, Fulton County, Georgia,23,1,22,21,13,6,0,1
-1,131210108024004.000000000000000,Block 4004, Block Group 4, Census Tract 108.02, Fulton County, Georgia,23,9,14,12,11,0,1,2
-1,131210110003017.000000000000000,Block 3017, Block Group 3, Census Tract 110, Fulton County, Georgia,23,0,23,22,1,21,0,1
-1,131210111001028.000000000000000,Block 1028, Block Group 1, Census Tract 111, Fulton County, Georgia,23,5,18,14,5,9,0,4
-1,131210111003010.000000000000000,Block 3010, Block Group 3, Census Tract 111, Fulton County, Georgia,23,1,22,21,3,16,0,1
-1,131210112021012.000000000000000,Block 1012, Block Group 1, Census Tract 112.02, Fulton County, Georgia,23,6,17,13,7,5,0,4
-1,131210112023002.000000000000000,Block 3002, Block Group 3, Census Tract 112.02, Fulton County, Georgia,23,1,22,22,5,17,0,0
-1,131210113011013.000000000000000,Block 1013, Block Group 1, Census Tract 113.01, Fulton County, Georgia,23,2,21,20,2,18,0,1
-1,131210114194005.000000000000000,Block 4005, Block Group 4, Census Tract 114.19, Fulton County, Georgia,23,4,19,13,13,0,0,6
-1,131210114221005.000000000000000,Block 1005, Block Group 1, Census Tract 114.22, Fulton County, Georgia,23,5,18,15,4,5,0,3
-1,131210114222000.000000000000000,Block 2000, Block Group 2, Census Tract 114.22, Fulton County, Georgia,23,1,22,19,13,5,1,3
-1,131210114382004.000000000000000,Block 2004, Block Group 2, Census Tract 114.38, Fulton County, Georgia,23,1,22,22,22,0,0,0
-1,131210114383002.000000000000000,Block 3002, Block Group 3, Census Tract 114.38, Fulton County, Georgia,23,6,17,14,4,1,0,3
-1,131210115082008.000000000000000,Block 2008, Block Group 2, Census Tract 115.08, Fulton County, Georgia,23,0,23,22,9,0,1,1
-1,131210115121004.000000000000000,Block 1004, Block Group 1, Census Tract 115.12, Fulton County, Georgia,23,0,23,22,22,0,0,1
-1,131210115122024.000000000000000,Block 2024, Block Group 2, Census Tract 115.12, Fulton County, Georgia,23,0,23,19,18,0,0,4
-1,131210115141000.000000000000000,Block 1000, Block Group 1, Census Tract 115.14, Fulton County, Georgia,23,4,19,16,16,0,0,3
-1,131210116311010.000000000000000,Block 1010, Block Group 1, Census Tract 116.31, Fulton County, Georgia,23,6,17,15,6,0,2,2
-1,131210116462001.000000000000000,Block 2001, Block Group 2, Census Tract 116.46, Fulton County, Georgia,23,7,16,16,13,1,1,0
-1,131210116474008.000000000000000,Block 4008, Block Group 4, Census Tract 116.47, Fulton County, Georgia,23,1,22,22,17,4,0,0
-1,131210116501018.000000000000000,Block 1018, Block Group 1, Census Tract 116.50, Fulton County, Georgia,23,3,20,15,7,0,2,5
-1,131210118021038.000000000000000,Block 1038, Block Group 1, Census Tract 118.02, Fulton County, Georgia,23,1,22,21,1,16,3,1
-1,131210118022014.000000000000000,Block 2014, Block Group 2, Census Tract 118.02, Fulton County, Georgia,23,5,18,18,1,17,0,0
-1,131210120002005.000000000000000,Block 2005, Block Group 2, Census Tract 120, Fulton County, Georgia,23,3,20,15,3,11,0,5
-1,131210123003038.000000000000000,Block 3038, Block Group 3, Census Tract 123, Fulton County, Georgia,23,2,21,21,0,18,0,0
-1,131210001003000.000000000000000,Block 3000, Block Group 3, Census Tract 1, Fulton County, Georgia,22,12,10,8,8,0,0,2
-1,131210001005007.000000000000000,Block 5007, Block Group 5, Census Tract 1, Fulton County, Georgia,22,2,20,19,14,5,0,1
-1,131210005013002.000000000000000,Block 3002, Block Group 3, Census Tract 5.01, Fulton County, Georgia,22,10,12,4,0,0,0,8
-1,131210007001004.000000000000000,Block 1004, Block Group 1, Census Tract 7, Fulton County, Georgia,22,3,19,17,12,3,0,2
-1,131210007001029.000000000000000,Block 1029, Block Group 1, Census Tract 7, Fulton County, Georgia,22,1,21,18,11,5,0,3
-1,131210012061002.000000000000000,Block 1002, Block Group 1, Census Tract 12.06, Fulton County, Georgia,22,4,18,9,0,7,2,9
-1,131210023001006.000000000000000,Block 1006, Block Group 1, Census Tract 23, Fulton County, Georgia,22,1,21,21,1,18,0,0
-1,131210023001016.000000000000000,Block 1016, Block Group 1, Census Tract 23, Fulton County, Georgia,22,0,22,22,0,22,0,0
-1,131210025001013.000000000000000,Block 1013, Block Group 1, Census Tract 25, Fulton County, Georgia,22,4,18,16,0,16,0,2
-1,131210039001001.000000000000000,Block 1001, Block Group 1, Census Tract 39, Fulton County, Georgia,22,1,21,21,0,21,0,0
-1,131210039001016.000000000000000,Block 1016, Block Group 1, Census Tract 39, Fulton County, Georgia,22,0,22,21,5,16,0,1
-1,131210042003020.000000000000000,Block 3020, Block Group 3, Census Tract 42, Fulton County, Georgia,22,0,22,21,4,16,1,1
-1,131210043003004.000000000000000,Block 3004, Block Group 3, Census Tract 43, Fulton County, Georgia,22,1,21,18,1,15,0,3
-1,131210049001019.000000000000000,Block 1019, Block Group 1, Census Tract 49, Fulton County, Georgia,22,1,21,21,5,15,0,0
-1,131210050002004.000000000000000,Block 2004, Block Group 2, Census Tract 50, Fulton County, Georgia,22,9,13,11,9,2,0,2
-1,131210053002014.000000000000000,Block 2014, Block Group 2, Census Tract 53, Fulton County, Georgia,22,0,22,20,16,4,0,2
-1,131210055011014.000000000000000,Block 1014, Block Group 1, Census Tract 55.01, Fulton County, Georgia,22,2,20,18,14,0,4,2
-1,131210055041019.000000000000000,Block 1019, Block Group 1, Census Tract 55.04, Fulton County, Georgia,22,0,22,17,0,17,0,5
-1,131210058001047.000000000000000,Block 1047, Block Group 1, Census Tract 58, Fulton County, Georgia,22,0,22,19,2,15,2,3
-1,131210061001007.000000000000000,Block 1007, Block Group 1, Census Tract 61, Fulton County, Georgia,22,2,20,19,0,18,0,1
-1,131210063002002.000000000000000,Block 2002, Block Group 2, Census Tract 63, Fulton County, Georgia,22,1,21,20,3,17,0,1
-1,131210067012005.000000000000000,Block 2005, Block Group 2, Census Tract 67.01, Fulton County, Georgia,22,3,19,18,2,16,0,1
-1,131210067021031.000000000000000,Block 1031, Block Group 1, Census Tract 67.02, Fulton County, Georgia,22,0,22,22,10,12,0,0
-1,131210067021038.000000000000000,Block 1038, Block Group 1, Census Tract 67.02, Fulton County, Georgia,22,0,22,22,0,22,0,0
-1,131210071002007.000000000000000,Block 2007, Block Group 2, Census Tract 71, Fulton County, Georgia,22,0,22,20,0,20,0,2
-1,131210075001007.000000000000000,Block 1007, Block Group 1, Census Tract 75, Fulton County, Georgia,22,5,17,17,0,13,0,0
-1,131210079004002.000000000000000,Block 4002, Block Group 4, Census Tract 79, Fulton County, Georgia,22,2,20,20,2,18,0,0
-1,131210080004013.000000000000000,Block 4013, Block Group 4, Census Tract 80, Fulton County, Georgia,22,0,22,19,0,19,0,3
-1,131210081031001.000000000000000,Block 1001, Block Group 1, Census Tract 81.03, Fulton County, Georgia,22,8,14,12,0,12,0,2
-1,131210083022010.000000000000000,Block 2010, Block Group 2, Census Tract 83.02, Fulton County, Georgia,22,0,22,22,3,18,1,0
-1,131210085002001.000000000000000,Block 2001, Block Group 2, Census Tract 85, Fulton County, Georgia,22,0,22,20,2,18,0,2
-1,131210087021005.000000000000000,Block 1005, Block Group 1, Census Tract 87.02, Fulton County, Georgia,22,4,18,18,10,8,0,0
-1,131210088022003.000000000000000,Block 2003, Block Group 2, Census Tract 88.02, Fulton County, Georgia,22,1,21,17,10,3,4,4
-1,131210092031001.000000000000000,Block 1001, Block Group 1, Census Tract 92.03, Fulton County, Georgia,22,5,17,15,15,0,0,2
-1,131210092032014.000000000000000,Block 2014, Block Group 2, Census Tract 92.03, Fulton County, Georgia,22,4,18,18,14,3,0,0
-1,131210097003003.000000000000000,Block 3003, Block Group 3, Census Tract 97, Fulton County, Georgia,22,1,21,21,13,0,0,0
-1,131210103052008.000000000000000,Block 2008, Block Group 2, Census Tract 103.05, Fulton County, Georgia,22,0,22,22,0,22,0,0
-1,131210103074001.000000000000000,Block 4001, Block Group 4, Census Tract 103.07, Fulton County, Georgia,22,5,17,17,0,17,0,0
-1,131210103093011.000000000000000,Block 3011, Block Group 3, Census Tract 103.09, Fulton County, Georgia,22,1,21,17,0,14,2,4
-1,131210103131005.000000000000000,Block 1005, Block Group 1, Census Tract 103.13, Fulton County, Georgia,22,1,21,17,5,12,0,4
-1,131210104013006.000000000000000,Block 3006, Block Group 3, Census Tract 104.01, Fulton County, Georgia,22,5,17,17,17,0,0,0
-1,131210104013016.000000000000000,Block 3016, Block Group 3, Census Tract 104.01, Fulton County, Georgia,22,3,19,19,13,6,0,0
-1,131210105081011.000000000000000,Block 1011, Block Group 1, Census Tract 105.08, Fulton County, Georgia,22,1,21,16,0,16,0,5
-1,131210105183003.000000000000000,Block 3003, Block Group 3, Census Tract 105.18, Fulton County, Georgia,22,4,18,17,3,14,0,1
-1,131210105191039.000000000000000,Block 1039, Block Group 1, Census Tract 105.19, Fulton County, Georgia,22,7,15,14,0,12,2,1
-1,131210105201008.000000000000000,Block 1008, Block Group 1, Census Tract 105.20, Fulton County, Georgia,22,3,19,19,0,16,0,0
-1,131210105251000.000000000000000,Block 1000, Block Group 1, Census Tract 105.25, Fulton County, Georgia,22,4,18,16,3,13,0,2
-1,131210105253011.000000000000000,Block 3011, Block Group 3, Census Tract 105.25, Fulton County, Georgia,22,6,16,11,0,8,0,5
-1,131210105261021.000000000000000,Block 1021, Block Group 1, Census Tract 105.26, Fulton County, Georgia,22,1,21,19,9,10,0,2
-1,131210105262008.000000000000000,Block 2008, Block Group 2, Census Tract 105.26, Fulton County, Georgia,22,5,17,15,2,10,0,2
-1,131210105281006.000000000000000,Block 1006, Block Group 1, Census Tract 105.28, Fulton County, Georgia,22,9,13,12,11,0,0,1
-1,131210105283007.000000000000000,Block 3007, Block Group 3, Census Tract 105.28, Fulton County, Georgia,22,3,19,18,7,11,0,1
-1,131210105293028.000000000000000,Block 3028, Block Group 3, Census Tract 105.29, Fulton County, Georgia,22,10,12,7,3,0,2,5
-1,131210105342018.000000000000000,Block 2018, Block Group 2, Census Tract 105.34, Fulton County, Georgia,22,2,20,19,0,17,2,1
-1,131210105382000.000000000000000,Block 2000, Block Group 2, Census Tract 105.38, Fulton County, Georgia,22,3,19,19,3,16,0,0
-1,131210105382006.000000000000000,Block 2006, Block Group 2, Census Tract 105.38, Fulton County, Georgia,22,3,19,14,0,14,0,5
-1,131210106013001.000000000000000,Block 3001, Block Group 3, Census Tract 106.01, Fulton County, Georgia,22,2,20,18,9,9,0,2
-1,131210106014006.000000000000000,Block 4006, Block Group 4, Census Tract 106.01, Fulton County, Georgia,22,1,21,17,12,5,0,4
-1,131210108011006.000000000000000,Block 1006, Block Group 1, Census Tract 108.01, Fulton County, Georgia,22,15,7,3,0,0,0,4
-1,131210108011009.000000000000000,Block 1009, Block Group 1, Census Tract 108.01, Fulton County, Georgia,22,2,20,20,9,11,0,0
-1,131210110003029.000000000000000,Block 3029, Block Group 3, Census Tract 110, Fulton County, Georgia,22,7,15,15,4,11,0,0
-1,131210111002032.000000000000000,Block 2032, Block Group 2, Census Tract 111, Fulton County, Georgia,22,3,19,19,15,3,1,0
-1,131210112021004.000000000000000,Block 1004, Block Group 1, Census Tract 112.02, Fulton County, Georgia,22,5,17,16,2,14,0,1
-1,131210112023011.000000000000000,Block 3011, Block Group 3, Census Tract 112.02, Fulton County, Georgia,22,7,15,15,0,15,0,0
-1,131210112032014.000000000000000,Block 2014, Block Group 2, Census Tract 112.03, Fulton County, Georgia,22,2,20,20,0,20,0,0
-1,131210112032015.000000000000000,Block 2015, Block Group 2, Census Tract 112.03, Fulton County, Georgia,22,1,21,21,12,9,0,0
-1,131210113061030.000000000000000,Block 1030, Block Group 1, Census Tract 113.06, Fulton County, Georgia,22,4,18,14,3,9,1,4
-1,131210113103001.000000000000000,Block 3001, Block Group 3, Census Tract 113.10, Fulton County, Georgia,22,7,15,13,0,13,0,2
-1,131210114163009.000000000000000,Block 3009, Block Group 3, Census Tract 114.16, Fulton County, Georgia,22,7,15,9,9,0,0,6
-1,131210114172004.000000000000000,Block 2004, Block Group 2, Census Tract 114.17, Fulton County, Georgia,22,4,18,17,15,0,0,1
-1,131210114301007.000000000000000,Block 1007, Block Group 1, Census Tract 114.30, Fulton County, Georgia,22,18,4,2,1,1,0,2
-1,131210114311003.000000000000000,Block 1003, Block Group 1, Census Tract 114.31, Fulton County, Georgia,22,17,5,4,2,1,0,1
-1,131210114372008.000000000000000,Block 2008, Block Group 2, Census Tract 114.37, Fulton County, Georgia,22,4,18,16,13,0,3,2
-1,131210114382009.000000000000000,Block 2009, Block Group 2, Census Tract 114.38, Fulton County, Georgia,22,3,19,16,14,2,0,3
-1,131210114382012.000000000000000,Block 2012, Block Group 2, Census Tract 114.38, Fulton County, Georgia,22,4,18,16,12,4,0,2
-1,131210114382013.000000000000000,Block 2013, Block Group 2, Census Tract 114.38, Fulton County, Georgia,22,1,21,20,15,3,0,1
-1,131210114422009.000000000000000,Block 2009, Block Group 2, Census Tract 114.42, Fulton County, Georgia,22,5,17,17,13,3,0,0
-1,131210114451010.000000000000000,Block 1010, Block Group 1, Census Tract 114.45, Fulton County, Georgia,22,11,11,10,9,1,0,1
-1,131210116181006.000000000000000,Block 1006, Block Group 1, Census Tract 116.18, Fulton County, Georgia,22,5,17,16,11,5,0,1
-1,131210116413005.000000000000000,Block 3005, Block Group 3, Census Tract 116.41, Fulton County, Georgia,22,0,22,21,18,0,0,1
-1,131210116443008.000000000000000,Block 3008, Block Group 3, Census Tract 116.44, Fulton County, Georgia,22,2,20,18,11,4,0,2
-1,131210116461001.000000000000000,Block 1001, Block Group 1, Census Tract 116.46, Fulton County, Georgia,22,11,11,7,0,3,0,4
-1,131210116502001.000000000000000,Block 2001, Block Group 2, Census Tract 116.50, Fulton County, Georgia,22,8,14,13,1,5,0,1
-1,131210116601010.000000000000000,Block 1010, Block Group 1, Census Tract 116.60, Fulton County, Georgia,22,1,21,21,9,4,0,0
-1,131210118021037.000000000000000,Block 1037, Block Group 1, Census Tract 118.02, Fulton County, Georgia,22,0,22,22,5,17,0,0
-1,131210118022025.000000000000000,Block 2025, Block Group 2, Census Tract 118.02, Fulton County, Georgia,22,2,20,20,0,20,0,0
-1,131210119011045.000000000000000,Block 1045, Block Group 1, Census Tract 119.01, Fulton County, Georgia,22,1,21,21,2,15,0,0
-1,131210120002020.000000000000000,Block 2020, Block Group 2, Census Tract 120, Fulton County, Georgia,22,0,22,21,3,17,0,1
-1,131210120003015.000000000000000,Block 3015, Block Group 3, Census Tract 120, Fulton County, Georgia,22,0,22,20,0,16,4,2
-1,131210120003031.000000000000000,Block 3031, Block Group 3, Census Tract 120, Fulton County, Georgia,22,0,22,20,0,20,0,2
-1,131210005013011.000000000000000,Block 3011, Block Group 3, Census Tract 5.01, Fulton County, Georgia,21,7,14,3,0,3,0,11
-1,131210011013000.000000000000000,Block 3000, Block Group 3, Census Tract 11.01, Fulton County, Georgia,21,2,19,16,9,5,0,3
-1,131210019022003.000000000000000,Block 2003, Block Group 2, Census Tract 19.02, Fulton County, Georgia,21,6,15,11,6,5,0,4
-1,131210019022004.000000000000000,Block 2004, Block Group 2, Census Tract 19.02, Fulton County, Georgia,21,4,17,16,1,12,0,1
-1,131210023003002.000000000000000,Block 3002, Block Group 3, Census Tract 23, Fulton County, Georgia,21,0,21,20,5,14,0,1
-1,131210029002009.000000000000000,Block 2009, Block Group 2, Census Tract 29, Fulton County, Georgia,21,1,20,16,16,0,0,4
-1,131210031001009.000000000000000,Block 1009, Block Group 1, Census Tract 31, Fulton County, Georgia,21,8,13,12,6,2,3,1
-1,131210039001019.000000000000000,Block 1019, Block Group 1, Census Tract 39, Fulton County, Georgia,21,2,19,18,0,16,2,1
-1,131210044002025.000000000000000,Block 2025, Block Group 2, Census Tract 44, Fulton County, Georgia,21,4,17,17,2,15,0,0
-1,131210055011005.000000000000000,Block 1005, Block Group 1, Census Tract 55.01, Fulton County, Georgia,21,0,21,15,13,2,0,6
-1,131210061003007.000000000000000,Block 3007, Block Group 3, Census Tract 61, Fulton County, Georgia,21,3,18,18,2,16,0,0
-1,131210063001001.000000000000000,Block 1001, Block Group 1, Census Tract 63, Fulton County, Georgia,21,0,21,20,2,18,0,1
-1,131210063002018.000000000000000,Block 2018, Block Group 2, Census Tract 63, Fulton County, Georgia,21,1,20,17,3,14,0,3
-1,131210065003007.000000000000000,Block 3007, Block Group 3, Census Tract 65, Fulton County, Georgia,21,0,21,18,2,16,0,3
-1,131210065004000.000000000000000,Block 4000, Block Group 4, Census Tract 65, Fulton County, Georgia,21,2,19,16,9,7,0,3
-1,131210067021018.000000000000000,Block 1018, Block Group 1, Census Tract 67.02, Fulton County, Georgia,21,6,15,15,4,9,2,0
-1,131210067022002.000000000000000,Block 2002, Block Group 2, Census Tract 67.02, Fulton County, Georgia,21,1,20,19,3,14,0,1
-1,131210070023013.000000000000000,Block 3013, Block Group 3, Census Tract 70.02, Fulton County, Georgia,21,0,21,17,0,17,0,4
-1,131210071001012.000000000000000,Block 1012, Block Group 1, Census Tract 71, Fulton County, Georgia,21,6,15,15,0,14,0,0
-1,131210073022009.000000000000000,Block 2009, Block Group 2, Census Tract 73.02, Fulton County, Georgia,21,2,19,19,0,19,0,0
-1,131210077072001.000000000000000,Block 2001, Block Group 2, Census Tract 77.07, Fulton County, Georgia,21,4,17,11,0,8,2,6
-1,131210078053017.000000000000000,Block 3017, Block Group 3, Census Tract 78.05, Fulton County, Georgia,21,1,20,19,0,19,0,1
-1,131210080001008.000000000000000,Block 1008, Block Group 1, Census Tract 80, Fulton County, Georgia,21,2,19,17,2,14,1,2
-1,131210083011001.000000000000000,Block 1001, Block Group 1, Census Tract 83.01, Fulton County, Georgia,21,2,19,16,0,16,0,3
-1,131210087011023.000000000000000,Block 1023, Block Group 1, Census Tract 87.01, Fulton County, Georgia,21,0,21,17,0,16,1,4
-1,131210088022020.000000000000000,Block 2020, Block Group 2, Census Tract 88.02, Fulton County, Georgia,21,7,14,11,5,6,0,3
-1,131210089052015.000000000000000,Block 2015, Block Group 2, Census Tract 89.05, Fulton County, Georgia,21,2,19,18,11,4,2,1
-1,131210096052000.000000000000000,Block 2000, Block Group 2, Census Tract 96.05, Fulton County, Georgia,21,7,14,12,8,4,0,2
-1,131210096073001.000000000000000,Block 3001, Block Group 3, Census Tract 96.07, Fulton County, Georgia,21,12,9,7,2,5,0,2
-1,131210099003000.000000000000000,Block 3000, Block Group 3, Census Tract 99, Fulton County, Georgia,21,4,17,14,12,1,0,3
-1,131210100031004.000000000000000,Block 1004, Block Group 1, Census Tract 100.03, Fulton County, Georgia,21,1,20,13,13,0,0,7
-1,131210100031008.000000000000000,Block 1008, Block Group 1, Census Tract 100.03, Fulton County, Georgia,21,5,16,11,5,3,0,5
-1,131210101323006.000000000000000,Block 3006, Block Group 3, Census Tract 101.32, Fulton County, Georgia,21,1,20,20,19,0,0,0
-1,131210101332010.000000000000000,Block 2010, Block Group 2, Census Tract 101.33, Fulton County, Georgia,21,9,12,10,9,0,0,2
-1,131210101353001.000000000000000,Block 3001, Block Group 3, Census Tract 101.35, Fulton County, Georgia,21,6,15,10,8,2,0,5
-1,131210102182003.000000000000000,Block 2003, Block Group 2, Census Tract 102.18, Fulton County, Georgia,21,3,18,5,4,1,0,13
-1,131210103051032.000000000000000,Block 1032, Block Group 1, Census Tract 103.05, Fulton County, Georgia,21,0,21,20,0,17,1,1
-1,131210103091002.000000000000000,Block 1002, Block Group 1, Census Tract 103.09, Fulton County, Georgia,21,0,21,21,9,12,0,0
-1,131210103133020.000000000000000,Block 3020, Block Group 3, Census Tract 103.13, Fulton County, Georgia,21,0,21,20,1,18,0,1
-1,131210104011041.000000000000000,Block 1041, Block Group 1, Census Tract 104.01, Fulton County, Georgia,21,5,16,15,12,3,0,1
-1,131210104012015.000000000000000,Block 2015, Block Group 2, Census Tract 104.01, Fulton County, Georgia,21,4,17,15,0,10,5,2
-1,131210104013018.000000000000000,Block 3018, Block Group 3, Census Tract 104.01, Fulton County, Georgia,21,2,19,19,5,11,0,0
-1,131210104013019.000000000000000,Block 3019, Block Group 3, Census Tract 104.01, Fulton County, Georgia,21,0,21,21,18,0,2,0
-1,131210104013046.000000000000000,Block 3046, Block Group 3, Census Tract 104.01, Fulton County, Georgia,21,8,13,11,0,9,0,2
-1,131210104022050.000000000000000,Block 2050, Block Group 2, Census Tract 104.02, Fulton County, Georgia,21,2,19,19,15,4,0,0
-1,131210105172005.000000000000000,Block 2005, Block Group 2, Census Tract 105.17, Fulton County, Georgia,21,10,11,7,0,7,0,4
-1,131210105191007.000000000000000,Block 1007, Block Group 1, Census Tract 105.19, Fulton County, Georgia,21,4,17,17,0,15,0,0
-1,131210105222005.000000000000000,Block 2005, Block Group 2, Census Tract 105.22, Fulton County, Georgia,21,6,15,12,2,10,0,3
-1,131210105262014.000000000000000,Block 2014, Block Group 2, Census Tract 105.26, Fulton County, Georgia,21,2,19,19,6,13,0,0
-1,131210105263006.000000000000000,Block 3006, Block Group 3, Census Tract 105.26, Fulton County, Georgia,21,8,13,12,4,8,0,1
-1,131210105264003.000000000000000,Block 4003, Block Group 4, Census Tract 105.26, Fulton County, Georgia,21,2,19,18,15,3,0,1
-1,131210105343026.000000000000000,Block 3026, Block Group 3, Census Tract 105.34, Fulton County, Georgia,21,6,15,13,7,6,0,2
-1,131210106033000.000000000000000,Block 3000, Block Group 3, Census Tract 106.03, Fulton County, Georgia,21,2,19,19,0,17,2,0
-1,131210108022012.000000000000000,Block 2012, Block Group 2, Census Tract 108.02, Fulton County, Georgia,21,18,3,3,0,1,0,0
-1,131210108024000.000000000000000,Block 4000, Block Group 4, Census Tract 108.02, Fulton County, Georgia,21,5,16,10,6,3,0,6
-1,131210111002024.000000000000000,Block 2024, Block Group 2, Census Tract 111, Fulton County, Georgia,21,4,17,16,6,10,0,1
-1,131210113093007.000000000000000,Block 3007, Block Group 3, Census Tract 113.09, Fulton County, Georgia,21,0,21,21,6,15,0,0
-1,131210114341010.000000000000000,Block 1010, Block Group 1, Census Tract 114.34, Fulton County, Georgia,21,7,14,9,6,0,0,5
-1,131210114363015.000000000000000,Block 3015, Block Group 3, Census Tract 114.36, Fulton County, Georgia,21,6,15,13,9,0,0,2
-1,131210114371015.000000000000000,Block 1015, Block Group 1, Census Tract 114.37, Fulton County, Georgia,21,9,12,9,6,1,0,3
-1,131210114373006.000000000000000,Block 3006, Block Group 3, Census Tract 114.37, Fulton County, Georgia,21,3,18,16,16,0,0,2
-1,131210114451011.000000000000000,Block 1011, Block Group 1, Census Tract 114.45, Fulton County, Georgia,21,1,20,15,14,0,1,5
-1,131210115072001.000000000000000,Block 2001, Block Group 2, Census Tract 115.07, Fulton County, Georgia,21,3,18,13,11,0,0,5
-1,131210115082023.000000000000000,Block 2023, Block Group 2, Census Tract 115.08, Fulton County, Georgia,21,7,14,9,2,2,2,5
-1,131210115101002.000000000000000,Block 1002, Block Group 1, Census Tract 115.10, Fulton County, Georgia,21,6,15,14,7,0,3,1
-1,131210115141005.000000000000000,Block 1005, Block Group 1, Census Tract 115.14, Fulton County, Georgia,21,7,14,12,11,0,0,2
-1,131210116282001.000000000000000,Block 2001, Block Group 2, Census Tract 116.28, Fulton County, Georgia,21,7,14,12,4,7,0,2
-1,131210116471001.000000000000000,Block 1001, Block Group 1, Census Tract 116.47, Fulton County, Georgia,21,10,11,6,0,5,0,5
-1,131210118021033.000000000000000,Block 1033, Block Group 1, Census Tract 118.02, Fulton County, Georgia,21,0,21,21,0,19,1,0
-1,131210118022016.000000000000000,Block 2016, Block Group 2, Census Tract 118.02, Fulton County, Georgia,21,1,20,20,3,14,3,0
-1,131210120003032.000000000000000,Block 3032, Block Group 3, Census Tract 120, Fulton County, Georgia,21,0,21,18,8,10,0,3
-1,131210123001014.000000000000000,Block 1014, Block Group 1, Census Tract 123, Fulton County, Georgia,21,2,19,19,5,14,0,0
-1,131210123003013.000000000000000,Block 3013, Block Group 3, Census Tract 123, Fulton County, Georgia,21,0,21,16,3,13,0,5
-1,131210123003019.000000000000000,Block 3019, Block Group 3, Census Tract 123, Fulton County, Georgia,21,1,20,20,10,10,0,0
-1,131210123003021.000000000000000,Block 3021, Block Group 3, Census Tract 123, Fulton County, Georgia,21,5,16,16,5,10,0,0
-1,131210123004017.000000000000000,Block 4017, Block Group 4, Census Tract 123, Fulton County, Georgia,21,3,18,18,10,8,0,0
-1,131210005013003.000000000000000,Block 3003, Block Group 3, Census Tract 5.01, Fulton County, Georgia,20,1,19,14,13,0,0,5
-1,131210005022033.000000000000000,Block 2033, Block Group 2, Census Tract 5.02, Fulton County, Georgia,20,5,15,14,14,0,0,1
-1,131210006012001.000000000000000,Block 2001, Block Group 2, Census Tract 6.01, Fulton County, Georgia,20,0,20,19,11,1,0,1
-1,131210006023007.000000000000000,Block 3007, Block Group 3, Census Tract 6.02, Fulton County, Georgia,20,7,13,5,0,0,0,8
-1,131210010022012.000000000000000,Block 2012, Block Group 2, Census Tract 10.02, Fulton County, Georgia,20,10,10,5,3,2,0,5
-1,131210017022006.000000000000000,Block 2006, Block Group 2, Census Tract 17.02, Fulton County, Georgia,20,9,11,6,6,0,0,5
-1,131210023001004.000000000000000,Block 1004, Block Group 1, Census Tract 23, Fulton County, Georgia,20,0,20,18,3,15,0,2
-1,131210025002000.000000000000000,Block 2000, Block Group 2, Census Tract 25, Fulton County, Georgia,20,8,12,12,0,12,0,0
-1,131210025003006.000000000000000,Block 3006, Block Group 3, Census Tract 25, Fulton County, Georgia,20,2,18,18,0,16,0,0
-1,131210031002009.000000000000000,Block 2009, Block Group 2, Census Tract 31, Fulton County, Georgia,20,6,14,14,12,0,0,0
-1,131210040003009.000000000000000,Block 3009, Block Group 3, Census Tract 40, Fulton County, Georgia,20,0,20,20,1,19,0,0
-1,131210041002000.000000000000000,Block 2000, Block Group 2, Census Tract 41, Fulton County, Georgia,20,3,17,16,14,2,0,1
-1,131210041003004.000000000000000,Block 3004, Block Group 3, Census Tract 41, Fulton County, Georgia,20,0,20,18,4,14,0,2
-1,131210044002011.000000000000000,Block 2011, Block Group 2, Census Tract 44, Fulton County, Georgia,20,3,17,13,0,12,1,4
-1,131210050002008.000000000000000,Block 2008, Block Group 2, Census Tract 50, Fulton County, Georgia,20,2,18,15,14,0,0,3
-1,131210052003005.000000000000000,Block 3005, Block Group 3, Census Tract 52, Fulton County, Georgia,20,4,16,15,15,0,0,1
-1,131210053002023.000000000000000,Block 2023, Block Group 2, Census Tract 53, Fulton County, Georgia,20,1,19,16,14,1,0,3
-1,131210055011009.000000000000000,Block 1009, Block Group 1, Census Tract 55.01, Fulton County, Georgia,20,3,17,15,1,14,0,2
-1,131210055012018.000000000000000,Block 2018, Block Group 2, Census Tract 55.01, Fulton County, Georgia,20,4,16,14,8,6,0,2
-1,131210063002015.000000000000000,Block 2015, Block Group 2, Census Tract 63, Fulton County, Georgia,20,2,18,18,0,18,0,0
-1,131210064001010.000000000000000,Block 1010, Block Group 1, Census Tract 64, Fulton County, Georgia,20,3,17,14,8,6,0,3
-1,131210067021011.000000000000000,Block 1011, Block Group 1, Census Tract 67.02, Fulton County, Georgia,20,0,20,19,3,13,3,1
-1,131210069003016.000000000000000,Block 3016, Block Group 3, Census Tract 69, Fulton County, Georgia,20,3,17,16,6,10,0,1
-1,131210069003028.000000000000000,Block 3028, Block Group 3, Census Tract 69, Fulton County, Georgia,20,1,19,17,16,0,0,2
-1,131210070011008.000000000000000,Block 1008, Block Group 1, Census Tract 70.01, Fulton County, Georgia,20,5,15,13,0,13,0,2
-1,131210074002001.000000000000000,Block 2001, Block Group 2, Census Tract 74, Fulton County, Georgia,20,6,14,10,0,10,0,4
-1,131210079001002.000000000000000,Block 1002, Block Group 1, Census Tract 79, Fulton County, Georgia,20,0,20,20,0,20,0,0
-1,131210081041005.000000000000000,Block 1005, Block Group 1, Census Tract 81.04, Fulton County, Georgia,20,1,19,17,3,14,0,2
-1,131210083011022.000000000000000,Block 1022, Block Group 1, Census Tract 83.01, Fulton County, Georgia,20,0,20,16,0,16,0,4
-1,131210085001013.000000000000000,Block 1013, Block Group 1, Census Tract 85, Fulton County, Georgia,20,1,19,19,0,19,0,0
-1,131210085002006.000000000000000,Block 2006, Block Group 2, Census Tract 85, Fulton County, Georgia,20,0,20,18,3,15,0,2
-1,131210085003016.000000000000000,Block 3016, Block Group 3, Census Tract 85, Fulton County, Georgia,20,11,9,8,0,7,1,1
-1,131210086014004.000000000000000,Block 4004, Block Group 4, Census Tract 86.01, Fulton County, Georgia,20,0,20,20,0,16,0,0
-1,131210087022022.000000000000000,Block 2022, Block Group 2, Census Tract 87.02, Fulton County, Georgia,20,2,18,11,7,4,0,7
-1,131210089082004.000000000000000,Block 2004, Block Group 2, Census Tract 89.08, Fulton County, Georgia,20,8,12,8,0,0,0,4
-1,131210093011008.000000000000000,Block 1008, Block Group 1, Census Tract 93.01, Fulton County, Georgia,20,5,15,14,14,0,0,1
-1,131210094111002.000000000000000,Block 1002, Block Group 1, Census Tract 94.11, Fulton County, Georgia,20,7,13,12,2,2,0,1
-1,131210096053002.000000000000000,Block 3002, Block Group 3, Census Tract 96.05, Fulton County, Georgia,20,5,15,4,4,0,0,11
-1,131210096061017.000000000000000,Block 1017, Block Group 1, Census Tract 96.06, Fulton County, Georgia,20,4,16,15,15,0,0,1
-1,131210101332011.000000000000000,Block 2011, Block Group 2, Census Tract 101.33, Fulton County, Georgia,20,2,18,9,6,1,2,9
-1,131210103063014.000000000000000,Block 3014, Block Group 3, Census Tract 103.06, Fulton County, Georgia,20,1,19,17,0,17,0,2
-1,131210103082011.000000000000000,Block 2011, Block Group 2, Census Tract 103.08, Fulton County, Georgia,20,5,15,13,6,7,0,2
-1,131210103092013.000000000000000,Block 2013, Block Group 2, Census Tract 103.09, Fulton County, Georgia,20,5,15,8,0,8,0,7
-1,131210103092023.000000000000000,Block 2023, Block Group 2, Census Tract 103.09, Fulton County, Georgia,20,0,20,20,0,19,0,0
-1,131210103111016.000000000000000,Block 1016, Block Group 1, Census Tract 103.11, Fulton County, Georgia,20,4,16,15,1,13,1,1
-1,131210104013031.000000000000000,Block 3031, Block Group 3, Census Tract 104.01, Fulton County, Georgia,20,0,20,18,1,17,0,2
-1,131210104021029.000000000000000,Block 1029, Block Group 1, Census Tract 104.02, Fulton County, Georgia,20,0,20,18,12,6,0,2
-1,131210104022060.000000000000000,Block 2060, Block Group 2, Census Tract 104.02, Fulton County, Georgia,20,7,13,13,3,10,0,0
-1,131210105083002.000000000000000,Block 3002, Block Group 3, Census Tract 105.08, Fulton County, Georgia,20,6,14,12,6,6,0,2
-1,131210105212012.000000000000000,Block 2012, Block Group 2, Census Tract 105.21, Fulton County, Georgia,20,3,17,15,1,14,0,2
-1,131210105231017.000000000000000,Block 1017, Block Group 1, Census Tract 105.23, Fulton County, Georgia,20,8,12,12,10,0,0,0
-1,131210105263001.000000000000000,Block 3001, Block Group 3, Census Tract 105.26, Fulton County, Georgia,20,1,19,16,2,13,0,3
-1,131210105274003.000000000000000,Block 4003, Block Group 4, Census Tract 105.27, Fulton County, Georgia,20,5,15,15,0,14,0,0
-1,131210105302022.000000000000000,Block 2022, Block Group 2, Census Tract 105.30, Fulton County, Georgia,20,0,20,20,0,19,0,0
-1,131210105322002.000000000000000,Block 2002, Block Group 2, Census Tract 105.32, Fulton County, Georgia,20,1,19,16,3,13,0,3
-1,131210105343006.000000000000000,Block 3006, Block Group 3, Census Tract 105.34, Fulton County, Georgia,20,6,14,11,7,4,0,3
-1,131210105351009.000000000000000,Block 1009, Block Group 1, Census Tract 105.35, Fulton County, Georgia,20,2,18,17,11,6,0,1
-1,131210105352017.000000000000000,Block 2017, Block Group 2, Census Tract 105.35, Fulton County, Georgia,20,0,20,20,0,20,0,0
-1,131210105381016.000000000000000,Block 1016, Block Group 1, Census Tract 105.38, Fulton County, Georgia,20,1,19,18,11,7,0,1
-1,131210105401036.000000000000000,Block 1036, Block Group 1, Census Tract 105.40, Fulton County, Georgia,20,1,19,19,3,15,0,0
-1,131210105401038.000000000000000,Block 1038, Block Group 1, Census Tract 105.40, Fulton County, Georgia,20,0,20,18,0,18,0,2
-1,131210106012010.000000000000000,Block 2010, Block Group 2, Census Tract 106.01, Fulton County, Georgia,20,0,20,17,2,15,0,3
-1,131210108011001.000000000000000,Block 1001, Block Group 1, Census Tract 108.01, Fulton County, Georgia,20,12,8,6,6,0,0,2
-1,131210108023009.000000000000000,Block 3009, Block Group 3, Census Tract 108.02, Fulton County, Georgia,20,6,14,14,14,0,0,0
-1,131210108024005.000000000000000,Block 4005, Block Group 4, Census Tract 108.02, Fulton County, Georgia,20,6,14,11,4,7,0,3
-1,131210108024024.000000000000000,Block 4024, Block Group 4, Census Tract 108.02, Fulton County, Georgia,20,9,11,10,9,0,0,1
-1,131210111002007.000000000000000,Block 2007, Block Group 2, Census Tract 111, Fulton County, Georgia,20,2,18,18,8,10,0,0
-1,131210111002026.000000000000000,Block 2026, Block Group 2, Census Tract 111, Fulton County, Georgia,20,2,18,14,2,11,1,4
-1,131210112026019.000000000000000,Block 6019, Block Group 6, Census Tract 112.02, Fulton County, Georgia,20,3,17,17,6,11,0,0
-1,131210113015002.000000000000000,Block 5002, Block Group 5, Census Tract 113.01, Fulton County, Georgia,20,2,18,16,3,13,0,2
-1,131210113016004.000000000000000,Block 6004, Block Group 6, Census Tract 113.01, Fulton County, Georgia,20,5,15,14,0,14,0,1
-1,131210114191002.000000000000000,Block 1002, Block Group 1, Census Tract 114.19, Fulton County, Georgia,20,8,12,9,2,6,0,3
-1,131210114194009.000000000000000,Block 4009, Block Group 4, Census Tract 114.19, Fulton County, Georgia,20,0,20,20,12,3,2,0
-1,131210114261008.000000000000000,Block 1008, Block Group 1, Census Tract 114.26, Fulton County, Georgia,20,12,8,4,1,3,0,4
-1,131210114371010.000000000000000,Block 1010, Block Group 1, Census Tract 114.37, Fulton County, Georgia,20,8,12,9,4,5,0,3
-1,131210115092016.000000000000000,Block 2016, Block Group 2, Census Tract 115.09, Fulton County, Georgia,20,3,17,17,15,1,1,0
-1,131210115122022.000000000000000,Block 2022, Block Group 2, Census Tract 115.12, Fulton County, Georgia,20,2,18,18,18,0,0,0
-1,131210115142015.000000000000000,Block 2015, Block Group 2, Census Tract 115.14, Fulton County, Georgia,20,10,10,6,4,0,0,4
-1,131210116282003.000000000000000,Block 2003, Block Group 2, Census Tract 116.28, Fulton County, Georgia,20,0,20,19,0,3,2,1
-1,131210116411008.000000000000000,Block 1008, Block Group 1, Census Tract 116.41, Fulton County, Georgia,20,7,13,13,0,13,0,0
-1,131210116472016.000000000000000,Block 2016, Block Group 2, Census Tract 116.47, Fulton County, Georgia,20,13,7,2,0,0,1,5
-1,131210116521015.000000000000000,Block 1015, Block Group 1, Census Tract 116.52, Fulton County, Georgia,20,4,16,12,7,2,2,4
-1,131210116552010.000000000000000,Block 2010, Block Group 2, Census Tract 116.55, Fulton County, Georgia,20,1,19,19,15,2,0,0
-1,131210119021001.000000000000000,Block 1001, Block Group 1, Census Tract 119.02, Fulton County, Georgia,20,0,20,20,7,10,2,0
-1,131210120002014.000000000000000,Block 2014, Block Group 2, Census Tract 120, Fulton County, Georgia,20,2,18,13,2,11,0,5
-1,131210120003002.000000000000000,Block 3002, Block Group 3, Census Tract 120, Fulton County, Georgia,20,0,20,18,0,18,0,2
-1,131210123002046.000000000000000,Block 2046, Block Group 2, Census Tract 123, Fulton County, Georgia,20,0,20,17,3,14,0,3
-1,131210001003007.000000000000000,Block 3007, Block Group 3, Census Tract 1, Fulton County, Georgia,19,6,13,10,5,5,0,3
-1,131210005022034.000000000000000,Block 2034, Block Group 2, Census Tract 5.02, Fulton County, Georgia,19,4,15,13,9,2,0,2
-1,131210007001003.000000000000000,Block 1003, Block Group 1, Census Tract 7, Fulton County, Georgia,19,1,18,18,14,4,0,0
-1,131210012062003.000000000000000,Block 2003, Block Group 2, Census Tract 12.06, Fulton County, Georgia,19,9,10,4,0,2,2,6
-1,131210014001006.000000000000000,Block 1006, Block Group 1, Census Tract 14, Fulton County, Georgia,19,1,18,18,18,0,0,0
-1,131210019021020.000000000000000,Block 1020, Block Group 1, Census Tract 19.02, Fulton County, Georgia,19,6,13,5,3,2,0,8
-1,131210023002012.000000000000000,Block 2012, Block Group 2, Census Tract 23, Fulton County, Georgia,19,2,17,17,0,17,0,0
-1,131210025001003.000000000000000,Block 1003, Block Group 1, Census Tract 25, Fulton County, Georgia,19,4,15,11,1,9,1,4
-1,131210030001018.000000000000000,Block 1018, Block Group 1, Census Tract 30, Fulton County, Georgia,19,3,16,16,11,5,0,0
-1,131210031001019.000000000000000,Block 1019, Block Group 1, Census Tract 31, Fulton County, Georgia,19,6,13,10,8,0,0,3
-1,131210038001003.000000000000000,Block 1003, Block Group 1, Census Tract 38, Fulton County, Georgia,19,1,18,13,0,13,0,5
-1,131210039001006.000000000000000,Block 1006, Block Group 1, Census Tract 39, Fulton County, Georgia,19,3,16,14,0,14,0,2
-1,131210039002002.000000000000000,Block 2002, Block Group 2, Census Tract 39, Fulton County, Georgia,19,2,17,14,0,14,0,3
-1,131210040003013.000000000000000,Block 3013, Block Group 3, Census Tract 40, Fulton County, Georgia,19,0,19,19,0,17,0,0
-1,131210042001011.000000000000000,Block 1011, Block Group 1, Census Tract 42, Fulton County, Georgia,19,1,18,13,0,13,0,5
-1,131210050002003.000000000000000,Block 2003, Block Group 2, Census Tract 50, Fulton County, Georgia,19,2,17,12,8,4,0,5
-1,131210052002006.000000000000000,Block 2006, Block Group 2, Census Tract 52, Fulton County, Georgia,19,1,18,17,13,4,0,1
-1,131210053003010.000000000000000,Block 3010, Block Group 3, Census Tract 53, Fulton County, Georgia,19,3,16,12,8,4,0,4
-1,131210055011016.000000000000000,Block 1016, Block Group 1, Census Tract 55.01, Fulton County, Georgia,19,0,19,19,13,4,0,0
-1,131210055041014.000000000000000,Block 1014, Block Group 1, Census Tract 55.04, Fulton County, Georgia,19,1,18,14,5,9,0,4
-1,131210055041026.000000000000000,Block 1026, Block Group 1, Census Tract 55.04, Fulton County, Georgia,19,0,19,19,2,13,3,0
-1,131210058001021.000000000000000,Block 1021, Block Group 1, Census Tract 58, Fulton County, Georgia,19,0,19,16,3,13,0,3
-1,131210060003008.000000000000000,Block 3008, Block Group 3, Census Tract 60, Fulton County, Georgia,19,0,19,13,0,13,0,6
-1,131210063001007.000000000000000,Block 1007, Block Group 1, Census Tract 63, Fulton County, Georgia,19,1,18,18,0,18,0,0
-1,131210063001012.000000000000000,Block 1012, Block Group 1, Census Tract 63, Fulton County, Georgia,19,0,19,19,0,18,1,0
-1,131210063002009.000000000000000,Block 2009, Block Group 2, Census Tract 63, Fulton County, Georgia,19,4,15,15,2,12,1,0
-1,131210066021014.000000000000000,Block 1014, Block Group 1, Census Tract 66.02, Fulton County, Georgia,19,3,16,16,0,16,0,0
-1,131210067021030.000000000000000,Block 1030, Block Group 1, Census Tract 67.02, Fulton County, Georgia,19,2,17,16,0,13,3,1
-1,131210070011003.000000000000000,Block 1003, Block Group 1, Census Tract 70.01, Fulton County, Georgia,19,0,19,18,1,17,0,1
-1,131210075003010.000000000000000,Block 3010, Block Group 3, Census Tract 75, Fulton County, Georgia,19,2,17,16,6,9,0,1
-1,131210079003007.000000000000000,Block 3007, Block Group 3, Census Tract 79, Fulton County, Georgia,19,0,19,15,0,15,0,4
-1,131210079004004.000000000000000,Block 4004, Block Group 4, Census Tract 79, Fulton County, Georgia,19,2,17,17,0,16,0,0
-1,131210080001007.000000000000000,Block 1007, Block Group 1, Census Tract 80, Fulton County, Georgia,19,1,18,14,1,11,1,4
-1,131210081043008.000000000000000,Block 3008, Block Group 3, Census Tract 81.04, Fulton County, Georgia,19,2,17,15,5,10,0,2
-1,131210083021002.000000000000000,Block 1002, Block Group 1, Census Tract 83.02, Fulton County, Georgia,19,1,18,17,3,13,1,1
-1,131210084002007.000000000000000,Block 2007, Block Group 2, Census Tract 84, Fulton County, Georgia,19,0,19,15,0,15,0,4
-1,131210085002017.000000000000000,Block 2017, Block Group 2, Census Tract 85, Fulton County, Georgia,19,1,18,18,7,10,1,0
-1,131210085003005.000000000000000,Block 3005, Block Group 3, Census Tract 85, Fulton County, Georgia,19,1,18,15,0,15,0,3
-1,131210086012001.000000000000000,Block 2001, Block Group 2, Census Tract 86.01, Fulton County, Georgia,19,3,16,16,0,16,0,0
-1,131210086012009.000000000000000,Block 2009, Block Group 2, Census Tract 86.01, Fulton County, Georgia,19,2,17,17,0,15,2,0
-1,131210088021004.000000000000000,Block 1004, Block Group 1, Census Tract 88.02, Fulton County, Georgia,19,2,17,14,14,0,0,3
-1,131210089072002.000000000000000,Block 2002, Block Group 2, Census Tract 89.07, Fulton County, Georgia,19,9,10,8,6,1,1,2
-1,131210093012003.000000000000000,Block 2003, Block Group 2, Census Tract 93.01, Fulton County, Georgia,19,3,16,14,14,0,0,2
-1,131210096061006.000000000000000,Block 1006, Block Group 1, Census Tract 96.06, Fulton County, Georgia,19,5,14,10,7,3,0,4
-1,131210097002005.000000000000000,Block 2005, Block Group 2, Census Tract 97, Fulton County, Georgia,19,1,18,16,14,0,2,2
-1,131210100051017.000000000000000,Block 1017, Block Group 1, Census Tract 100.05, Fulton County, Georgia,19,6,13,13,12,0,0,0
-1,131210101311000.000000000000000,Block 1000, Block Group 1, Census Tract 101.31, Fulton County, Georgia,19,5,14,13,2,9,0,1
-1,131210101312006.000000000000000,Block 2006, Block Group 2, Census Tract 101.31, Fulton County, Georgia,19,5,14,13,10,1,0,1
-1,131210102232005.000000000000000,Block 2005, Block Group 2, Census Tract 102.23, Fulton County, Georgia,19,2,17,13,11,2,0,4
-1,131210103091013.000000000000000,Block 1013, Block Group 1, Census Tract 103.09, Fulton County, Georgia,19,3,16,10,5,5,0,6
-1,131210104011002.000000000000000,Block 1002, Block Group 1, Census Tract 104.01, Fulton County, Georgia,19,2,17,11,4,7,0,6
-1,131210104013000.000000000000000,Block 3000, Block Group 3, Census Tract 104.01, Fulton County, Georgia,19,13,6,6,0,6,0,0
-1,131210104013008.000000000000000,Block 3008, Block Group 3, Census Tract 104.01, Fulton County, Georgia,19,5,14,11,3,8,0,3
-1,131210104021020.000000000000000,Block 1020, Block Group 1, Census Tract 104.02, Fulton County, Georgia,19,0,19,18,18,0,0,1
-1,131210105191040.000000000000000,Block 1040, Block Group 1, Census Tract 105.19, Fulton County, Georgia,19,2,17,14,0,14,0,3
-1,131210105203000.000000000000000,Block 3000, Block Group 3, Census Tract 105.20, Fulton County, Georgia,19,3,16,14,0,12,0,2
-1,131210105203040.000000000000000,Block 3040, Block Group 3, Census Tract 105.20, Fulton County, Georgia,19,1,18,17,12,5,0,1
-1,131210105212004.000000000000000,Block 2004, Block Group 2, Census Tract 105.21, Fulton County, Georgia,19,0,19,18,0,18,0,1
-1,131210105241014.000000000000000,Block 1014, Block Group 1, Census Tract 105.24, Fulton County, Georgia,19,2,17,13,0,13,0,4
-1,131210105281015.000000000000000,Block 1015, Block Group 1, Census Tract 105.28, Fulton County, Georgia,19,6,13,12,6,5,0,1
-1,131210105282005.000000000000000,Block 2005, Block Group 2, Census Tract 105.28, Fulton County, Georgia,19,11,8,4,3,0,1,4
-1,131210105283014.000000000000000,Block 3014, Block Group 3, Census Tract 105.28, Fulton County, Georgia,19,4,15,8,1,3,0,7
-1,131210105302007.000000000000000,Block 2007, Block Group 2, Census Tract 105.30, Fulton County, Georgia,19,5,14,13,5,8,0,1
-1,131210105352005.000000000000000,Block 2005, Block Group 2, Census Tract 105.35, Fulton County, Georgia,19,2,17,15,5,9,0,2
-1,131210105361022.000000000000000,Block 1022, Block Group 1, Census Tract 105.36, Fulton County, Georgia,19,1,18,16,1,15,0,2
-1,131210105391008.000000000000000,Block 1008, Block Group 1, Census Tract 105.39, Fulton County, Georgia,19,3,16,16,7,9,0,0
-1,131210105401001.000000000000000,Block 1001, Block Group 1, Census Tract 105.40, Fulton County, Georgia,19,5,14,13,3,10,0,1
-1,131210108012012.000000000000000,Block 2012, Block Group 2, Census Tract 108.01, Fulton County, Georgia,19,1,18,13,7,5,0,5
-1,131210112026015.000000000000000,Block 6015, Block Group 6, Census Tract 112.02, Fulton County, Georgia,19,5,14,14,2,12,0,0
-1,131210113011007.000000000000000,Block 1007, Block Group 1, Census Tract 113.01, Fulton County, Georgia,19,3,16,15,4,11,0,1
-1,131210113011012.000000000000000,Block 1012, Block Group 1, Census Tract 113.01, Fulton County, Georgia,19,6,13,12,7,5,0,1
-1,131210114162004.000000000000000,Block 2004, Block Group 2, Census Tract 114.16, Fulton County, Georgia,19,2,17,8,5,0,0,9
-1,131210114173006.000000000000000,Block 3006, Block Group 3, Census Tract 114.17, Fulton County, Georgia,19,2,17,10,7,3,0,7
-1,131210115102025.000000000000000,Block 2025, Block Group 2, Census Tract 115.10, Fulton County, Georgia,19,5,14,11,9,0,0,3
-1,131210115142011.000000000000000,Block 2011, Block Group 2, Census Tract 115.14, Fulton County, Georgia,19,3,16,14,9,3,1,2
-1,131210116121004.000000000000000,Block 1004, Block Group 1, Census Tract 116.12, Fulton County, Georgia,19,3,16,16,12,3,0,0
-1,131210116382002.000000000000000,Block 2002, Block Group 2, Census Tract 116.38, Fulton County, Georgia,19,3,16,14,14,0,0,2
-1,131210116411001.000000000000000,Block 1001, Block Group 1, Census Tract 116.41, Fulton County, Georgia,19,3,16,11,6,0,2,5
-1,131210116493006.000000000000000,Block 3006, Block Group 3, Census Tract 116.49, Fulton County, Georgia,19,3,16,13,2,6,0,3
-1,131210116551009.000000000000000,Block 1009, Block Group 1, Census Tract 116.55, Fulton County, Georgia,19,5,14,14,11,3,0,0
-1,131210118022017.000000000000000,Block 2017, Block Group 2, Census Tract 118.02, Fulton County, Georgia,19,1,18,17,3,14,0,1
-1,131210119013014.000000000000000,Block 3014, Block Group 3, Census Tract 119.01, Fulton County, Georgia,19,3,16,12,0,8,2,4
-1,131210123001005.000000000000000,Block 1005, Block Group 1, Census Tract 123, Fulton County, Georgia,19,1,18,18,11,7,0,0
-1,131210123003000.000000000000000,Block 3000, Block Group 3, Census Tract 123, Fulton County, Georgia,19,2,17,11,3,8,0,6
-1,131210123003001.000000000000000,Block 3001, Block Group 3, Census Tract 123, Fulton County, Georgia,19,2,17,17,1,16,0,0
-1,131210123003017.000000000000000,Block 3017, Block Group 3, Census Tract 123, Fulton County, Georgia,19,0,19,18,7,11,0,1
-1,131210007001009.000000000000000,Block 1009, Block Group 1, Census Tract 7, Fulton County, Georgia,18,2,16,12,5,7,0,4
-1,131210024002003.000000000000000,Block 2003, Block Group 2, Census Tract 24, Fulton County, Georgia,18,1,17,17,0,17,0,0
-1,131210025003004.000000000000000,Block 3004, Block Group 3, Census Tract 25, Fulton County, Georgia,18,0,18,17,0,15,0,1
-1,131210026001009.000000000000000,Block 1009, Block Group 1, Census Tract 26, Fulton County, Georgia,18,0,18,16,2,13,0,2
-1,131210029001002.000000000000000,Block 1002, Block Group 1, Census Tract 29, Fulton County, Georgia,18,1,17,17,0,12,5,0
-1,131210031001007.000000000000000,Block 1007, Block Group 1, Census Tract 31, Fulton County, Georgia,18,0,18,15,13,2,0,3
-1,131210031002002.000000000000000,Block 2002, Block Group 2, Census Tract 31, Fulton County, Georgia,18,3,15,14,5,8,0,1
-1,131210035002000.000000000000000,Block 2000, Block Group 2, Census Tract 35, Fulton County, Georgia,18,0,18,18,5,2,0,0
-1,131210039001000.000000000000000,Block 1000, Block Group 1, Census Tract 39, Fulton County, Georgia,18,2,16,16,0,16,0,0
-1,131210055011022.000000000000000,Block 1022, Block Group 1, Census Tract 55.01, Fulton County, Georgia,18,0,18,16,6,8,1,2
-1,131210057002012.000000000000000,Block 2012, Block Group 2, Census Tract 57, Fulton County, Georgia,18,2,16,15,0,15,0,1
-1,131210061003005.000000000000000,Block 3005, Block Group 3, Census Tract 61, Fulton County, Georgia,18,1,17,15,3,12,0,2
-1,131210061003022.000000000000000,Block 3022, Block Group 3, Census Tract 61, Fulton County, Georgia,18,4,14,14,1,9,3,0
-1,131210062002006.000000000000000,Block 2006, Block Group 2, Census Tract 62, Fulton County, Georgia,18,0,18,13,0,11,1,5
-1,131210063002019.000000000000000,Block 2019, Block Group 2, Census Tract 63, Fulton County, Georgia,18,0,18,18,0,18,0,0
-1,131210065003003.000000000000000,Block 3003, Block Group 3, Census Tract 65, Fulton County, Georgia,18,0,18,16,4,12,0,2
-1,131210065003011.000000000000000,Block 3011, Block Group 3, Census Tract 65, Fulton County, Georgia,18,2,16,11,0,11,0,5
-1,131210067021013.000000000000000,Block 1013, Block Group 1, Census Tract 67.02, Fulton County, Georgia,18,3,15,13,1,12,0,2
-1,131210067021041.000000000000000,Block 1041, Block Group 1, Census Tract 67.02, Fulton County, Georgia,18,2,16,16,0,16,0,0
-1,131210067022005.000000000000000,Block 2005, Block Group 2, Census Tract 67.02, Fulton County, Georgia,18,3,15,15,0,15,0,0
-1,131210069003010.000000000000000,Block 3010, Block Group 3, Census Tract 69, Fulton County, Georgia,18,2,16,16,9,3,0,0
-1,131210077112011.000000000000000,Block 2011, Block Group 2, Census Tract 77.11, Fulton County, Georgia,18,1,17,16,0,14,0,1
-1,131210083022000.000000000000000,Block 2000, Block Group 2, Census Tract 83.02, Fulton County, Georgia,18,0,18,16,0,16,0,2
-1,131210085003017.000000000000000,Block 3017, Block Group 3, Census Tract 85, Fulton County, Georgia,18,3,15,14,0,14,0,1
-1,131210087011021.000000000000000,Block 1021, Block Group 1, Census Tract 87.01, Fulton County, Georgia,18,3,15,12,3,9,0,3
-1,131210088011029.000000000000000,Block 1029, Block Group 1, Census Tract 88.01, Fulton County, Georgia,18,9,9,6,3,2,1,3
-1,131210088021031.000000000000000,Block 1031, Block Group 1, Census Tract 88.02, Fulton County, Georgia,18,8,10,7,7,0,0,3
-1,131210089071001.000000000000000,Block 1001, Block Group 1, Census Tract 89.07, Fulton County, Georgia,18,1,17,12,6,3,0,5
-1,131210093011001.000000000000000,Block 1001, Block Group 1, Census Tract 93.01, Fulton County, Georgia,18,0,18,17,17,0,0,1
-1,131210094101006.000000000000000,Block 1006, Block Group 1, Census Tract 94.10, Fulton County, Georgia,18,7,11,6,3,1,1,5
-1,131210095012013.000000000000000,Block 2013, Block Group 2, Census Tract 95.01, Fulton County, Georgia,18,1,17,17,15,1,1,0
-1,131210096073002.000000000000000,Block 3002, Block Group 3, Census Tract 96.07, Fulton County, Georgia,18,2,16,13,6,3,0,3
-1,131210098042003.000000000000000,Block 2003, Block Group 2, Census Tract 98.04, Fulton County, Georgia,18,1,17,15,14,0,0,2
-1,131210101323004.000000000000000,Block 3004, Block Group 3, Census Tract 101.32, Fulton County, Georgia,18,3,15,13,5,8,0,2
-1,131210101351004.000000000000000,Block 1004, Block Group 1, Census Tract 101.35, Fulton County, Georgia,18,5,13,4,3,0,0,9
-1,131210102181001.000000000000000,Block 1001, Block Group 1, Census Tract 102.18, Fulton County, Georgia,18,5,13,10,1,1,5,3
-1,131210102213002.000000000000000,Block 3002, Block Group 3, Census Tract 102.21, Fulton County, Georgia,18,5,13,9,7,0,0,4
-1,131210102233001.000000000000000,Block 3001, Block Group 3, Census Tract 102.23, Fulton County, Georgia,18,0,18,17,8,2,2,1
-1,131210103051004.000000000000000,Block 1004, Block Group 1, Census Tract 103.05, Fulton County, Georgia,18,1,17,17,0,16,0,0
-1,131210103063012.000000000000000,Block 3012, Block Group 3, Census Tract 103.06, Fulton County, Georgia,18,2,16,15,2,10,3,1
-1,131210103151014.000000000000000,Block 1014, Block Group 1, Census Tract 103.15, Fulton County, Georgia,18,1,17,17,4,10,0,0
-1,131210104021010.000000000000000,Block 1010, Block Group 1, Census Tract 104.02, Fulton County, Georgia,18,3,15,15,15,0,0,0
-1,131210105203033.000000000000000,Block 3033, Block Group 3, Census Tract 105.20, Fulton County, Georgia,18,5,13,8,8,0,0,5
-1,131210105222043.000000000000000,Block 2043, Block Group 2, Census Tract 105.22, Fulton County, Georgia,18,6,12,9,0,9,0,3
-1,131210105262010.000000000000000,Block 2010, Block Group 2, Census Tract 105.26, Fulton County, Georgia,18,3,15,14,5,8,1,1
-1,131210105273015.000000000000000,Block 3015, Block Group 3, Census Tract 105.27, Fulton County, Georgia,18,15,3,3,0,3,0,0
-1,131210105281002.000000000000000,Block 1002, Block Group 1, Census Tract 105.28, Fulton County, Georgia,18,14,4,2,0,2,0,2
-1,131210105302028.000000000000000,Block 2028, Block Group 2, Census Tract 105.30, Fulton County, Georgia,18,0,18,15,5,7,2,3
-1,131210105361020.000000000000000,Block 1020, Block Group 1, Census Tract 105.36, Fulton County, Georgia,18,4,14,7,0,4,3,7
-1,131210105362005.000000000000000,Block 2005, Block Group 2, Census Tract 105.36, Fulton County, Georgia,18,2,16,14,0,14,0,2
-1,131210105401026.000000000000000,Block 1026, Block Group 1, Census Tract 105.40, Fulton County, Georgia,18,1,17,17,0,17,0,0
-1,131210105401034.000000000000000,Block 1034, Block Group 1, Census Tract 105.40, Fulton County, Georgia,18,2,16,14,1,13,0,2
-1,131210105402025.000000000000000,Block 2025, Block Group 2, Census Tract 105.40, Fulton County, Georgia,18,7,11,9,4,5,0,2
-1,131210108011008.000000000000000,Block 1008, Block Group 1, Census Tract 108.01, Fulton County, Georgia,18,2,16,16,4,11,1,0
-1,131210108013007.000000000000000,Block 3007, Block Group 3, Census Tract 108.01, Fulton County, Georgia,18,5,13,8,2,2,2,5
-1,131210108024007.000000000000000,Block 4007, Block Group 4, Census Tract 108.02, Fulton County, Georgia,18,2,16,9,0,9,0,7
-1,131210112023031.000000000000000,Block 3031, Block Group 3, Census Tract 112.02, Fulton County, Georgia,18,4,14,8,4,4,0,6
-1,131210112023033.000000000000000,Block 3033, Block Group 3, Census Tract 112.02, Fulton County, Georgia,18,4,14,12,0,11,0,2
-1,131210112024016.000000000000000,Block 4016, Block Group 4, Census Tract 112.02, Fulton County, Georgia,18,3,15,9,3,3,3,6
-1,131210112026000.000000000000000,Block 6000, Block Group 6, Census Tract 112.02, Fulton County, Georgia,18,10,8,4,2,1,1,4
-1,131210112026011.000000000000000,Block 6011, Block Group 6, Census Tract 112.02, Fulton County, Georgia,18,6,12,12,1,10,0,0
-1,131210112032025.000000000000000,Block 2025, Block Group 2, Census Tract 112.03, Fulton County, Georgia,18,0,18,17,2,15,0,1
-1,131210114163000.000000000000000,Block 3000, Block Group 3, Census Tract 114.16, Fulton County, Georgia,18,5,13,4,4,0,0,9
-1,131210114164004.000000000000000,Block 4004, Block Group 4, Census Tract 114.16, Fulton County, Georgia,18,4,14,12,8,2,0,2
-1,131210114171005.000000000000000,Block 1005, Block Group 1, Census Tract 114.17, Fulton County, Georgia,18,1,17,16,14,2,0,1
-1,131210114172011.000000000000000,Block 2011, Block Group 2, Census Tract 114.17, Fulton County, Georgia,18,3,15,11,8,0,2,4
-1,131210114231002.000000000000000,Block 1002, Block Group 1, Census Tract 114.23, Fulton County, Georgia,18,1,17,17,16,1,0,0
-1,131210114382007.000000000000000,Block 2007, Block Group 2, Census Tract 114.38, Fulton County, Georgia,18,3,15,11,6,5,0,4
-1,131210115102011.000000000000000,Block 2011, Block Group 2, Census Tract 115.10, Fulton County, Georgia,18,5,13,13,3,10,0,0
-1,131210115122010.000000000000000,Block 2010, Block Group 2, Census Tract 115.12, Fulton County, Georgia,18,2,16,16,14,0,0,0
-1,131210116291004.000000000000000,Block 1004, Block Group 1, Census Tract 116.29, Fulton County, Georgia,18,4,14,6,3,1,2,8
-1,131210116353021.000000000000000,Block 3021, Block Group 3, Census Tract 116.35, Fulton County, Georgia,18,1,17,16,0,2,0,1
-1,131210116401008.000000000000000,Block 1008, Block Group 1, Census Tract 116.40, Fulton County, Georgia,18,4,14,9,6,0,0,5
-1,131210116402009.000000000000000,Block 2009, Block Group 2, Census Tract 116.40, Fulton County, Georgia,18,0,18,18,17,0,0,0
-1,131210116402011.000000000000000,Block 2011, Block Group 2, Census Tract 116.40, Fulton County, Georgia,18,3,15,13,8,5,0,2
-1,131210116472000.000000000000000,Block 2000, Block Group 2, Census Tract 116.47, Fulton County, Georgia,18,5,13,11,0,2,0,2
-1,131210116521025.000000000000000,Block 1025, Block Group 1, Census Tract 116.52, Fulton County, Georgia,18,9,9,7,5,0,1,2
-1,131210116602004.000000000000000,Block 2004, Block Group 2, Census Tract 116.60, Fulton County, Georgia,18,7,11,11,3,5,0,0
-1,131210118021021.000000000000000,Block 1021, Block Group 1, Census Tract 118.02, Fulton County, Georgia,18,0,18,18,0,18,0,0
-1,131210118022012.000000000000000,Block 2012, Block Group 2, Census Tract 118.02, Fulton County, Georgia,18,0,18,17,4,13,0,1
-1,131210118022023.000000000000000,Block 2023, Block Group 2, Census Tract 118.02, Fulton County, Georgia,18,4,14,12,0,12,0,2
-1,131210119012001.000000000000000,Block 2001, Block Group 2, Census Tract 119.01, Fulton County, Georgia,18,1,17,17,1,16,0,0
-1,131210120002004.000000000000000,Block 2004, Block Group 2, Census Tract 120, Fulton County, Georgia,18,0,18,13,0,13,0,5
-1,131210123003002.000000000000000,Block 3002, Block Group 3, Census Tract 123, Fulton County, Georgia,18,2,16,16,2,14,0,0
-1,131210123003004.000000000000000,Block 3004, Block Group 3, Census Tract 123, Fulton County, Georgia,18,1,17,17,0,17,0,0
-1,131210123003039.000000000000000,Block 3039, Block Group 3, Census Tract 123, Fulton County, Georgia,18,0,18,17,2,15,0,1
-1,131210001003006.000000000000000,Block 3006, Block Group 3, Census Tract 1, Fulton County, Georgia,17,0,17,15,14,0,0,2
-1,131210002012006.000000000000000,Block 2006, Block Group 2, Census Tract 2.01, Fulton County, Georgia,17,3,14,12,12,0,0,2
-1,131210002022010.000000000000000,Block 2010, Block Group 2, Census Tract 2.02, Fulton County, Georgia,17,1,16,5,5,0,0,11
-1,131210012041008.000000000000000,Block 1008, Block Group 1, Census Tract 12.04, Fulton County, Georgia,17,9,8,2,0,0,2,6
-1,131210014001000.000000000000000,Block 1000, Block Group 1, Census Tract 14, Fulton County, Georgia,17,0,17,17,13,1,1,0
-1,131210021001020.000000000000000,Block 1020, Block Group 1, Census Tract 21, Fulton County, Georgia,17,3,14,11,9,2,0,3
-1,131210023001010.000000000000000,Block 1010, Block Group 1, Census Tract 23, Fulton County, Georgia,17,0,17,15,4,11,0,2
-1,131210023002014.000000000000000,Block 2014, Block Group 2, Census Tract 23, Fulton County, Georgia,17,0,17,17,0,17,0,0
-1,131210024002007.000000000000000,Block 2007, Block Group 2, Census Tract 24, Fulton County, Georgia,17,1,16,16,5,11,0,0
-1,131210026001010.000000000000000,Block 1010, Block Group 1, Census Tract 26, Fulton County, Georgia,17,1,16,15,3,9,0,1
-1,131210030001007.000000000000000,Block 1007, Block Group 1, Census Tract 30, Fulton County, Georgia,17,1,16,15,9,3,0,1
-1,131210031001026.000000000000000,Block 1026, Block Group 1, Census Tract 31, Fulton County, Georgia,17,3,14,13,12,1,0,1
-1,131210038001022.000000000000000,Block 1022, Block Group 1, Census Tract 38, Fulton County, Georgia,17,0,17,16,0,16,0,1
-1,131210038002004.000000000000000,Block 2004, Block Group 2, Census Tract 38, Fulton County, Georgia,17,0,17,17,0,17,0,0
-1,131210049001000.000000000000000,Block 1000, Block Group 1, Census Tract 49, Fulton County, Georgia,17,0,17,9,9,0,0,8
-1,131210053002008.000000000000000,Block 2008, Block Group 2, Census Tract 53, Fulton County, Georgia,17,2,15,15,15,0,0,0
-1,131210055042001.000000000000000,Block 2001, Block Group 2, Census Tract 55.04, Fulton County, Georgia,17,3,14,12,2,10,0,2
-1,131210061003023.000000000000000,Block 3023, Block Group 3, Census Tract 61, Fulton County, Georgia,17,0,17,16,2,10,4,1
-1,131210063002000.000000000000000,Block 2000, Block Group 2, Census Tract 63, Fulton County, Georgia,17,2,15,15,2,13,0,0
-1,131210064001003.000000000000000,Block 1003, Block Group 1, Census Tract 64, Fulton County, Georgia,17,4,13,13,4,9,0,0
-1,131210067012004.000000000000000,Block 2004, Block Group 2, Census Tract 67.01, Fulton County, Georgia,17,1,16,12,4,7,0,4
-1,131210067021009.000000000000000,Block 1009, Block Group 1, Census Tract 67.02, Fulton County, Georgia,17,0,17,15,2,13,0,2
-1,131210069003023.000000000000000,Block 3023, Block Group 3, Census Tract 69, Fulton County, Georgia,17,1,16,15,2,8,0,1
-1,131210070022003.000000000000000,Block 2003, Block Group 2, Census Tract 70.02, Fulton County, Georgia,17,5,12,10,0,10,0,2
-1,131210071001005.000000000000000,Block 1005, Block Group 1, Census Tract 71, Fulton County, Georgia,17,1,16,16,0,16,0,0
-1,131210077032015.000000000000000,Block 2015, Block Group 2, Census Tract 77.03, Fulton County, Georgia,17,0,17,16,0,16,0,1
-1,131210077072009.000000000000000,Block 2009, Block Group 2, Census Tract 77.07, Fulton County, Georgia,17,3,14,13,0,13,0,1
-1,131210077103000.000000000000000,Block 3000, Block Group 3, Census Tract 77.10, Fulton County, Georgia,17,7,10,8,1,5,2,2
-1,131210078061005.000000000000000,Block 1005, Block Group 1, Census Tract 78.06, Fulton County, Georgia,17,1,16,15,0,12,3,1
-1,131210078064004.000000000000000,Block 4004, Block Group 4, Census Tract 78.06, Fulton County, Georgia,17,1,16,12,0,8,4,4
-1,131210078091003.000000000000000,Block 1003, Block Group 1, Census Tract 78.09, Fulton County, Georgia,17,0,17,17,4,13,0,0
-1,131210079002003.000000000000000,Block 2003, Block Group 2, Census Tract 79, Fulton County, Georgia,17,1,16,15,2,13,0,1
-1,131210079004018.000000000000000,Block 4018, Block Group 4, Census Tract 79, Fulton County, Georgia,17,0,17,14,0,14,0,3
-1,131210081033000.000000000000000,Block 3000, Block Group 3, Census Tract 81.03, Fulton County, Georgia,17,4,13,10,1,6,1,3
-1,131210081043014.000000000000000,Block 3014, Block Group 3, Census Tract 81.04, Fulton County, Georgia,17,3,14,14,0,14,0,0
-1,131210083013004.000000000000000,Block 3004, Block Group 3, Census Tract 83.01, Fulton County, Georgia,17,2,15,15,0,15,0,0
-1,131210083022017.000000000000000,Block 2017, Block Group 2, Census Tract 83.02, Fulton County, Georgia,17,0,17,17,0,17,0,0
-1,131210086011004.000000000000000,Block 1004, Block Group 1, Census Tract 86.01, Fulton County, Georgia,17,0,17,16,0,13,0,1
-1,131210087021013.000000000000000,Block 1013, Block Group 1, Census Tract 87.02, Fulton County, Georgia,17,6,11,10,6,4,0,1
-1,131210088011003.000000000000000,Block 1003, Block Group 1, Census Tract 88.01, Fulton County, Georgia,17,2,15,14,7,7,0,1
-1,131210088011028.000000000000000,Block 1028, Block Group 1, Census Tract 88.01, Fulton County, Georgia,17,5,12,11,11,0,0,1
-1,131210088011032.000000000000000,Block 1032, Block Group 1, Census Tract 88.01, Fulton County, Georgia,17,4,13,13,7,6,0,0
-1,131210088021033.000000000000000,Block 1033, Block Group 1, Census Tract 88.02, Fulton County, Georgia,17,1,16,12,9,3,0,4
-1,131210091052001.000000000000000,Block 2001, Block Group 2, Census Tract 91.05, Fulton County, Georgia,17,3,14,12,12,0,0,2
-1,131210096012000.000000000000000,Block 2000, Block Group 2, Census Tract 96.01, Fulton County, Georgia,17,8,9,8,6,1,0,1
-1,131210101062001.000000000000000,Block 2001, Block Group 2, Census Tract 101.06, Fulton County, Georgia,17,8,9,3,2,1,0,6
-1,131210101064003.000000000000000,Block 4003, Block Group 4, Census Tract 101.06, Fulton County, Georgia,17,0,17,11,7,0,3,6
-1,131210101064004.000000000000000,Block 4004, Block Group 4, Census Tract 101.06, Fulton County, Georgia,17,4,13,5,3,0,1,8
-1,131210101072002.000000000000000,Block 2002, Block Group 2, Census Tract 101.07, Fulton County, Georgia,17,4,13,5,4,1,0,8
-1,131210101332000.000000000000000,Block 2000, Block Group 2, Census Tract 101.33, Fulton County, Georgia,17,0,17,16,6,7,2,1
-1,131210101362005.000000000000000,Block 2005, Block Group 2, Census Tract 101.36, Fulton County, Georgia,17,11,6,3,1,2,0,3
-1,131210102202006.000000000000000,Block 2006, Block Group 2, Census Tract 102.20, Fulton County, Georgia,17,11,6,5,2,0,0,1
-1,131210102213000.000000000000000,Block 3000, Block Group 3, Census Tract 102.21, Fulton County, Georgia,17,4,13,13,10,0,1,0
-1,131210104021011.000000000000000,Block 1011, Block Group 1, Census Tract 104.02, Fulton County, Georgia,17,0,17,17,17,0,0,0
-1,131210105273005.000000000000000,Block 3005, Block Group 3, Census Tract 105.27, Fulton County, Georgia,17,1,16,12,6,6,0,4
-1,131210105281007.000000000000000,Block 1007, Block Group 1, Census Tract 105.28, Fulton County, Georgia,17,3,14,12,1,10,0,2
-1,131210105301002.000000000000000,Block 1002, Block Group 1, Census Tract 105.30, Fulton County, Georgia,17,0,17,14,7,7,0,3
-1,131210105372010.000000000000000,Block 2010, Block Group 2, Census Tract 105.37, Fulton County, Georgia,17,5,12,10,7,3,0,2
-1,131210105381005.000000000000000,Block 1005, Block Group 1, Census Tract 105.38, Fulton County, Georgia,17,1,16,15,6,8,1,1
-1,131210106034010.000000000000000,Block 4010, Block Group 4, Census Tract 106.03, Fulton County, Georgia,17,1,16,15,1,14,0,1
-1,131210108013033.000000000000000,Block 3033, Block Group 3, Census Tract 108.01, Fulton County, Georgia,17,2,15,13,13,0,0,2
-1,131210108024002.000000000000000,Block 4002, Block Group 4, Census Tract 108.02, Fulton County, Georgia,17,10,7,7,1,4,0,0
-1,131210110002011.000000000000000,Block 2011, Block Group 2, Census Tract 110, Fulton County, Georgia,17,8,9,9,0,9,0,0
-1,131210110003009.000000000000000,Block 3009, Block Group 3, Census Tract 110, Fulton County, Georgia,17,5,12,10,2,6,0,2
-1,131210110003013.000000000000000,Block 3013, Block Group 3, Census Tract 110, Fulton County, Georgia,17,8,9,8,0,8,0,1
-1,131210112023021.000000000000000,Block 3021, Block Group 3, Census Tract 112.02, Fulton County, Georgia,17,7,10,9,0,9,0,1
-1,131210112041005.000000000000000,Block 1005, Block Group 1, Census Tract 112.04, Fulton County, Georgia,17,2,15,14,3,11,0,1
-1,131210113072000.000000000000000,Block 2000, Block Group 2, Census Tract 113.07, Fulton County, Georgia,17,0,17,16,1,14,0,1
-1,131210113105008.000000000000000,Block 5008, Block Group 5, Census Tract 113.10, Fulton County, Georgia,17,2,15,15,4,9,0,0
-1,131210114172005.000000000000000,Block 2005, Block Group 2, Census Tract 114.17, Fulton County, Georgia,17,0,17,16,16,0,0,1
-1,131210114192013.000000000000000,Block 2013, Block Group 2, Census Tract 114.19, Fulton County, Georgia,17,3,14,14,9,3,2,0
-1,131210114371019.000000000000000,Block 1019, Block Group 1, Census Tract 114.37, Fulton County, Georgia,17,8,9,2,1,0,0,7
-1,131210115052001.000000000000000,Block 2001, Block Group 2, Census Tract 115.05, Fulton County, Georgia,17,6,11,9,6,3,0,2
-1,131210115101005.000000000000000,Block 1005, Block Group 1, Census Tract 115.10, Fulton County, Georgia,17,0,17,14,12,2,0,3
-1,131210116361003.000000000000000,Block 1003, Block Group 1, Census Tract 116.36, Fulton County, Georgia,17,10,7,0,0,0,0,7
-1,131210116391024.000000000000000,Block 1024, Block Group 1, Census Tract 116.39, Fulton County, Georgia,17,4,13,12,0,7,3,1
-1,131210116474011.000000000000000,Block 4011, Block Group 4, Census Tract 116.47, Fulton County, Georgia,17,1,16,12,12,0,0,4
-1,131210116542000.000000000000000,Block 2000, Block Group 2, Census Tract 116.54, Fulton County, Georgia,17,2,15,6,1,2,0,9
-1,131210118021022.000000000000000,Block 1022, Block Group 1, Census Tract 118.02, Fulton County, Georgia,17,2,15,15,0,15,0,0
-1,131210118021040.000000000000000,Block 1040, Block Group 1, Census Tract 118.02, Fulton County, Georgia,17,0,17,16,6,10,0,1
-1,131210119013009.000000000000000,Block 3009, Block Group 3, Census Tract 119.01, Fulton County, Georgia,17,4,13,13,0,13,0,0
-1,131210120002010.000000000000000,Block 2010, Block Group 2, Census Tract 120, Fulton County, Georgia,17,0,17,17,0,17,0,0
-1,131210120003036.000000000000000,Block 3036, Block Group 3, Census Tract 120, Fulton County, Georgia,17,0,17,15,0,15,0,2
-1,131210123003020.000000000000000,Block 3020, Block Group 3, Census Tract 123, Fulton County, Georgia,17,1,16,15,7,8,0,1
-1,131210005022038.000000000000000,Block 2038, Block Group 2, Census Tract 5.02, Fulton County, Georgia,16,0,16,15,12,2,0,1
-1,131210011022004.000000000000000,Block 2004, Block Group 2, Census Tract 11.02, Fulton County, Georgia,16,9,7,7,2,2,0,0
-1,131210011022009.000000000000000,Block 2009, Block Group 2, Census Tract 11.02, Fulton County, Georgia,16,4,12,5,1,3,0,7
-1,131210017011008.000000000000000,Block 1008, Block Group 1, Census Tract 17.01, Fulton County, Georgia,16,5,11,11,5,3,3,0
-1,131210023002000.000000000000000,Block 2000, Block Group 2, Census Tract 23, Fulton County, Georgia,16,0,16,14,0,14,0,2
-1,131210023002002.000000000000000,Block 2002, Block Group 2, Census Tract 23, Fulton County, Georgia,16,0,16,16,0,16,0,0
-1,131210028022005.000000000000000,Block 2005, Block Group 2, Census Tract 28.02, Fulton County, Georgia,16,3,13,7,0,5,2,6
-1,131210029001023.000000000000000,Block 1023, Block Group 1, Census Tract 29, Fulton County, Georgia,16,4,12,11,5,6,0,1
-1,131210030001014.000000000000000,Block 1014, Block Group 1, Census Tract 30, Fulton County, Georgia,16,3,13,5,4,1,0,8
-1,131210036001002.000000000000000,Block 1002, Block Group 1, Census Tract 36, Fulton County, Georgia,16,4,12,8,0,5,0,4
-1,131210039002013.000000000000000,Block 2013, Block Group 2, Census Tract 39, Fulton County, Georgia,16,0,16,16,2,14,0,0
-1,131210042003003.000000000000000,Block 3003, Block Group 3, Census Tract 42, Fulton County, Georgia,16,4,12,10,3,2,2,2
-1,131210058001025.000000000000000,Block 1025, Block Group 1, Census Tract 58, Fulton County, Georgia,16,4,12,11,3,8,0,1
-1,131210067021002.000000000000000,Block 1002, Block Group 1, Census Tract 67.02, Fulton County, Georgia,16,0,16,16,4,11,0,0
-1,131210067021037.000000000000000,Block 1037, Block Group 1, Census Tract 67.02, Fulton County, Georgia,16,3,13,12,0,12,0,1
-1,131210067021040.000000000000000,Block 1040, Block Group 1, Census Tract 67.02, Fulton County, Georgia,16,0,16,14,3,11,0,2
-1,131210069003014.000000000000000,Block 3014, Block Group 3, Census Tract 69, Fulton County, Georgia,16,4,12,12,3,7,0,0
-1,131210071001017.000000000000000,Block 1017, Block Group 1, Census Tract 71, Fulton County, Georgia,16,2,14,13,0,11,0,1
-1,131210071002008.000000000000000,Block 2008, Block Group 2, Census Tract 71, Fulton County, Georgia,16,5,11,10,0,9,0,1
-1,131210073022003.000000000000000,Block 2003, Block Group 2, Census Tract 73.02, Fulton County, Georgia,16,1,15,15,2,13,0,0
-1,131210075003020.000000000000000,Block 3020, Block Group 3, Census Tract 75, Fulton County, Georgia,16,1,15,15,2,10,0,0
-1,131210077053019.000000000000000,Block 3019, Block Group 3, Census Tract 77.05, Fulton County, Georgia,16,1,15,15,0,15,0,0
-1,131210077103011.000000000000000,Block 3011, Block Group 3, Census Tract 77.10, Fulton County, Georgia,16,2,14,14,1,13,0,0
-1,131210078093003.000000000000000,Block 3003, Block Group 3, Census Tract 78.09, Fulton County, Georgia,16,0,16,15,4,9,2,1
-1,131210081043006.000000000000000,Block 3006, Block Group 3, Census Tract 81.04, Fulton County, Georgia,16,1,15,15,0,15,0,0
-1,131210083021006.000000000000000,Block 1006, Block Group 1, Census Tract 83.02, Fulton County, Georgia,16,1,15,9,0,8,1,6
-1,131210083022012.000000000000000,Block 2012, Block Group 2, Census Tract 83.02, Fulton County, Georgia,16,0,16,15,0,15,0,1
-1,131210085002026.000000000000000,Block 2026, Block Group 2, Census Tract 85, Fulton County, Georgia,16,0,16,16,0,16,0,0
-1,131210085003018.000000000000000,Block 3018, Block Group 3, Census Tract 85, Fulton County, Georgia,16,1,15,12,0,12,0,3
-1,131210087011018.000000000000000,Block 1018, Block Group 1, Census Tract 87.01, Fulton County, Georgia,16,0,16,15,4,11,0,1
-1,131210087021007.000000000000000,Block 1007, Block Group 1, Census Tract 87.02, Fulton County, Georgia,16,4,12,8,0,0,0,4
-1,131210087021012.000000000000000,Block 1012, Block Group 1, Census Tract 87.02, Fulton County, Georgia,16,0,16,16,2,14,0,0
-1,131210088021042.000000000000000,Block 1042, Block Group 1, Census Tract 88.02, Fulton County, Georgia,16,3,13,11,11,0,0,2
-1,131210088022018.000000000000000,Block 2018, Block Group 2, Census Tract 88.02, Fulton County, Georgia,16,3,13,12,3,9,0,1
-1,131210089053000.000000000000000,Block 3000, Block Group 3, Census Tract 89.05, Fulton County, Georgia,16,2,14,13,8,2,0,1
-1,131210089091012.000000000000000,Block 1012, Block Group 1, Census Tract 89.09, Fulton County, Georgia,16,4,12,12,8,0,4,0
-1,131210090022014.000000000000000,Block 2014, Block Group 2, Census Tract 90.02, Fulton County, Georgia,16,0,16,14,14,0,0,2
-1,131210091042003.000000000000000,Block 2003, Block Group 2, Census Tract 91.04, Fulton County, Georgia,16,3,13,10,8,0,0,3
-1,131210092031002.000000000000000,Block 1002, Block Group 1, Census Tract 92.03, Fulton County, Georgia,16,3,13,10,10,0,0,3
-1,131210095013002.000000000000000,Block 3002, Block Group 3, Census Tract 95.01, Fulton County, Georgia,16,0,16,14,12,0,2,2
-1,131210097001009.000000000000000,Block 1009, Block Group 1, Census Tract 97, Fulton County, Georgia,16,4,12,8,7,0,0,4
-1,131210097002012.000000000000000,Block 2012, Block Group 2, Census Tract 97, Fulton County, Georgia,16,1,15,14,9,2,0,1
-1,131210100042008.000000000000000,Block 2008, Block Group 2, Census Tract 100.04, Fulton County, Georgia,16,0,16,16,15,1,0,0
-1,131210101063004.000000000000000,Block 3004, Block Group 3, Census Tract 101.06, Fulton County, Georgia,16,0,16,14,6,3,1,2
-1,131210102111005.000000000000000,Block 1005, Block Group 1, Census Tract 102.11, Fulton County, Georgia,16,3,13,13,8,0,0,0
-1,131210102114013.000000000000000,Block 4013, Block Group 4, Census Tract 102.11, Fulton County, Georgia,16,1,15,15,14,0,0,0
-1,131210103063004.000000000000000,Block 3004, Block Group 3, Census Tract 103.06, Fulton County, Georgia,16,0,16,15,9,5,1,1
-1,131210103082024.000000000000000,Block 2024, Block Group 2, Census Tract 103.08, Fulton County, Georgia,16,0,16,15,9,6,0,1
-1,131210103091038.000000000000000,Block 1038, Block Group 1, Census Tract 103.09, Fulton County, Georgia,16,4,12,7,7,0,0,5
-1,131210103101003.000000000000000,Block 1003, Block Group 1, Census Tract 103.10, Fulton County, Georgia,16,4,12,11,9,2,0,1
-1,131210104011028.000000000000000,Block 1028, Block Group 1, Census Tract 104.01, Fulton County, Georgia,16,1,15,13,2,11,0,2
-1,131210104012000.000000000000000,Block 2000, Block Group 2, Census Tract 104.01, Fulton County, Georgia,16,0,16,14,11,2,0,2
-1,131210104012012.000000000000000,Block 2012, Block Group 2, Census Tract 104.01, Fulton County, Georgia,16,0,16,14,10,4,0,2
-1,131210104022027.000000000000000,Block 2027, Block Group 2, Census Tract 104.02, Fulton County, Georgia,16,2,14,13,3,10,0,1
-1,131210104022030.000000000000000,Block 2030, Block Group 2, Census Tract 104.02, Fulton County, Georgia,16,0,16,16,6,10,0,0
-1,131210104023061.000000000000000,Block 3061, Block Group 3, Census Tract 104.02, Fulton County, Georgia,16,3,13,12,12,0,0,1
-1,131210105081010.000000000000000,Block 1010, Block Group 1, Census Tract 105.08, Fulton County, Georgia,16,0,16,15,6,9,0,1
-1,131210105241003.000000000000000,Block 1003, Block Group 1, Census Tract 105.24, Fulton County, Georgia,16,1,15,12,8,4,0,3
-1,131210105251007.000000000000000,Block 1007, Block Group 1, Census Tract 105.25, Fulton County, Georgia,16,1,15,15,1,14,0,0
-1,131210105274011.000000000000000,Block 4011, Block Group 4, Census Tract 105.27, Fulton County, Georgia,16,1,15,13,3,9,0,2
-1,131210105293027.000000000000000,Block 3027, Block Group 3, Census Tract 105.29, Fulton County, Georgia,16,1,15,15,0,15,0,0
-1,131210105301022.000000000000000,Block 1022, Block Group 1, Census Tract 105.30, Fulton County, Georgia,16,0,16,14,2,10,0,2
-1,131210105392004.000000000000000,Block 2004, Block Group 2, Census Tract 105.39, Fulton County, Georgia,16,1,15,14,2,12,0,1
-1,131210105392024.000000000000000,Block 2024, Block Group 2, Census Tract 105.39, Fulton County, Georgia,16,0,16,15,2,11,0,1
-1,131210105401033.000000000000000,Block 1033, Block Group 1, Census Tract 105.40, Fulton County, Georgia,16,3,13,12,0,12,0,1
-1,131210105402024.000000000000000,Block 2024, Block Group 2, Census Tract 105.40, Fulton County, Georgia,16,0,16,12,5,2,0,4
-1,131210105402027.000000000000000,Block 2027, Block Group 2, Census Tract 105.40, Fulton County, Georgia,16,6,10,9,8,0,1,1
-1,131210106043018.000000000000000,Block 3018, Block Group 3, Census Tract 106.04, Fulton County, Georgia,16,1,15,15,0,15,0,0
-1,131210108011013.000000000000000,Block 1013, Block Group 1, Census Tract 108.01, Fulton County, Georgia,16,14,2,2,2,0,0,0
-1,131210108013018.000000000000000,Block 3018, Block Group 3, Census Tract 108.01, Fulton County, Georgia,16,1,15,13,8,3,2,2
-1,131210110001012.000000000000000,Block 1012, Block Group 1, Census Tract 110, Fulton County, Georgia,16,13,3,3,0,3,0,0
-1,131210110003020.000000000000000,Block 3020, Block Group 3, Census Tract 110, Fulton County, Georgia,16,1,15,15,1,14,0,0
-1,131210111001015.000000000000000,Block 1015, Block Group 1, Census Tract 111, Fulton County, Georgia,16,3,13,13,6,1,1,0
-1,131210111002022.000000000000000,Block 2022, Block Group 2, Census Tract 111, Fulton County, Georgia,16,0,16,15,0,15,0,1
-1,131210112023024.000000000000000,Block 3024, Block Group 3, Census Tract 112.02, Fulton County, Georgia,16,5,11,9,0,9,0,2
-1,131210113061001.000000000000000,Block 1001, Block Group 1, Census Tract 113.06, Fulton County, Georgia,16,2,14,10,0,4,6,4
-1,131210113071000.000000000000000,Block 1000, Block Group 1, Census Tract 113.07, Fulton County, Georgia,16,5,11,6,0,3,2,5
-1,131210114322006.000000000000000,Block 2006, Block Group 2, Census Tract 114.32, Fulton County, Georgia,16,4,12,4,1,2,0,8
-1,131210114422016.000000000000000,Block 2016, Block Group 2, Census Tract 114.42, Fulton County, Georgia,16,2,14,12,6,6,0,2
-1,131210115121013.000000000000000,Block 1013, Block Group 1, Census Tract 115.12, Fulton County, Georgia,16,1,15,15,15,0,0,0
-1,131210115122008.000000000000000,Block 2008, Block Group 2, Census Tract 115.12, Fulton County, Georgia,16,0,16,16,16,0,0,0
-1,131210116382003.000000000000000,Block 2003, Block Group 2, Census Tract 116.38, Fulton County, Georgia,16,0,16,10,5,4,0,6
-1,131210116412003.000000000000000,Block 2003, Block Group 2, Census Tract 116.41, Fulton County, Georgia,16,10,6,2,2,0,0,4
-1,131210116421001.000000000000000,Block 1001, Block Group 1, Census Tract 116.42, Fulton County, Georgia,16,11,5,2,0,2,0,3
-1,131210116521000.000000000000000,Block 1000, Block Group 1, Census Tract 116.52, Fulton County, Georgia,16,4,12,9,2,6,0,3
-1,131210116531001.000000000000000,Block 1001, Block Group 1, Census Tract 116.53, Fulton County, Georgia,16,1,15,12,1,2,0,3
-1,131210116531002.000000000000000,Block 1002, Block Group 1, Census Tract 116.53, Fulton County, Georgia,16,5,11,9,1,2,1,2
-1,131210116551008.000000000000000,Block 1008, Block Group 1, Census Tract 116.55, Fulton County, Georgia,16,0,16,11,8,1,0,5
-1,131210118021023.000000000000000,Block 1023, Block Group 1, Census Tract 118.02, Fulton County, Georgia,16,4,12,12,3,9,0,0
-1,131210123001003.000000000000000,Block 1003, Block Group 1, Census Tract 123, Fulton County, Georgia,16,0,16,16,12,4,0,0
-1,131210123001013.000000000000000,Block 1013, Block Group 1, Census Tract 123, Fulton County, Georgia,16,0,16,14,1,13,0,2
-1,131210123002036.000000000000000,Block 2036, Block Group 2, Census Tract 123, Fulton County, Georgia,16,3,13,13,10,2,0,0
-1,131210004001006.000000000000000,Block 1006, Block Group 1, Census Tract 4, Fulton County, Georgia,15,0,15,15,3,12,0,0
-1,131210004001012.000000000000000,Block 1012, Block Group 1, Census Tract 4, Fulton County, Georgia,15,1,14,7,5,1,0,7
-1,131210004001014.000000000000000,Block 1014, Block Group 1, Census Tract 4, Fulton County, Georgia,15,4,11,3,2,0,1,8
-1,131210006013011.000000000000000,Block 3011, Block Group 3, Census Tract 6.01, Fulton County, Georgia,15,5,10,10,9,0,0,0
-1,131210012051002.000000000000000,Block 1002, Block Group 1, Census Tract 12.05, Fulton County, Georgia,15,4,11,8,3,4,0,3
-1,131210023003010.000000000000000,Block 3010, Block Group 3, Census Tract 23, Fulton County, Georgia,15,0,15,14,0,14,0,1
-1,131210024002013.000000000000000,Block 2013, Block Group 2, Census Tract 24, Fulton County, Georgia,15,1,14,14,5,9,0,0
-1,131210025002014.000000000000000,Block 2014, Block Group 2, Census Tract 25, Fulton County, Georgia,15,5,10,9,0,8,0,1
-1,131210031002008.000000000000000,Block 2008, Block Group 2, Census Tract 31, Fulton County, Georgia,15,4,11,10,9,0,1,1
-1,131210038001016.000000000000000,Block 1016, Block Group 1, Census Tract 38, Fulton County, Georgia,15,1,14,11,0,11,0,3
-1,131210039001015.000000000000000,Block 1015, Block Group 1, Census Tract 39, Fulton County, Georgia,15,0,15,13,1,12,0,2
-1,131210040001000.000000000000000,Block 1000, Block Group 1, Census Tract 40, Fulton County, Georgia,15,1,14,11,4,7,0,3
-1,131210043003002.000000000000000,Block 3002, Block Group 3, Census Tract 43, Fulton County, Georgia,15,4,11,9,2,7,0,2
-1,131210050002002.000000000000000,Block 2002, Block Group 2, Census Tract 50, Fulton County, Georgia,15,5,10,8,6,0,0,2
-1,131210053002011.000000000000000,Block 2011, Block Group 2, Census Tract 53, Fulton County, Georgia,15,0,15,14,14,0,0,1
-1,131210053002019.000000000000000,Block 2019, Block Group 2, Census Tract 53, Fulton County, Georgia,15,0,15,13,10,1,2,2
-1,131210057001010.000000000000000,Block 1010, Block Group 1, Census Tract 57, Fulton County, Georgia,15,0,15,14,0,14,0,1
-1,131210061002008.000000000000000,Block 2008, Block Group 2, Census Tract 61, Fulton County, Georgia,15,0,15,14,0,13,1,1
-1,131210063001003.000000000000000,Block 1003, Block Group 1, Census Tract 63, Fulton County, Georgia,15,0,15,15,4,10,0,0
-1,131210067011011.000000000000000,Block 1011, Block Group 1, Census Tract 67.01, Fulton County, Georgia,15,3,12,7,1,5,0,5
-1,131210067021001.000000000000000,Block 1001, Block Group 1, Census Tract 67.02, Fulton County, Georgia,15,0,15,11,0,11,0,4
-1,131210067021045.000000000000000,Block 1045, Block Group 1, Census Tract 67.02, Fulton County, Georgia,15,1,14,12,0,12,0,2
-1,131210072003013.000000000000000,Block 3013, Block Group 3, Census Tract 72, Fulton County, Georgia,15,2,13,13,0,13,0,0
-1,131210078051037.000000000000000,Block 1037, Block Group 1, Census Tract 78.05, Fulton County, Georgia,15,4,11,6,0,5,1,5
-1,131210083011015.000000000000000,Block 1015, Block Group 1, Census Tract 83.01, Fulton County, Georgia,15,0,15,13,0,13,0,2
-1,131210083012004.000000000000000,Block 2004, Block Group 2, Census Tract 83.01, Fulton County, Georgia,15,3,12,9,1,8,0,3
-1,131210083022015.000000000000000,Block 2015, Block Group 2, Census Tract 83.02, Fulton County, Georgia,15,1,14,11,0,11,0,3
-1,131210084001001.000000000000000,Block 1001, Block Group 1, Census Tract 84, Fulton County, Georgia,15,1,14,9,1,8,0,5
-1,131210084001013.000000000000000,Block 1013, Block Group 1, Census Tract 84, Fulton County, Georgia,15,0,15,15,0,15,0,0
-1,131210084003004.000000000000000,Block 3004, Block Group 3, Census Tract 84, Fulton County, Georgia,15,1,14,9,1,1,0,5
-1,131210084003007.000000000000000,Block 3007, Block Group 3, Census Tract 84, Fulton County, Georgia,15,0,15,15,2,12,1,0
-1,131210088021009.000000000000000,Block 1009, Block Group 1, Census Tract 88.02, Fulton County, Georgia,15,0,15,9,0,5,1,6
-1,131210088021016.000000000000000,Block 1016, Block Group 1, Census Tract 88.02, Fulton County, Georgia,15,4,11,10,8,2,0,1
-1,131210088021043.000000000000000,Block 1043, Block Group 1, Census Tract 88.02, Fulton County, Georgia,15,3,12,11,11,0,0,1
-1,131210091051011.000000000000000,Block 1011, Block Group 1, Census Tract 91.05, Fulton County, Georgia,15,2,13,6,6,0,0,7
-1,131210101341007.000000000000000,Block 1007, Block Group 1, Census Tract 101.34, Fulton County, Georgia,15,3,12,6,1,5,0,6
-1,131210103052011.000000000000000,Block 2011, Block Group 2, Census Tract 103.05, Fulton County, Georgia,15,4,11,10,3,7,0,1
-1,131210103063018.000000000000000,Block 3018, Block Group 3, Census Tract 103.06, Fulton County, Georgia,15,1,14,13,0,13,0,1
-1,131210103072012.000000000000000,Block 2012, Block Group 2, Census Tract 103.07, Fulton County, Georgia,15,8,7,6,2,4,0,1
-1,131210103074009.000000000000000,Block 4009, Block Group 4, Census Tract 103.07, Fulton County, Georgia,15,3,12,11,3,8,0,1
-1,131210103082025.000000000000000,Block 2025, Block Group 2, Census Tract 103.08, Fulton County, Georgia,15,6,9,9,7,2,0,0
-1,131210103083018.000000000000000,Block 3018, Block Group 3, Census Tract 103.08, Fulton County, Georgia,15,1,14,8,0,7,0,6
-1,131210103153001.000000000000000,Block 3001, Block Group 3, Census Tract 103.15, Fulton County, Georgia,15,1,14,14,1,13,0,0
-1,131210104013039.000000000000000,Block 3039, Block Group 3, Census Tract 104.01, Fulton County, Georgia,15,0,15,15,1,14,0,0
-1,131210104021033.000000000000000,Block 1033, Block Group 1, Census Tract 104.02, Fulton County, Georgia,15,0,15,14,1,13,0,1
-1,131210104021036.000000000000000,Block 1036, Block Group 1, Census Tract 104.02, Fulton County, Georgia,15,4,11,11,8,3,0,0
-1,131210104022043.000000000000000,Block 2043, Block Group 2, Census Tract 104.02, Fulton County, Georgia,15,0,15,15,0,15,0,0
-1,131210105182007.000000000000000,Block 2007, Block Group 2, Census Tract 105.18, Fulton County, Georgia,15,0,15,15,2,13,0,0
-1,131210105191028.000000000000000,Block 1028, Block Group 1, Census Tract 105.19, Fulton County, Georgia,15,5,10,9,7,0,0,1
-1,131210105201010.000000000000000,Block 1010, Block Group 1, Census Tract 105.20, Fulton County, Georgia,15,11,4,0,0,0,0,4
-1,131210105201023.000000000000000,Block 1023, Block Group 1, Census Tract 105.20, Fulton County, Georgia,15,8,7,7,1,5,1,0
-1,131210105203003.000000000000000,Block 3003, Block Group 3, Census Tract 105.20, Fulton County, Georgia,15,0,15,15,0,13,1,0
-1,131210105222034.000000000000000,Block 2034, Block Group 2, Census Tract 105.22, Fulton County, Georgia,15,1,14,14,6,6,0,0
-1,131210105264002.000000000000000,Block 4002, Block Group 4, Census Tract 105.26, Fulton County, Georgia,15,2,13,8,1,7,0,5
-1,131210105271017.000000000000000,Block 1017, Block Group 1, Census Tract 105.27, Fulton County, Georgia,15,5,10,9,4,5,0,1
-1,131210105273006.000000000000000,Block 3006, Block Group 3, Census Tract 105.27, Fulton County, Georgia,15,10,5,2,0,0,0,3
-1,131210105292015.000000000000000,Block 2015, Block Group 2, Census Tract 105.29, Fulton County, Georgia,15,1,14,13,1,4,1,1
-1,131210105301009.000000000000000,Block 1009, Block Group 1, Census Tract 105.30, Fulton County, Georgia,15,1,14,12,4,8,0,2
-1,131210105322003.000000000000000,Block 2003, Block Group 2, Census Tract 105.32, Fulton County, Georgia,15,7,8,8,0,6,2,0
-1,131210105322015.000000000000000,Block 2015, Block Group 2, Census Tract 105.32, Fulton County, Georgia,15,2,13,13,5,8,0,0
-1,131210105343020.000000000000000,Block 3020, Block Group 3, Census Tract 105.34, Fulton County, Georgia,15,3,12,11,9,2,0,1
-1,131210105352020.000000000000000,Block 2020, Block Group 2, Census Tract 105.35, Fulton County, Georgia,15,1,14,13,4,9,0,1
-1,131210105391031.000000000000000,Block 1031, Block Group 1, Census Tract 105.39, Fulton County, Georgia,15,7,8,8,0,8,0,0
-1,131210106041009.000000000000000,Block 1009, Block Group 1, Census Tract 106.04, Fulton County, Georgia,15,4,11,10,0,10,0,1
-1,131210106043016.000000000000000,Block 3016, Block Group 3, Census Tract 106.04, Fulton County, Georgia,15,3,12,10,0,10,0,2
-1,131210108011012.000000000000000,Block 1012, Block Group 1, Census Tract 108.01, Fulton County, Georgia,15,9,6,2,0,0,2,4
-1,131210108013034.000000000000000,Block 3034, Block Group 3, Census Tract 108.01, Fulton County, Georgia,15,0,15,15,6,8,0,0
-1,131210108021002.000000000000000,Block 1002, Block Group 1, Census Tract 108.02, Fulton County, Georgia,15,6,9,7,0,6,0,2
-1,131210108021013.000000000000000,Block 1013, Block Group 1, Census Tract 108.02, Fulton County, Georgia,15,3,12,11,3,6,1,1
-1,131210108024006.000000000000000,Block 4006, Block Group 4, Census Tract 108.02, Fulton County, Georgia,15,11,4,4,3,0,0,0
-1,131210113014009.000000000000000,Block 4009, Block Group 4, Census Tract 113.01, Fulton County, Georgia,15,2,13,12,0,12,0,1
-1,131210113014011.000000000000000,Block 4011, Block Group 4, Census Tract 113.01, Fulton County, Georgia,15,1,14,12,0,11,0,2
-1,131210114191009.000000000000000,Block 1009, Block Group 1, Census Tract 114.19, Fulton County, Georgia,15,1,14,11,8,0,3,3
-1,131210114194017.000000000000000,Block 4017, Block Group 4, Census Tract 114.19, Fulton County, Georgia,15,0,15,14,12,1,1,1
-1,131210114231000.000000000000000,Block 1000, Block Group 1, Census Tract 114.23, Fulton County, Georgia,15,2,13,10,2,6,1,3
-1,131210114363009.000000000000000,Block 3009, Block Group 3, Census Tract 114.36, Fulton County, Georgia,15,5,10,8,6,2,0,2
-1,131210114422010.000000000000000,Block 2010, Block Group 2, Census Tract 114.42, Fulton County, Georgia,15,7,8,8,2,2,3,0
-1,131210115122000.000000000000000,Block 2000, Block Group 2, Census Tract 115.12, Fulton County, Georgia,15,0,15,13,12,0,1,2
-1,131210115122005.000000000000000,Block 2005, Block Group 2, Census Tract 115.12, Fulton County, Georgia,15,0,15,14,11,0,0,1
-1,131210115122020.000000000000000,Block 2020, Block Group 2, Census Tract 115.12, Fulton County, Georgia,15,5,10,8,8,0,0,2
-1,131210115122025.000000000000000,Block 2025, Block Group 2, Census Tract 115.12, Fulton County, Georgia,15,2,13,12,12,0,0,1
-1,131210115152007.000000000000000,Block 2007, Block Group 2, Census Tract 115.15, Fulton County, Georgia,15,2,13,7,5,1,0,6
-1,131210116181004.000000000000000,Block 1004, Block Group 1, Census Tract 116.18, Fulton County, Georgia,15,5,10,6,0,1,3,4
-1,131210116391010.000000000000000,Block 1010, Block Group 1, Census Tract 116.39, Fulton County, Georgia,15,7,8,3,1,0,2,5
-1,131210116402026.000000000000000,Block 2026, Block Group 2, Census Tract 116.40, Fulton County, Georgia,15,0,15,15,10,4,0,0
-1,131210116511002.000000000000000,Block 1002, Block Group 1, Census Tract 116.51, Fulton County, Georgia,15,2,13,10,10,0,0,3
-1,131210118021031.000000000000000,Block 1031, Block Group 1, Census Tract 118.02, Fulton County, Georgia,15,1,14,13,1,12,0,1
-1,131210118021039.000000000000000,Block 1039, Block Group 1, Census Tract 118.02, Fulton County, Georgia,15,4,11,10,3,6,0,1
-1,131210119011022.000000000000000,Block 1022, Block Group 1, Census Tract 119.01, Fulton County, Georgia,15,5,10,7,0,7,0,3
-1,131210123001023.000000000000000,Block 1023, Block Group 1, Census Tract 123, Fulton County, Georgia,15,7,8,6,6,0,0,2
-1,131210005022015.000000000000000,Block 2015, Block Group 2, Census Tract 5.02, Fulton County, Georgia,14,2,12,10,1,9,0,2
-1,131210007001002.000000000000000,Block 1002, Block Group 1, Census Tract 7, Fulton County, Georgia,14,0,14,12,2,10,0,2
-1,131210010012030.000000000000000,Block 2030, Block Group 2, Census Tract 10.01, Fulton County, Georgia,14,5,9,2,0,2,0,7
-1,131210012041007.000000000000000,Block 1007, Block Group 1, Census Tract 12.04, Fulton County, Georgia,14,0,14,12,6,5,0,2
-1,131210021001004.000000000000000,Block 1004, Block Group 1, Census Tract 21, Fulton County, Georgia,14,2,12,11,5,4,0,1
-1,131210023002001.000000000000000,Block 2001, Block Group 2, Census Tract 23, Fulton County, Georgia,14,2,12,12,0,12,0,0
-1,131210028021004.000000000000000,Block 1004, Block Group 1, Census Tract 28.02, Fulton County, Georgia,14,5,9,7,4,3,0,2
-1,131210028022002.000000000000000,Block 2002, Block Group 2, Census Tract 28.02, Fulton County, Georgia,14,8,6,2,0,2,0,4
-1,131210039001020.000000000000000,Block 1020, Block Group 1, Census Tract 39, Fulton County, Georgia,14,0,14,14,2,12,0,0
-1,131210040002005.000000000000000,Block 2005, Block Group 2, Census Tract 40, Fulton County, Georgia,14,1,13,8,0,8,0,5
-1,131210049002016.000000000000000,Block 2016, Block Group 2, Census Tract 49, Fulton County, Georgia,14,4,10,10,7,3,0,0
-1,131210053002003.000000000000000,Block 2003, Block Group 2, Census Tract 53, Fulton County, Georgia,14,1,13,12,6,3,0,1
-1,131210053002009.000000000000000,Block 2009, Block Group 2, Census Tract 53, Fulton County, Georgia,14,4,10,9,1,8,0,1
-1,131210055011024.000000000000000,Block 1024, Block Group 1, Census Tract 55.01, Fulton County, Georgia,14,1,13,10,10,0,0,3
-1,131210055012017.000000000000000,Block 2017, Block Group 2, Census Tract 55.01, Fulton County, Georgia,14,2,12,12,1,11,0,0
-1,131210055041007.000000000000000,Block 1007, Block Group 1, Census Tract 55.04, Fulton County, Georgia,14,4,10,9,0,9,0,1
-1,131210063001010.000000000000000,Block 1010, Block Group 1, Census Tract 63, Fulton County, Georgia,14,0,14,13,0,13,0,1
-1,131210067021012.000000000000000,Block 1012, Block Group 1, Census Tract 67.02, Fulton County, Georgia,14,5,9,9,0,9,0,0
-1,131210067021024.000000000000000,Block 1024, Block Group 1, Census Tract 67.02, Fulton County, Georgia,14,0,14,14,5,9,0,0
-1,131210067021025.000000000000000,Block 1025, Block Group 1, Census Tract 67.02, Fulton County, Georgia,14,0,14,9,0,9,0,5
-1,131210070024004.000000000000000,Block 4004, Block Group 4, Census Tract 70.02, Fulton County, Georgia,14,3,11,11,0,11,0,0
-1,131210077052002.000000000000000,Block 2002, Block Group 2, Census Tract 77.05, Fulton County, Georgia,14,4,10,10,4,6,0,0
-1,131210077101004.000000000000000,Block 1004, Block Group 1, Census Tract 77.10, Fulton County, Georgia,14,4,10,9,1,7,0,1
-1,131210078051026.000000000000000,Block 1026, Block Group 1, Census Tract 78.05, Fulton County, Georgia,14,1,13,12,3,9,0,1
-1,131210078081007.000000000000000,Block 1007, Block Group 1, Census Tract 78.08, Fulton County, Georgia,14,4,10,8,2,6,0,2
-1,131210078103003.000000000000000,Block 3003, Block Group 3, Census Tract 78.10, Fulton County, Georgia,14,1,13,13,5,8,0,0
-1,131210080004004.000000000000000,Block 4004, Block Group 4, Census Tract 80, Fulton County, Georgia,14,2,12,11,2,9,0,1
-1,131210081043020.000000000000000,Block 3020, Block Group 3, Census Tract 81.04, Fulton County, Georgia,14,1,13,13,2,11,0,0
-1,131210083011018.000000000000000,Block 1018, Block Group 1, Census Tract 83.01, Fulton County, Georgia,14,0,14,10,0,10,0,4
-1,131210085002014.000000000000000,Block 2014, Block Group 2, Census Tract 85, Fulton County, Georgia,14,1,13,13,1,12,0,0
-1,131210085003007.000000000000000,Block 3007, Block Group 3, Census Tract 85, Fulton County, Georgia,14,0,14,14,0,14,0,0
-1,131210101311012.000000000000000,Block 1012, Block Group 1, Census Tract 101.31, Fulton County, Georgia,14,1,13,11,7,4,0,2
-1,131210102131003.000000000000000,Block 1003, Block Group 1, Census Tract 102.13, Fulton County, Georgia,14,4,10,4,1,3,0,6
-1,131210103051024.000000000000000,Block 1024, Block Group 1, Census Tract 103.05, Fulton County, Georgia,14,5,9,7,0,7,0,2
-1,131210103063005.000000000000000,Block 3005, Block Group 3, Census Tract 103.06, Fulton County, Georgia,14,1,13,10,2,8,0,3
-1,131210103072013.000000000000000,Block 2013, Block Group 2, Census Tract 103.07, Fulton County, Georgia,14,0,14,9,1,6,0,5
-1,131210103083009.000000000000000,Block 3009, Block Group 3, Census Tract 103.08, Fulton County, Georgia,14,3,11,8,0,7,0,3
-1,131210103091005.000000000000000,Block 1005, Block Group 1, Census Tract 103.09, Fulton County, Georgia,14,0,14,14,13,1,0,0
-1,131210103091039.000000000000000,Block 1039, Block Group 1, Census Tract 103.09, Fulton County, Georgia,14,1,13,13,13,0,0,0
-1,131210103092000.000000000000000,Block 2000, Block Group 2, Census Tract 103.09, Fulton County, Georgia,14,2,12,11,11,0,0,1
-1,131210103093000.000000000000000,Block 3000, Block Group 3, Census Tract 103.09, Fulton County, Georgia,14,2,12,12,4,8,0,0
-1,131210103111022.000000000000000,Block 1022, Block Group 1, Census Tract 103.11, Fulton County, Georgia,14,0,14,11,5,4,1,3
-1,131210104011005.000000000000000,Block 1005, Block Group 1, Census Tract 104.01, Fulton County, Georgia,14,7,7,6,6,0,0,1
-1,131210104013009.000000000000000,Block 3009, Block Group 3, Census Tract 104.01, Fulton County, Georgia,14,4,10,10,4,4,0,0
-1,131210104013034.000000000000000,Block 3034, Block Group 3, Census Tract 104.01, Fulton County, Georgia,14,1,13,13,13,0,0,0
-1,131210104021008.000000000000000,Block 1008, Block Group 1, Census Tract 104.02, Fulton County, Georgia,14,0,14,11,11,0,0,3
-1,131210104021024.000000000000000,Block 1024, Block Group 1, Census Tract 104.02, Fulton County, Georgia,14,0,14,12,11,1,0,2
-1,131210104021044.000000000000000,Block 1044, Block Group 1, Census Tract 104.02, Fulton County, Georgia,14,5,9,8,7,1,0,1
-1,131210104022037.000000000000000,Block 2037, Block Group 2, Census Tract 104.02, Fulton County, Georgia,14,2,12,10,8,2,0,2
-1,131210104023027.000000000000000,Block 3027, Block Group 3, Census Tract 104.02, Fulton County, Georgia,14,0,14,13,12,0,0,1
-1,131210105231016.000000000000000,Block 1016, Block Group 1, Census Tract 105.23, Fulton County, Georgia,14,3,11,10,3,0,6,1
-1,131210105241007.000000000000000,Block 1007, Block Group 1, Census Tract 105.24, Fulton County, Georgia,14,3,11,8,2,6,0,3
-1,131210105261001.000000000000000,Block 1001, Block Group 1, Census Tract 105.26, Fulton County, Georgia,14,0,14,12,4,1,6,2
-1,131210105263009.000000000000000,Block 3009, Block Group 3, Census Tract 105.26, Fulton County, Georgia,14,0,14,5,1,3,0,9
-1,131210105264001.000000000000000,Block 4001, Block Group 4, Census Tract 105.26, Fulton County, Georgia,14,0,14,11,1,9,0,3
-1,131210105282002.000000000000000,Block 2002, Block Group 2, Census Tract 105.28, Fulton County, Georgia,14,5,9,4,0,4,0,5
-1,131210105284001.000000000000000,Block 4001, Block Group 4, Census Tract 105.28, Fulton County, Georgia,14,6,8,5,4,1,0,3
-1,131210105293000.000000000000000,Block 3000, Block Group 3, Census Tract 105.29, Fulton County, Georgia,14,2,12,12,5,7,0,0
-1,131210105323000.000000000000000,Block 3000, Block Group 3, Census Tract 105.32, Fulton County, Georgia,14,2,12,7,1,6,0,5
-1,131210105343025.000000000000000,Block 3025, Block Group 3, Census Tract 105.34, Fulton County, Georgia,14,2,12,11,9,2,0,1
-1,131210106012002.000000000000000,Block 2002, Block Group 2, Census Tract 106.01, Fulton County, Georgia,14,2,12,12,4,8,0,0
-1,131210110001007.000000000000000,Block 1007, Block Group 1, Census Tract 110, Fulton County, Georgia,14,10,4,4,1,3,0,0
-1,131210110001015.000000000000000,Block 1015, Block Group 1, Census Tract 110, Fulton County, Georgia,14,11,3,2,2,0,0,1
-1,131210112023009.000000000000000,Block 3009, Block Group 3, Census Tract 112.02, Fulton County, Georgia,14,0,14,12,3,3,2,2
-1,131210112026018.000000000000000,Block 6018, Block Group 6, Census Tract 112.02, Fulton County, Georgia,14,1,13,13,8,5,0,0
-1,131210112041015.000000000000000,Block 1015, Block Group 1, Census Tract 112.04, Fulton County, Georgia,14,0,14,12,7,5,0,2
-1,131210114194008.000000000000000,Block 4008, Block Group 4, Census Tract 114.19, Fulton County, Georgia,14,0,14,10,9,1,0,4
-1,131210114231009.000000000000000,Block 1009, Block Group 1, Census Tract 114.23, Fulton County, Georgia,14,1,13,10,5,0,2,3
-1,131210114371016.000000000000000,Block 1016, Block Group 1, Census Tract 114.37, Fulton County, Georgia,14,3,11,8,8,0,0,3
-1,131210114451013.000000000000000,Block 1013, Block Group 1, Census Tract 114.45, Fulton County, Georgia,14,0,14,13,13,0,0,1
-1,131210115091009.000000000000000,Block 1009, Block Group 1, Census Tract 115.09, Fulton County, Georgia,14,5,9,4,2,0,0,5
-1,131210115092010.000000000000000,Block 2010, Block Group 2, Census Tract 115.09, Fulton County, Georgia,14,0,14,11,3,7,0,3
-1,131210115141006.000000000000000,Block 1006, Block Group 1, Census Tract 115.14, Fulton County, Georgia,14,3,11,6,3,0,0,5
-1,131210116293002.000000000000000,Block 3002, Block Group 3, Census Tract 116.29, Fulton County, Georgia,14,2,12,9,4,3,0,3
-1,131210116293004.000000000000000,Block 3004, Block Group 3, Census Tract 116.29, Fulton County, Georgia,14,2,12,8,2,0,0,4
-1,131210116411011.000000000000000,Block 1011, Block Group 1, Census Tract 116.41, Fulton County, Georgia,14,3,11,8,2,0,2,3
-1,131210116411016.000000000000000,Block 1016, Block Group 1, Census Tract 116.41, Fulton County, Georgia,14,2,12,10,8,1,0,2
-1,131210116471004.000000000000000,Block 1004, Block Group 1, Census Tract 116.47, Fulton County, Georgia,14,4,10,9,9,0,0,1
-1,131210118021017.000000000000000,Block 1017, Block Group 1, Census Tract 118.02, Fulton County, Georgia,14,0,14,14,3,11,0,0
-1,131210119011033.000000000000000,Block 1033, Block Group 1, Census Tract 119.01, Fulton County, Georgia,14,11,3,3,1,2,0,0
-1,131210123001002.000000000000000,Block 1002, Block Group 1, Census Tract 123, Fulton County, Georgia,14,0,14,13,1,12,0,1
-1,131210123002028.000000000000000,Block 2028, Block Group 2, Census Tract 123, Fulton County, Georgia,14,2,12,12,4,8,0,0
-1,131210004001017.000000000000000,Block 1017, Block Group 1, Census Tract 4, Fulton County, Georgia,13,0,13,10,3,5,0,3
-1,131210007001023.000000000000000,Block 1023, Block Group 1, Census Tract 7, Fulton County, Georgia,13,6,7,5,3,2,0,2
-1,131210019021006.000000000000000,Block 1006, Block Group 1, Census Tract 19.02, Fulton County, Georgia,13,4,9,9,3,4,0,0
-1,131210021001003.000000000000000,Block 1003, Block Group 1, Census Tract 21, Fulton County, Georgia,13,5,8,2,0,0,2,6
-1,131210026001003.000000000000000,Block 1003, Block Group 1, Census Tract 26, Fulton County, Georgia,13,3,10,10,6,4,0,0
-1,131210039001013.000000000000000,Block 1013, Block Group 1, Census Tract 39, Fulton County, Georgia,13,2,11,11,0,9,2,0
-1,131210039002012.000000000000000,Block 2012, Block Group 2, Census Tract 39, Fulton County, Georgia,13,1,12,11,5,6,0,1
-1,131210040003010.000000000000000,Block 3010, Block Group 3, Census Tract 40, Fulton County, Georgia,13,1,12,12,2,9,0,0
-1,131210049001016.000000000000000,Block 1016, Block Group 1, Census Tract 49, Fulton County, Georgia,13,3,10,4,4,0,0,6
-1,131210057001014.000000000000000,Block 1014, Block Group 1, Census Tract 57, Fulton County, Georgia,13,0,13,13,0,13,0,0
-1,131210060001006.000000000000000,Block 1006, Block Group 1, Census Tract 60, Fulton County, Georgia,13,0,13,11,5,2,0,2
-1,131210061003006.000000000000000,Block 3006, Block Group 3, Census Tract 61, Fulton County, Georgia,13,0,13,12,0,12,0,1
-1,131210062002007.000000000000000,Block 2007, Block Group 2, Census Tract 62, Fulton County, Georgia,13,1,12,11,0,11,0,1
-1,131210063001004.000000000000000,Block 1004, Block Group 1, Census Tract 63, Fulton County, Georgia,13,0,13,11,2,9,0,2
-1,131210063001005.000000000000000,Block 1005, Block Group 1, Census Tract 63, Fulton County, Georgia,13,1,12,11,2,9,0,1
-1,131210063001024.000000000000000,Block 1024, Block Group 1, Census Tract 63, Fulton County, Georgia,13,0,13,12,0,12,0,1
-1,131210063002003.000000000000000,Block 2003, Block Group 2, Census Tract 63, Fulton County, Georgia,13,0,13,13,5,6,2,0
-1,131210067021008.000000000000000,Block 1008, Block Group 1, Census Tract 67.02, Fulton County, Georgia,13,1,12,11,0,11,0,1
-1,131210067021036.000000000000000,Block 1036, Block Group 1, Census Tract 67.02, Fulton County, Georgia,13,3,10,9,0,9,0,1
-1,131210067022001.000000000000000,Block 2001, Block Group 2, Census Tract 67.02, Fulton County, Georgia,13,0,13,13,0,13,0,0
-1,131210069002008.000000000000000,Block 2008, Block Group 2, Census Tract 69, Fulton County, Georgia,13,6,7,4,1,3,0,3
-1,131210072001008.000000000000000,Block 1008, Block Group 1, Census Tract 72, Fulton County, Georgia,13,3,10,8,0,8,0,2
-1,131210072002007.000000000000000,Block 2007, Block Group 2, Census Tract 72, Fulton County, Georgia,13,0,13,9,0,7,2,4
-1,131210073022012.000000000000000,Block 2012, Block Group 2, Census Tract 73.02, Fulton County, Georgia,13,0,13,11,0,10,1,2
-1,131210078051031.000000000000000,Block 1031, Block Group 1, Census Tract 78.05, Fulton County, Georgia,13,1,12,7,0,7,0,5
-1,131210078053008.000000000000000,Block 3008, Block Group 3, Census Tract 78.05, Fulton County, Georgia,13,0,13,13,0,13,0,0
-1,131210078092012.000000000000000,Block 2012, Block Group 2, Census Tract 78.09, Fulton County, Georgia,13,0,13,10,0,8,0,3
-1,131210078092013.000000000000000,Block 2013, Block Group 2, Census Tract 78.09, Fulton County, Georgia,13,1,12,11,0,11,0,1
-1,131210080004009.000000000000000,Block 4009, Block Group 4, Census Tract 80, Fulton County, Georgia,13,1,12,10,3,7,0,2
-1,131210085002010.000000000000000,Block 2010, Block Group 2, Census Tract 85, Fulton County, Georgia,13,1,12,12,4,8,0,0
-1,131210085003009.000000000000000,Block 3009, Block Group 3, Census Tract 85, Fulton County, Georgia,13,0,13,13,1,12,0,0
-1,131210087011005.000000000000000,Block 1005, Block Group 1, Census Tract 87.01, Fulton County, Georgia,13,3,10,9,0,7,0,1
-1,131210087022018.000000000000000,Block 2018, Block Group 2, Census Tract 87.02, Fulton County, Georgia,13,0,13,11,0,10,0,2
-1,131210088021030.000000000000000,Block 1030, Block Group 1, Census Tract 88.02, Fulton County, Georgia,13,2,11,11,6,5,0,0
-1,131210089053008.000000000000000,Block 3008, Block Group 3, Census Tract 89.05, Fulton County, Georgia,13,9,4,4,3,1,0,0
-1,131210089053012.000000000000000,Block 3012, Block Group 3, Census Tract 89.05, Fulton County, Georgia,13,1,12,10,8,2,0,2
-1,131210089061006.000000000000000,Block 1006, Block Group 1, Census Tract 89.06, Fulton County, Georgia,13,1,12,8,7,1,0,4
-1,131210100051022.000000000000000,Block 1022, Block Group 1, Census Tract 100.05, Fulton County, Georgia,13,4,9,7,0,0,0,2
-1,131210101302004.000000000000000,Block 2004, Block Group 2, Census Tract 101.30, Fulton County, Georgia,13,2,11,10,3,6,0,1
-1,131210101331003.000000000000000,Block 1003, Block Group 1, Census Tract 101.33, Fulton County, Georgia,13,5,8,8,7,0,0,0
-1,131210102231008.000000000000000,Block 1008, Block Group 1, Census Tract 102.23, Fulton County, Georgia,13,3,10,5,0,0,0,5
-1,131210103072017.000000000000000,Block 2017, Block Group 2, Census Tract 103.07, Fulton County, Georgia,13,8,5,4,0,4,0,1
-1,131210103091035.000000000000000,Block 1035, Block Group 1, Census Tract 103.09, Fulton County, Georgia,13,0,13,13,3,10,0,0
-1,131210103093004.000000000000000,Block 3004, Block Group 3, Census Tract 103.09, Fulton County, Georgia,13,3,10,9,0,9,0,1
-1,131210103111023.000000000000000,Block 1023, Block Group 1, Census Tract 103.11, Fulton County, Georgia,13,4,9,9,8,0,1,0
-1,131210103122019.000000000000000,Block 2019, Block Group 2, Census Tract 103.12, Fulton County, Georgia,13,1,12,11,0,10,0,1
-1,131210104011010.000000000000000,Block 1010, Block Group 1, Census Tract 104.01, Fulton County, Georgia,13,1,12,11,8,3,0,1
-1,131210104023003.000000000000000,Block 3003, Block Group 3, Census Tract 104.02, Fulton County, Georgia,13,3,10,10,8,2,0,0
-1,131210104023055.000000000000000,Block 3055, Block Group 3, Census Tract 104.02, Fulton County, Georgia,13,1,12,11,11,0,0,1
-1,131210105172007.000000000000000,Block 2007, Block Group 2, Census Tract 105.17, Fulton County, Georgia,13,3,10,4,2,0,0,6
-1,131210105183001.000000000000000,Block 3001, Block Group 3, Census Tract 105.18, Fulton County, Georgia,13,3,10,8,0,8,0,2
-1,131210105191036.000000000000000,Block 1036, Block Group 1, Census Tract 105.19, Fulton County, Georgia,13,0,13,13,0,13,0,0
-1,131210105192009.000000000000000,Block 2009, Block Group 2, Census Tract 105.19, Fulton County, Georgia,13,0,13,13,6,7,0,0
-1,131210105203008.000000000000000,Block 3008, Block Group 3, Census Tract 105.20, Fulton County, Georgia,13,3,10,10,4,6,0,0
-1,131210105203051.000000000000000,Block 3051, Block Group 3, Census Tract 105.20, Fulton County, Georgia,13,1,12,11,7,2,0,1
-1,131210105231013.000000000000000,Block 1013, Block Group 1, Census Tract 105.23, Fulton County, Georgia,13,8,5,4,1,3,0,1
-1,131210105273019.000000000000000,Block 3019, Block Group 3, Census Tract 105.27, Fulton County, Georgia,13,4,9,7,0,7,0,2
-1,131210105281005.000000000000000,Block 1005, Block Group 1, Census Tract 105.28, Fulton County, Georgia,13,0,13,12,0,11,0,1
-1,131210105283020.000000000000000,Block 3020, Block Group 3, Census Tract 105.28, Fulton County, Georgia,13,6,7,6,5,0,0,1
-1,131210105301017.000000000000000,Block 1017, Block Group 1, Census Tract 105.30, Fulton County, Georgia,13,0,13,12,0,12,0,1
-1,131210105301020.000000000000000,Block 1020, Block Group 1, Census Tract 105.30, Fulton County, Georgia,13,0,13,13,2,11,0,0
-1,131210105342005.000000000000000,Block 2005, Block Group 2, Census Tract 105.34, Fulton County, Georgia,13,1,12,12,2,10,0,0
-1,131210105361012.000000000000000,Block 1012, Block Group 1, Census Tract 105.36, Fulton County, Georgia,13,1,12,8,1,7,0,4
-1,131210105361014.000000000000000,Block 1014, Block Group 1, Census Tract 105.36, Fulton County, Georgia,13,4,9,8,0,7,1,1
-1,131210105362007.000000000000000,Block 2007, Block Group 2, Census Tract 105.36, Fulton County, Georgia,13,1,12,9,9,0,0,3
-1,131210105402015.000000000000000,Block 2015, Block Group 2, Census Tract 105.40, Fulton County, Georgia,13,3,10,6,0,0,3,4
-1,131210106011012.000000000000000,Block 1012, Block Group 1, Census Tract 106.01, Fulton County, Georgia,13,0,13,13,10,2,0,0
-1,131210106014009.000000000000000,Block 4009, Block Group 4, Census Tract 106.01, Fulton County, Georgia,13,2,11,6,2,1,0,5
-1,131210106034003.000000000000000,Block 4003, Block Group 4, Census Tract 106.03, Fulton County, Georgia,13,5,8,6,0,5,0,2
-1,131210112023015.000000000000000,Block 3015, Block Group 3, Census Tract 112.02, Fulton County, Georgia,13,3,10,7,3,4,0,3
-1,131210112023022.000000000000000,Block 3022, Block Group 3, Census Tract 112.02, Fulton County, Georgia,13,5,8,6,0,5,1,2
-1,131210113061023.000000000000000,Block 1023, Block Group 1, Census Tract 113.06, Fulton County, Georgia,13,2,11,11,1,10,0,0
-1,131210114371007.000000000000000,Block 1007, Block Group 1, Census Tract 114.37, Fulton County, Georgia,13,6,7,3,0,0,3,4
-1,131210114422002.000000000000000,Block 2002, Block Group 2, Census Tract 114.42, Fulton County, Georgia,13,3,10,9,3,0,5,1
-1,131210115112006.000000000000000,Block 2006, Block Group 2, Census Tract 115.11, Fulton County, Georgia,13,2,11,10,9,0,0,1
-1,131210116502003.000000000000000,Block 2003, Block Group 2, Census Tract 116.50, Fulton County, Georgia,13,0,13,10,2,0,0,3
-1,131210118011006.000000000000000,Block 1006, Block Group 1, Census Tract 118.01, Fulton County, Georgia,13,3,10,5,1,1,2,5
-1,131210119021003.000000000000000,Block 1003, Block Group 1, Census Tract 119.02, Fulton County, Georgia,13,2,11,11,2,8,1,0
-1,131210123002023.000000000000000,Block 2023, Block Group 2, Census Tract 123, Fulton County, Georgia,13,2,11,11,0,11,0,0
-1,131210123002055.000000000000000,Block 2055, Block Group 2, Census Tract 123, Fulton County, Georgia,13,2,11,9,4,4,0,2
-1,131210005012001.000000000000000,Block 2001, Block Group 2, Census Tract 5.01, Fulton County, Georgia,12,3,9,7,5,1,0,2
-1,131210005012017.000000000000000,Block 2017, Block Group 2, Census Tract 5.01, Fulton County, Georgia,12,4,8,6,4,0,2,2
-1,131210005014001.000000000000000,Block 4001, Block Group 4, Census Tract 5.01, Fulton County, Georgia,12,8,4,0,0,0,0,4
-1,131210006011003.000000000000000,Block 1003, Block Group 1, Census Tract 6.01, Fulton County, Georgia,12,2,10,4,1,1,0,6
-1,131210023001003.000000000000000,Block 1003, Block Group 1, Census Tract 23, Fulton County, Georgia,12,0,12,11,1,7,0,1
-1,131210026001006.000000000000000,Block 1006, Block Group 1, Census Tract 26, Fulton County, Georgia,12,3,9,6,2,4,0,3
-1,131210029001015.000000000000000,Block 1015, Block Group 1, Census Tract 29, Fulton County, Georgia,12,0,12,10,0,8,1,2
-1,131210043001004.000000000000000,Block 1004, Block Group 1, Census Tract 43, Fulton County, Georgia,12,2,10,8,0,8,0,2
-1,131210043003009.000000000000000,Block 3009, Block Group 3, Census Tract 43, Fulton County, Georgia,12,3,9,6,6,0,0,3
-1,131210043003011.000000000000000,Block 3011, Block Group 3, Census Tract 43, Fulton County, Georgia,12,3,9,7,0,7,0,2
-1,131210055011027.000000000000000,Block 1027, Block Group 1, Census Tract 55.01, Fulton County, Georgia,12,0,12,11,0,9,0,1
-1,131210057001013.000000000000000,Block 1013, Block Group 1, Census Tract 57, Fulton County, Georgia,12,1,11,9,2,7,0,2
-1,131210057002013.000000000000000,Block 2013, Block Group 2, Census Tract 57, Fulton County, Georgia,12,3,9,9,0,9,0,0
-1,131210057002016.000000000000000,Block 2016, Block Group 2, Census Tract 57, Fulton County, Georgia,12,1,11,11,2,9,0,0
-1,131210063001014.000000000000000,Block 1014, Block Group 1, Census Tract 63, Fulton County, Georgia,12,0,12,11,2,7,0,1
-1,131210067021019.000000000000000,Block 1019, Block Group 1, Census Tract 67.02, Fulton County, Georgia,12,3,9,8,8,0,0,1
-1,131210067021020.000000000000000,Block 1020, Block Group 1, Census Tract 67.02, Fulton County, Georgia,12,1,11,10,0,10,0,1
-1,131210069002009.000000000000000,Block 2009, Block Group 2, Census Tract 69, Fulton County, Georgia,12,3,9,6,2,4,0,3
-1,131210070023014.000000000000000,Block 3014, Block Group 3, Census Tract 70.02, Fulton County, Georgia,12,5,7,5,1,4,0,2
-1,131210073022002.000000000000000,Block 2002, Block Group 2, Census Tract 73.02, Fulton County, Georgia,12,2,10,8,0,8,0,2
-1,131210075002010.000000000000000,Block 2010, Block Group 2, Census Tract 75, Fulton County, Georgia,12,0,12,10,2,6,0,2
-1,131210077102003.000000000000000,Block 2003, Block Group 2, Census Tract 77.10, Fulton County, Georgia,12,1,11,6,0,6,0,5
-1,131210078051035.000000000000000,Block 1035, Block Group 1, Census Tract 78.05, Fulton County, Georgia,12,5,7,5,5,0,0,2
-1,131210078053020.000000000000000,Block 3020, Block Group 3, Census Tract 78.05, Fulton County, Georgia,12,0,12,12,3,9,0,0
-1,131210078101008.000000000000000,Block 1008, Block Group 1, Census Tract 78.10, Fulton County, Georgia,12,3,9,7,0,7,0,2
-1,131210085001011.000000000000000,Block 1011, Block Group 1, Census Tract 85, Fulton County, Georgia,12,0,12,12,0,12,0,0
-1,131210086012010.000000000000000,Block 2010, Block Group 2, Census Tract 86.01, Fulton County, Georgia,12,5,7,7,0,7,0,0
-1,131210088022010.000000000000000,Block 2010, Block Group 2, Census Tract 88.02, Fulton County, Georgia,12,6,6,6,6,0,0,0
-1,131210088022013.000000000000000,Block 2013, Block Group 2, Census Tract 88.02, Fulton County, Georgia,12,1,11,5,1,4,0,6
-1,131210096061002.000000000000000,Block 1002, Block Group 1, Census Tract 96.06, Fulton County, Georgia,12,2,10,7,4,0,0,3
-1,131210098023001.000000000000000,Block 3001, Block Group 3, Census Tract 98.02, Fulton County, Georgia,12,0,12,12,8,4,0,0
-1,131210101152013.000000000000000,Block 2013, Block Group 2, Census Tract 101.15, Fulton County, Georgia,12,9,3,2,0,0,1,1
-1,131210101152015.000000000000000,Block 2015, Block Group 2, Census Tract 101.15, Fulton County, Georgia,12,5,7,6,4,2,0,1
-1,131210101152018.000000000000000,Block 2018, Block Group 2, Census Tract 101.15, Fulton County, Georgia,12,6,6,2,0,0,0,4
-1,131210103081008.000000000000000,Block 1008, Block Group 1, Census Tract 103.08, Fulton County, Georgia,12,4,8,4,0,2,2,4
-1,131210103091041.000000000000000,Block 1041, Block Group 1, Census Tract 103.09, Fulton County, Georgia,12,2,10,10,5,2,3,0
-1,131210103093005.000000000000000,Block 3005, Block Group 3, Census Tract 103.09, Fulton County, Georgia,12,1,11,11,5,6,0,0
-1,131210103132005.000000000000000,Block 2005, Block Group 2, Census Tract 103.13, Fulton County, Georgia,12,3,9,5,1,0,0,4
-1,131210104013040.000000000000000,Block 3040, Block Group 3, Census Tract 104.01, Fulton County, Georgia,12,2,10,8,0,8,0,2
-1,131210104021041.000000000000000,Block 1041, Block Group 1, Census Tract 104.02, Fulton County, Georgia,12,0,12,12,11,0,0,0
-1,131210104022049.000000000000000,Block 2049, Block Group 2, Census Tract 104.02, Fulton County, Georgia,12,0,12,12,11,1,0,0
-1,131210105191042.000000000000000,Block 1042, Block Group 1, Census Tract 105.19, Fulton County, Georgia,12,5,7,2,0,2,0,5
-1,131210105201021.000000000000000,Block 1021, Block Group 1, Census Tract 105.20, Fulton County, Georgia,12,0,12,11,8,2,0,1
-1,131210105253012.000000000000000,Block 3012, Block Group 3, Census Tract 105.25, Fulton County, Georgia,12,0,12,11,0,9,0,1
-1,131210105261016.000000000000000,Block 1016, Block Group 1, Census Tract 105.26, Fulton County, Georgia,12,3,9,7,1,6,0,2
-1,131210105273016.000000000000000,Block 3016, Block Group 3, Census Tract 105.27, Fulton County, Georgia,12,4,8,8,7,0,1,0
-1,131210105361004.000000000000000,Block 1004, Block Group 1, Census Tract 105.36, Fulton County, Georgia,12,0,12,10,3,6,1,2
-1,131210105362003.000000000000000,Block 2003, Block Group 2, Census Tract 105.36, Fulton County, Georgia,12,1,11,11,7,4,0,0
-1,131210105402026.000000000000000,Block 2026, Block Group 2, Census Tract 105.40, Fulton County, Georgia,12,3,9,8,0,7,1,1
-1,131210106011014.000000000000000,Block 1014, Block Group 1, Census Tract 106.01, Fulton County, Georgia,12,2,10,10,7,1,0,0
-1,131210108013037.000000000000000,Block 3037, Block Group 3, Census Tract 108.01, Fulton County, Georgia,12,0,12,12,4,8,0,0
-1,131210108021014.000000000000000,Block 1014, Block Group 1, Census Tract 108.02, Fulton County, Georgia,12,5,7,4,2,0,0,3
-1,131210110001001.000000000000000,Block 1001, Block Group 1, Census Tract 110, Fulton County, Georgia,12,7,5,5,0,5,0,0
-1,131210111002005.000000000000000,Block 2005, Block Group 2, Census Tract 111, Fulton County, Georgia,12,0,12,11,4,6,0,1
-1,131210112026013.000000000000000,Block 6013, Block Group 6, Census Tract 112.02, Fulton County, Georgia,12,1,11,9,3,5,1,2
-1,131210112041002.000000000000000,Block 1002, Block Group 1, Census Tract 112.04, Fulton County, Georgia,12,7,5,5,0,4,0,0
-1,131210114162006.000000000000000,Block 2006, Block Group 2, Census Tract 114.16, Fulton County, Georgia,12,0,12,4,1,2,0,8
-1,131210114422012.000000000000000,Block 2012, Block Group 2, Census Tract 114.42, Fulton County, Georgia,12,1,11,7,1,6,0,4
-1,131210115071008.000000000000000,Block 1008, Block Group 1, Census Tract 115.07, Fulton County, Georgia,12,3,9,8,3,5,0,1
-1,131210115071013.000000000000000,Block 1013, Block Group 1, Census Tract 115.07, Fulton County, Georgia,12,1,11,8,3,0,0,3
-1,131210115092007.000000000000000,Block 2007, Block Group 2, Census Tract 115.09, Fulton County, Georgia,12,4,8,5,5,0,0,3
-1,131210115122004.000000000000000,Block 2004, Block Group 2, Census Tract 115.12, Fulton County, Georgia,12,1,11,8,5,3,0,3
-1,131210115122019.000000000000000,Block 2019, Block Group 2, Census Tract 115.12, Fulton County, Georgia,12,1,11,10,10,0,0,1
-1,131210115142008.000000000000000,Block 2008, Block Group 2, Census Tract 115.14, Fulton County, Georgia,12,1,11,8,3,2,0,3
-1,131210116402032.000000000000000,Block 2032, Block Group 2, Census Tract 116.40, Fulton County, Georgia,12,0,12,12,6,4,0,0
-1,131210116473017.000000000000000,Block 3017, Block Group 3, Census Tract 116.47, Fulton County, Georgia,12,4,8,7,6,1,0,1
-1,131210116521024.000000000000000,Block 1024, Block Group 1, Census Tract 116.52, Fulton County, Georgia,12,0,12,12,11,1,0,0
-1,131210119011003.000000000000000,Block 1003, Block Group 1, Census Tract 119.01, Fulton County, Georgia,12,1,11,11,4,0,3,0
-1,131210119022005.000000000000000,Block 2005, Block Group 2, Census Tract 119.02, Fulton County, Georgia,12,1,11,11,3,6,0,0
-1,131210123002054.000000000000000,Block 2054, Block Group 2, Census Tract 123, Fulton County, Georgia,12,1,11,11,4,5,2,0
-1,131210123003028.000000000000000,Block 3028, Block Group 3, Census Tract 123, Fulton County, Georgia,12,2,10,10,3,6,1,0
-1,131210123004015.000000000000000,Block 4015, Block Group 4, Census Tract 123, Fulton County, Georgia,12,0,12,11,8,3,0,1
-1,131210005013010.000000000000000,Block 3010, Block Group 3, Census Tract 5.01, Fulton County, Georgia,11,3,8,6,3,3,0,2
-1,131210005021002.000000000000000,Block 1002, Block Group 1, Census Tract 5.02, Fulton County, Georgia,11,4,7,7,2,3,0,0
-1,131210007001006.000000000000000,Block 1006, Block Group 1, Census Tract 7, Fulton County, Georgia,11,4,7,2,2,0,0,5
-1,131210010022002.000000000000000,Block 2002, Block Group 2, Census Tract 10.02, Fulton County, Georgia,11,6,5,2,0,1,1,3
-1,131210014001001.000000000000000,Block 1001, Block Group 1, Census Tract 14, Fulton County, Georgia,11,0,11,5,3,2,0,6
-1,131210028021007.000000000000000,Block 1007, Block Group 1, Census Tract 28.02, Fulton County, Georgia,11,2,9,8,0,4,2,1
-1,131210029001008.000000000000000,Block 1008, Block Group 1, Census Tract 29, Fulton County, Georgia,11,2,9,8,8,0,0,1
-1,131210031001014.000000000000000,Block 1014, Block Group 1, Census Tract 31, Fulton County, Georgia,11,0,11,11,10,0,0,0
-1,131210035002007.000000000000000,Block 2007, Block Group 2, Census Tract 35, Fulton County, Georgia,11,0,11,11,0,11,0,0
-1,131210038001015.000000000000000,Block 1015, Block Group 1, Census Tract 38, Fulton County, Georgia,11,2,9,9,0,5,0,0
-1,131210038002003.000000000000000,Block 2003, Block Group 2, Census Tract 38, Fulton County, Georgia,11,0,11,10,0,10,0,1
-1,131210039002015.000000000000000,Block 2015, Block Group 2, Census Tract 39, Fulton County, Georgia,11,0,11,10,2,8,0,1
-1,131210040002013.000000000000000,Block 2013, Block Group 2, Census Tract 40, Fulton County, Georgia,11,0,11,11,0,11,0,0
-1,131210042001001.000000000000000,Block 1001, Block Group 1, Census Tract 42, Fulton County, Georgia,11,0,11,11,5,6,0,0
-1,131210044002001.000000000000000,Block 2001, Block Group 2, Census Tract 44, Fulton County, Georgia,11,0,11,11,5,6,0,0
-1,131210048002007.000000000000000,Block 2007, Block Group 2, Census Tract 48, Fulton County, Georgia,11,1,10,9,6,3,0,1
-1,131210052002008.000000000000000,Block 2008, Block Group 2, Census Tract 52, Fulton County, Georgia,11,0,11,10,10,0,0,1
-1,131210055011000.000000000000000,Block 1000, Block Group 1, Census Tract 55.01, Fulton County, Georgia,11,0,11,5,5,0,0,6
-1,131210055011004.000000000000000,Block 1004, Block Group 1, Census Tract 55.01, Fulton County, Georgia,11,2,9,8,4,4,0,1
-1,131210055041006.000000000000000,Block 1006, Block Group 1, Census Tract 55.04, Fulton County, Georgia,11,2,9,9,0,9,0,0
-1,131210060004001.000000000000000,Block 4001, Block Group 4, Census Tract 60, Fulton County, Georgia,11,0,11,8,1,6,0,3
-1,131210063002012.000000000000000,Block 2012, Block Group 2, Census Tract 63, Fulton County, Georgia,11,2,9,8,0,8,0,1
-1,131210067021032.000000000000000,Block 1032, Block Group 1, Census Tract 67.02, Fulton County, Georgia,11,0,11,11,0,7,0,0
-1,131210070014010.000000000000000,Block 4010, Block Group 4, Census Tract 70.01, Fulton County, Georgia,11,5,6,6,0,6,0,0
-1,131210072002004.000000000000000,Block 2004, Block Group 2, Census Tract 72, Fulton County, Georgia,11,2,9,2,0,2,0,7
-1,131210074001000.000000000000000,Block 1000, Block Group 1, Census Tract 74, Fulton County, Georgia,11,4,7,4,2,2,0,3
-1,131210077103012.000000000000000,Block 3012, Block Group 3, Census Tract 77.10, Fulton County, Georgia,11,3,8,7,0,7,0,1
-1,131210078093002.000000000000000,Block 3002, Block Group 3, Census Tract 78.09, Fulton County, Georgia,11,1,10,9,1,8,0,1
-1,131210078103006.000000000000000,Block 3006, Block Group 3, Census Tract 78.10, Fulton County, Georgia,11,2,9,5,0,5,0,4
-1,131210080004016.000000000000000,Block 4016, Block Group 4, Census Tract 80, Fulton County, Georgia,11,5,6,6,1,5,0,0
-1,131210081033005.000000000000000,Block 3005, Block Group 3, Census Tract 81.03, Fulton County, Georgia,11,7,4,2,0,0,2,2
-1,131210082043003.000000000000000,Block 3003, Block Group 3, Census Tract 82.04, Fulton County, Georgia,11,1,10,8,0,8,0,2
-1,131210083011014.000000000000000,Block 1014, Block Group 1, Census Tract 83.01, Fulton County, Georgia,11,1,10,7,0,7,0,3
-1,131210083021011.000000000000000,Block 1011, Block Group 1, Census Tract 83.02, Fulton County, Georgia,11,0,11,11,1,10,0,0
-1,131210086012002.000000000000000,Block 2002, Block Group 2, Census Tract 86.01, Fulton County, Georgia,11,0,11,9,5,4,0,2
-1,131210086013010.000000000000000,Block 3010, Block Group 3, Census Tract 86.01, Fulton County, Georgia,11,0,11,8,0,8,0,3
-1,131210086014005.000000000000000,Block 4005, Block Group 4, Census Tract 86.01, Fulton County, Georgia,11,0,11,11,0,11,0,0
-1,131210087011022.000000000000000,Block 1022, Block Group 1, Census Tract 87.01, Fulton County, Georgia,11,4,7,4,0,3,0,3
-1,131210093011004.000000000000000,Block 1004, Block Group 1, Census Tract 93.01, Fulton County, Georgia,11,2,9,6,4,2,0,3
-1,131210101323007.000000000000000,Block 3007, Block Group 3, Census Tract 101.32, Fulton County, Georgia,11,0,11,11,9,2,0,0
-1,131210102233002.000000000000000,Block 3002, Block Group 3, Census Tract 102.23, Fulton County, Georgia,11,9,2,0,0,0,0,2
-1,131210103063015.000000000000000,Block 3015, Block Group 3, Census Tract 103.06, Fulton County, Georgia,11,2,9,8,3,5,0,1
-1,131210103082027.000000000000000,Block 2027, Block Group 2, Census Tract 103.08, Fulton County, Georgia,11,0,11,8,2,6,0,3
-1,131210103091033.000000000000000,Block 1033, Block Group 1, Census Tract 103.09, Fulton County, Georgia,11,2,9,8,2,5,1,1
-1,131210103092031.000000000000000,Block 2031, Block Group 2, Census Tract 103.09, Fulton County, Georgia,11,6,5,4,0,1,3,1
-1,131210103101002.000000000000000,Block 1002, Block Group 1, Census Tract 103.10, Fulton County, Georgia,11,0,11,5,4,1,0,6
-1,131210103111020.000000000000000,Block 1020, Block Group 1, Census Tract 103.11, Fulton County, Georgia,11,8,3,2,2,0,0,1
-1,131210103122028.000000000000000,Block 2028, Block Group 2, Census Tract 103.12, Fulton County, Georgia,11,0,11,9,0,9,0,2
-1,131210103131019.000000000000000,Block 1019, Block Group 1, Census Tract 103.13, Fulton County, Georgia,11,0,11,8,0,6,2,3
-1,131210103132004.000000000000000,Block 2004, Block Group 2, Census Tract 103.13, Fulton County, Georgia,11,2,9,7,0,6,0,2
-1,131210104022022.000000000000000,Block 2022, Block Group 2, Census Tract 104.02, Fulton County, Georgia,11,0,11,11,4,6,0,0
-1,131210104022036.000000000000000,Block 2036, Block Group 2, Census Tract 104.02, Fulton County, Georgia,11,1,10,7,3,4,0,3
-1,131210104023051.000000000000000,Block 3051, Block Group 3, Census Tract 104.02, Fulton County, Georgia,11,3,8,8,0,6,0,0
-1,131210104023064.000000000000000,Block 3064, Block Group 3, Census Tract 104.02, Fulton County, Georgia,11,0,11,11,9,2,0,0
-1,131210105191008.000000000000000,Block 1008, Block Group 1, Census Tract 105.19, Fulton County, Georgia,11,7,4,4,0,2,2,0
-1,131210105191023.000000000000000,Block 1023, Block Group 1, Census Tract 105.19, Fulton County, Georgia,11,0,11,11,8,0,0,0
-1,131210105191027.000000000000000,Block 1027, Block Group 1, Census Tract 105.19, Fulton County, Georgia,11,6,5,4,0,4,0,1
-1,131210105191033.000000000000000,Block 1033, Block Group 1, Census Tract 105.19, Fulton County, Georgia,11,5,6,6,5,1,0,0
-1,131210105203023.000000000000000,Block 3023, Block Group 3, Census Tract 105.20, Fulton County, Georgia,11,4,7,6,0,3,0,1
-1,131210105222015.000000000000000,Block 2015, Block Group 2, Census Tract 105.22, Fulton County, Georgia,11,8,3,2,0,1,1,1
-1,131210105281004.000000000000000,Block 1004, Block Group 1, Census Tract 105.28, Fulton County, Georgia,11,2,9,7,1,6,0,2
-1,131210105361007.000000000000000,Block 1007, Block Group 1, Census Tract 105.36, Fulton County, Georgia,11,1,10,10,4,6,0,0
-1,131210105402032.000000000000000,Block 2032, Block Group 2, Census Tract 105.40, Fulton County, Georgia,11,0,11,11,10,1,0,0
-1,131210106033012.000000000000000,Block 3012, Block Group 3, Census Tract 106.03, Fulton County, Georgia,11,1,10,9,0,6,3,1
-1,131210108011020.000000000000000,Block 1020, Block Group 1, Census Tract 108.01, Fulton County, Georgia,11,5,6,4,2,2,0,2
-1,131210108013005.000000000000000,Block 3005, Block Group 3, Census Tract 108.01, Fulton County, Georgia,11,8,3,0,0,0,0,3
-1,131210108013014.000000000000000,Block 3014, Block Group 3, Census Tract 108.01, Fulton County, Georgia,11,4,7,7,2,0,0,0
-1,131210110001005.000000000000000,Block 1005, Block Group 1, Census Tract 110, Fulton County, Georgia,11,5,6,5,0,5,0,1
-1,131210111001000.000000000000000,Block 1000, Block Group 1, Census Tract 111, Fulton County, Georgia,11,0,11,10,0,9,1,1
-1,131210114302002.000000000000000,Block 2002, Block Group 2, Census Tract 114.30, Fulton County, Georgia,11,9,2,0,0,0,0,2
-1,131210114322007.000000000000000,Block 2007, Block Group 2, Census Tract 114.32, Fulton County, Georgia,11,2,9,7,0,0,0,2
-1,131210114382008.000000000000000,Block 2008, Block Group 2, Census Tract 114.38, Fulton County, Georgia,11,1,10,7,4,3,0,3
-1,131210114382015.000000000000000,Block 2015, Block Group 2, Census Tract 114.38, Fulton County, Georgia,11,4,7,7,4,2,0,0
-1,131210115052005.000000000000000,Block 2005, Block Group 2, Census Tract 115.05, Fulton County, Georgia,11,2,9,6,0,1,0,3
-1,131210115122009.000000000000000,Block 2009, Block Group 2, Census Tract 115.12, Fulton County, Georgia,11,1,10,9,9,0,0,1
-1,131210115122011.000000000000000,Block 2011, Block Group 2, Census Tract 115.12, Fulton County, Georgia,11,0,11,11,11,0,0,0
-1,131210115122017.000000000000000,Block 2017, Block Group 2, Census Tract 115.12, Fulton County, Georgia,11,3,8,8,8,0,0,0
-1,131210115142004.000000000000000,Block 2004, Block Group 2, Census Tract 115.14, Fulton County, Georgia,11,1,10,10,10,0,0,0
-1,131210116183013.000000000000000,Block 3013, Block Group 3, Census Tract 116.18, Fulton County, Georgia,11,0,11,11,9,2,0,0
-1,131210116411013.000000000000000,Block 1013, Block Group 1, Census Tract 116.41, Fulton County, Georgia,11,2,9,4,1,2,1,5
-1,131210116473001.000000000000000,Block 3001, Block Group 3, Census Tract 116.47, Fulton County, Georgia,11,0,11,4,2,0,0,7
-1,131210116481002.000000000000000,Block 1002, Block Group 1, Census Tract 116.48, Fulton County, Georgia,11,2,9,8,2,2,1,1
-1,131210116493001.000000000000000,Block 3001, Block Group 3, Census Tract 116.49, Fulton County, Georgia,11,4,7,3,0,0,2,4
-1,131210116551005.000000000000000,Block 1005, Block Group 1, Census Tract 116.55, Fulton County, Georgia,11,2,9,2,1,0,0,7
-1,131210118011017.000000000000000,Block 1017, Block Group 1, Census Tract 118.01, Fulton County, Georgia,11,3,8,4,3,1,0,4
-1,131210118021041.000000000000000,Block 1041, Block Group 1, Census Tract 118.02, Fulton County, Georgia,11,0,11,11,0,11,0,0
-1,131210118022006.000000000000000,Block 2006, Block Group 2, Census Tract 118.02, Fulton County, Georgia,11,1,10,6,2,4,0,4
-1,131210119011027.000000000000000,Block 1027, Block Group 1, Census Tract 119.01, Fulton County, Georgia,11,4,7,5,5,0,0,2
-1,131210120001003.000000000000000,Block 1003, Block Group 1, Census Tract 120, Fulton County, Georgia,11,2,9,8,0,6,0,1
-1,131210123001027.000000000000000,Block 1027, Block Group 1, Census Tract 123, Fulton County, Georgia,11,3,8,8,0,8,0,0
-1,131210123004006.000000000000000,Block 4006, Block Group 4, Census Tract 123, Fulton County, Georgia,11,1,10,10,8,2,0,0
-1,131210123004016.000000000000000,Block 4016, Block Group 4, Census Tract 123, Fulton County, Georgia,11,0,11,11,5,6,0,0
-1,131210001001002.000000000000000,Block 1002, Block Group 1, Census Tract 1, Fulton County, Georgia,10,1,9,9,6,3,0,0
-1,131210005014003.000000000000000,Block 4003, Block Group 4, Census Tract 5.01, Fulton County, Georgia,10,3,7,6,1,0,2,1
-1,131210006011006.000000000000000,Block 1006, Block Group 1, Census Tract 6.01, Fulton County, Georgia,10,0,10,3,2,0,0,7
-1,131210010021010.000000000000000,Block 1010, Block Group 1, Census Tract 10.02, Fulton County, Georgia,10,2,8,7,0,7,0,1
-1,131210010022022.000000000000000,Block 2022, Block Group 2, Census Tract 10.02, Fulton County, Georgia,10,0,10,5,1,0,0,5
-1,131210023001002.000000000000000,Block 1002, Block Group 1, Census Tract 23, Fulton County, Georgia,10,0,10,10,0,9,0,0
-1,131210029001005.000000000000000,Block 1005, Block Group 1, Census Tract 29, Fulton County, Georgia,10,3,7,6,2,1,0,1
-1,131210032002000.000000000000000,Block 2000, Block Group 2, Census Tract 32, Fulton County, Georgia,10,4,6,5,2,2,0,1
-1,131210038001014.000000000000000,Block 1014, Block Group 1, Census Tract 38, Fulton County, Georgia,10,0,10,10,0,10,0,0
-1,131210043003010.000000000000000,Block 3010, Block Group 3, Census Tract 43, Fulton County, Georgia,10,1,9,5,1,3,0,4
-1,131210057002018.000000000000000,Block 2018, Block Group 2, Census Tract 57, Fulton County, Georgia,10,1,9,9,0,9,0,0
-1,131210058001002.000000000000000,Block 1002, Block Group 1, Census Tract 58, Fulton County, Georgia,10,0,10,10,0,10,0,0
-1,131210063001022.000000000000000,Block 1022, Block Group 1, Census Tract 63, Fulton County, Georgia,10,3,7,6,2,4,0,1
-1,131210063002014.000000000000000,Block 2014, Block Group 2, Census Tract 63, Fulton County, Georgia,10,0,10,9,2,4,3,1
-1,131210065003004.000000000000000,Block 3004, Block Group 3, Census Tract 65, Fulton County, Georgia,10,0,10,10,4,6,0,0
-1,131210069003019.000000000000000,Block 3019, Block Group 3, Census Tract 69, Fulton County, Georgia,10,5,5,3,0,3,0,2
-1,131210070012005.000000000000000,Block 2005, Block Group 2, Census Tract 70.01, Fulton County, Georgia,10,1,9,9,0,5,4,0
-1,131210076033008.000000000000000,Block 3008, Block Group 3, Census Tract 76.03, Fulton County, Georgia,10,3,7,7,0,4,3,0
-1,131210077081003.000000000000000,Block 1003, Block Group 1, Census Tract 77.08, Fulton County, Georgia,10,5,5,5,0,5,0,0
-1,131210083012008.000000000000000,Block 2008, Block Group 2, Census Tract 83.01, Fulton County, Georgia,10,3,7,7,0,5,0,0
-1,131210085002019.000000000000000,Block 2019, Block Group 2, Census Tract 85, Fulton County, Georgia,10,1,9,8,0,8,0,1
-1,131210085003030.000000000000000,Block 3030, Block Group 3, Census Tract 85, Fulton County, Georgia,10,0,10,9,6,3,0,1
-1,131210086011009.000000000000000,Block 1009, Block Group 1, Census Tract 86.01, Fulton County, Georgia,10,1,9,4,0,3,0,5
-1,131210086012018.000000000000000,Block 2018, Block Group 2, Census Tract 86.01, Fulton County, Georgia,10,4,6,5,0,5,0,1
-1,131210088022001.000000000000000,Block 2001, Block Group 2, Census Tract 88.02, Fulton County, Georgia,10,3,7,1,0,1,0,6
-1,131210089031010.000000000000000,Block 1010, Block Group 1, Census Tract 89.03, Fulton County, Georgia,10,4,6,4,0,4,0,2
-1,131210098021024.000000000000000,Block 1024, Block Group 1, Census Tract 98.02, Fulton County, Georgia,10,0,10,9,7,1,0,1
-1,131210101071010.000000000000000,Block 1010, Block Group 1, Census Tract 101.07, Fulton County, Georgia,10,2,8,7,3,0,0,1
-1,131210101312000.000000000000000,Block 2000, Block Group 2, Census Tract 101.31, Fulton County, Georgia,10,6,4,3,2,0,0,1
-1,131210103051027.000000000000000,Block 1027, Block Group 1, Census Tract 103.05, Fulton County, Georgia,10,2,8,8,2,6,0,0
-1,131210103072016.000000000000000,Block 2016, Block Group 2, Census Tract 103.07, Fulton County, Georgia,10,2,8,6,0,6,0,2
-1,131210103074005.000000000000000,Block 4005, Block Group 4, Census Tract 103.07, Fulton County, Georgia,10,1,9,9,0,7,1,0
-1,131210103074011.000000000000000,Block 4011, Block Group 4, Census Tract 103.07, Fulton County, Georgia,10,4,6,5,0,5,0,1
-1,131210103091018.000000000000000,Block 1018, Block Group 1, Census Tract 103.09, Fulton County, Georgia,10,2,8,7,1,6,0,1
-1,131210103111001.000000000000000,Block 1001, Block Group 1, Census Tract 103.11, Fulton County, Georgia,10,2,8,7,2,5,0,1
-1,131210103111021.000000000000000,Block 1021, Block Group 1, Census Tract 103.11, Fulton County, Georgia,10,1,9,9,3,5,0,0
-1,131210103112000.000000000000000,Block 2000, Block Group 2, Census Tract 103.11, Fulton County, Georgia,10,6,4,1,1,0,0,3
-1,131210103131014.000000000000000,Block 1014, Block Group 1, Census Tract 103.13, Fulton County, Georgia,10,3,7,7,2,2,0,0
-1,131210104011014.000000000000000,Block 1014, Block Group 1, Census Tract 104.01, Fulton County, Georgia,10,6,4,4,0,4,0,0
-1,131210104011033.000000000000000,Block 1033, Block Group 1, Census Tract 104.01, Fulton County, Georgia,10,3,7,6,3,2,0,1
-1,131210104013004.000000000000000,Block 3004, Block Group 3, Census Tract 104.01, Fulton County, Georgia,10,6,4,4,2,2,0,0
-1,131210104021005.000000000000000,Block 1005, Block Group 1, Census Tract 104.02, Fulton County, Georgia,10,1,9,9,9,0,0,0
-1,131210104021018.000000000000000,Block 1018, Block Group 1, Census Tract 104.02, Fulton County, Georgia,10,1,9,9,8,0,0,0
-1,131210104021026.000000000000000,Block 1026, Block Group 1, Census Tract 104.02, Fulton County, Georgia,10,0,10,10,10,0,0,0
-1,131210104021034.000000000000000,Block 1034, Block Group 1, Census Tract 104.02, Fulton County, Georgia,10,1,9,5,0,5,0,4
-1,131210104023009.000000000000000,Block 3009, Block Group 3, Census Tract 104.02, Fulton County, Georgia,10,0,10,9,9,0,0,1
-1,131210105261013.000000000000000,Block 1013, Block Group 1, Census Tract 105.26, Fulton County, Georgia,10,0,10,10,5,4,0,0
-1,131210105261041.000000000000000,Block 1041, Block Group 1, Census Tract 105.26, Fulton County, Georgia,10,1,9,8,8,0,0,1
-1,131210105281011.000000000000000,Block 1011, Block Group 1, Census Tract 105.28, Fulton County, Georgia,10,8,2,1,0,1,0,1
-1,131210105343005.000000000000000,Block 3005, Block Group 3, Census Tract 105.34, Fulton County, Georgia,10,3,7,6,1,5,0,1
-1,131210105343010.000000000000000,Block 3010, Block Group 3, Census Tract 105.34, Fulton County, Georgia,10,2,8,6,0,4,0,2
-1,131210105343011.000000000000000,Block 3011, Block Group 3, Census Tract 105.34, Fulton County, Georgia,10,2,8,7,7,0,0,1
-1,131210105361003.000000000000000,Block 1003, Block Group 1, Census Tract 105.36, Fulton County, Georgia,10,0,10,6,0,6,0,4
-1,131210105361009.000000000000000,Block 1009, Block Group 1, Census Tract 105.36, Fulton County, Georgia,10,2,8,5,0,5,0,3
-1,131210105371015.000000000000000,Block 1015, Block Group 1, Census Tract 105.37, Fulton County, Georgia,10,2,8,6,1,2,3,2
-1,131210105382007.000000000000000,Block 2007, Block Group 2, Census Tract 105.38, Fulton County, Georgia,10,8,2,1,0,1,0,1
-1,131210108011017.000000000000000,Block 1017, Block Group 1, Census Tract 108.01, Fulton County, Georgia,10,7,3,3,3,0,0,0
-1,131210110003001.000000000000000,Block 3001, Block Group 3, Census Tract 110, Fulton County, Georgia,10,5,5,4,4,0,0,1
-1,131210111003012.000000000000000,Block 3012, Block Group 3, Census Tract 111, Fulton County, Georgia,10,1,9,9,1,8,0,0
-1,131210112023014.000000000000000,Block 3014, Block Group 3, Census Tract 112.02, Fulton County, Georgia,10,0,10,7,0,7,0,3
-1,131210112031004.000000000000000,Block 1004, Block Group 1, Census Tract 112.03, Fulton County, Georgia,10,5,5,3,2,1,0,2
-1,131210112041001.000000000000000,Block 1001, Block Group 1, Census Tract 112.04, Fulton County, Georgia,10,2,8,8,4,4,0,0
-1,131210114371006.000000000000000,Block 1006, Block Group 1, Census Tract 114.37, Fulton County, Georgia,10,2,8,6,0,6,0,2
-1,131210115112007.000000000000000,Block 2007, Block Group 2, Census Tract 115.11, Fulton County, Georgia,10,1,9,9,5,0,0,0
-1,131210115121010.000000000000000,Block 1010, Block Group 1, Census Tract 115.12, Fulton County, Georgia,10,1,9,9,9,0,0,0
-1,131210116551016.000000000000000,Block 1016, Block Group 1, Census Tract 116.55, Fulton County, Georgia,10,1,9,9,6,0,0,0
-1,131210119011028.000000000000000,Block 1028, Block Group 1, Census Tract 119.01, Fulton County, Georgia,10,0,10,6,1,5,0,4
-1,131210123002001.000000000000000,Block 2001, Block Group 2, Census Tract 123, Fulton County, Georgia,10,9,1,1,0,0,0,0
-1,131210123002030.000000000000000,Block 2030, Block Group 2, Census Tract 123, Fulton County, Georgia,10,8,2,2,1,1,0,0
-1,131210123003022.000000000000000,Block 3022, Block Group 3, Census Tract 123, Fulton County, Georgia,10,4,6,4,0,4,0,2
-1,131210123003029.000000000000000,Block 3029, Block Group 3, Census Tract 123, Fulton County, Georgia,10,1,9,6,1,5,0,3
-1,131210005014011.000000000000000,Block 4011, Block Group 4, Census Tract 5.01, Fulton County, Georgia,9,1,8,6,0,4,0,2
-1,131210005022018.000000000000000,Block 2018, Block Group 2, Census Tract 5.02, Fulton County, Georgia,9,0,9,2,0,0,0,7
-1,131210023001015.000000000000000,Block 1015, Block Group 1, Census Tract 23, Fulton County, Georgia,9,0,9,9,0,9,0,0
-1,131210023002010.000000000000000,Block 2010, Block Group 2, Census Tract 23, Fulton County, Georgia,9,1,8,7,1,6,0,1
-1,131210023003001.000000000000000,Block 3001, Block Group 3, Census Tract 23, Fulton County, Georgia,9,0,9,9,0,9,0,0
-1,131210026001005.000000000000000,Block 1005, Block Group 1, Census Tract 26, Fulton County, Georgia,9,1,8,8,0,8,0,0
-1,131210032002013.000000000000000,Block 2013, Block Group 2, Census Tract 32, Fulton County, Georgia,9,1,8,6,6,0,0,2
-1,131210035002027.000000000000000,Block 2027, Block Group 2, Census Tract 35, Fulton County, Georgia,9,3,6,4,1,3,0,2
-1,131210040001009.000000000000000,Block 1009, Block Group 1, Census Tract 40, Fulton County, Georgia,9,0,9,8,3,5,0,1
-1,131210042003008.000000000000000,Block 3008, Block Group 3, Census Tract 42, Fulton County, Georgia,9,5,4,4,0,3,1,0
-1,131210064001011.000000000000000,Block 1011, Block Group 1, Census Tract 64, Fulton County, Georgia,9,6,3,1,1,0,0,2
-1,131210065002012.000000000000000,Block 2012, Block Group 2, Census Tract 65, Fulton County, Georgia,9,3,6,5,0,5,0,1
-1,131210067021017.000000000000000,Block 1017, Block Group 1, Census Tract 67.02, Fulton County, Georgia,9,0,9,8,2,5,1,1
-1,131210067021021.000000000000000,Block 1021, Block Group 1, Census Tract 67.02, Fulton County, Georgia,9,0,9,8,0,8,0,1
-1,131210067021028.000000000000000,Block 1028, Block Group 1, Census Tract 67.02, Fulton County, Georgia,9,0,9,6,0,6,0,3
-1,131210073011004.000000000000000,Block 1004, Block Group 1, Census Tract 73.01, Fulton County, Georgia,9,6,3,2,0,2,0,1
-1,131210074002014.000000000000000,Block 2014, Block Group 2, Census Tract 74, Fulton County, Georgia,9,3,6,3,0,3,0,3
-1,131210075001003.000000000000000,Block 1003, Block Group 1, Census Tract 75, Fulton County, Georgia,9,0,9,5,1,1,0,4
-1,131210078053007.000000000000000,Block 3007, Block Group 3, Census Tract 78.05, Fulton County, Georgia,9,1,8,8,0,6,0,0
-1,131210078092014.000000000000000,Block 2014, Block Group 2, Census Tract 78.09, Fulton County, Georgia,9,0,9,8,1,7,0,1
-1,131210078094009.000000000000000,Block 4009, Block Group 4, Census Tract 78.09, Fulton County, Georgia,9,1,8,6,0,4,0,2
-1,131210079004019.000000000000000,Block 4019, Block Group 4, Census Tract 79, Fulton County, Georgia,9,0,9,9,1,8,0,0
-1,131210081031000.000000000000000,Block 1000, Block Group 1, Census Tract 81.03, Fulton County, Georgia,9,2,7,5,0,1,2,2
-1,131210081041000.000000000000000,Block 1000, Block Group 1, Census Tract 81.04, Fulton County, Georgia,9,0,9,7,0,6,1,2
-1,131210084003008.000000000000000,Block 3008, Block Group 3, Census Tract 84, Fulton County, Georgia,9,2,7,5,2,3,0,2
-1,131210085002011.000000000000000,Block 2011, Block Group 2, Census Tract 85, Fulton County, Georgia,9,2,7,7,0,7,0,0
-1,131210086012007.000000000000000,Block 2007, Block Group 2, Census Tract 86.01, Fulton County, Georgia,9,2,7,6,0,5,1,1
-1,131210086012013.000000000000000,Block 2013, Block Group 2, Census Tract 86.01, Fulton County, Georgia,9,5,4,3,0,3,0,1
-1,131210086013011.000000000000000,Block 3011, Block Group 3, Census Tract 86.01, Fulton County, Georgia,9,0,9,5,1,4,0,4
-1,131210086014001.000000000000000,Block 4001, Block Group 4, Census Tract 86.01, Fulton County, Georgia,9,3,6,6,0,6,0,0
-1,131210098023003.000000000000000,Block 3003, Block Group 3, Census Tract 98.02, Fulton County, Georgia,9,4,5,3,1,1,1,2
-1,131210101152005.000000000000000,Block 2005, Block Group 2, Census Tract 101.15, Fulton County, Georgia,9,3,6,2,0,1,0,4
-1,131210101201001.000000000000000,Block 1001, Block Group 1, Census Tract 101.20, Fulton County, Georgia,9,3,6,4,2,0,0,2
-1,131210101311010.000000000000000,Block 1010, Block Group 1, Census Tract 101.31, Fulton County, Georgia,9,2,7,7,0,1,0,0
-1,131210102042010.000000000000000,Block 2010, Block Group 2, Census Tract 102.04, Fulton County, Georgia,9,2,7,3,0,0,0,4
-1,131210103051007.000000000000000,Block 1007, Block Group 1, Census Tract 103.05, Fulton County, Georgia,9,0,9,9,0,9,0,0
-1,131210103082010.000000000000000,Block 2010, Block Group 2, Census Tract 103.08, Fulton County, Georgia,9,2,7,5,0,4,1,2
-1,131210103091019.000000000000000,Block 1019, Block Group 1, Census Tract 103.09, Fulton County, Georgia,9,3,6,6,1,5,0,0
-1,131210103132007.000000000000000,Block 2007, Block Group 2, Census Tract 103.13, Fulton County, Georgia,9,1,8,8,0,7,0,0
-1,131210104011037.000000000000000,Block 1037, Block Group 1, Census Tract 104.01, Fulton County, Georgia,9,1,8,6,6,0,0,2
-1,131210104013017.000000000000000,Block 3017, Block Group 3, Census Tract 104.01, Fulton County, Georgia,9,0,9,8,5,2,0,1
-1,131210104013044.000000000000000,Block 3044, Block Group 3, Census Tract 104.01, Fulton County, Georgia,9,0,9,8,0,8,0,1
-1,131210104022004.000000000000000,Block 2004, Block Group 2, Census Tract 104.02, Fulton County, Georgia,9,3,6,4,3,1,0,2
-1,131210104023007.000000000000000,Block 3007, Block Group 3, Census Tract 104.02, Fulton County, Georgia,9,4,5,5,0,5,0,0
-1,131210104023021.000000000000000,Block 3021, Block Group 3, Census Tract 104.02, Fulton County, Georgia,9,1,8,1,0,0,0,7
-1,131210105203011.000000000000000,Block 3011, Block Group 3, Census Tract 105.20, Fulton County, Georgia,9,1,8,3,2,0,1,5
-1,131210105203021.000000000000000,Block 3021, Block Group 3, Census Tract 105.20, Fulton County, Georgia,9,3,6,6,4,2,0,0
-1,131210105212007.000000000000000,Block 2007, Block Group 2, Census Tract 105.21, Fulton County, Georgia,9,5,4,3,0,3,0,1
-1,131210105241006.000000000000000,Block 1006, Block Group 1, Census Tract 105.24, Fulton County, Georgia,9,5,4,4,0,1,2,0
-1,131210105261002.000000000000000,Block 1002, Block Group 1, Census Tract 105.26, Fulton County, Georgia,9,0,9,6,2,4,0,3
-1,131210105261018.000000000000000,Block 1018, Block Group 1, Census Tract 105.26, Fulton County, Georgia,9,1,8,5,3,2,0,3
-1,131210105261037.000000000000000,Block 1037, Block Group 1, Census Tract 105.26, Fulton County, Georgia,9,5,4,3,0,3,0,1
-1,131210105261038.000000000000000,Block 1038, Block Group 1, Census Tract 105.26, Fulton County, Georgia,9,2,7,3,3,0,0,4
-1,131210105301019.000000000000000,Block 1019, Block Group 1, Census Tract 105.30, Fulton County, Georgia,9,0,9,9,5,4,0,0
-1,131210105332005.000000000000000,Block 2005, Block Group 2, Census Tract 105.33, Fulton County, Georgia,9,7,2,2,1,1,0,0
-1,131210105342009.000000000000000,Block 2009, Block Group 2, Census Tract 105.34, Fulton County, Georgia,9,4,5,4,0,4,0,1
-1,131210105343023.000000000000000,Block 3023, Block Group 3, Census Tract 105.34, Fulton County, Georgia,9,1,8,6,6,0,0,2
-1,131210105402019.000000000000000,Block 2019, Block Group 2, Census Tract 105.40, Fulton County, Georgia,9,4,5,5,3,2,0,0
-1,131210106041006.000000000000000,Block 1006, Block Group 1, Census Tract 106.04, Fulton County, Georgia,9,0,9,8,0,4,3,1
-1,131210112023004.000000000000000,Block 3004, Block Group 3, Census Tract 112.02, Fulton County, Georgia,9,6,3,3,3,0,0,0
-1,131210112026020.000000000000000,Block 6020, Block Group 6, Census Tract 112.02, Fulton County, Georgia,9,2,7,7,4,3,0,0
-1,131210113062007.000000000000000,Block 2007, Block Group 2, Census Tract 113.06, Fulton County, Georgia,9,4,5,1,0,0,0,4
-1,131210113081000.000000000000000,Block 1000, Block Group 1, Census Tract 113.08, Fulton County, Georgia,9,1,8,5,0,5,0,3
-1,131210113081005.000000000000000,Block 1005, Block Group 1, Census Tract 113.08, Fulton County, Georgia,9,0,9,5,1,4,0,4
-1,131210114191006.000000000000000,Block 1006, Block Group 1, Census Tract 114.19, Fulton County, Georgia,9,3,6,3,3,0,0,3
-1,131210114223007.000000000000000,Block 3007, Block Group 3, Census Tract 114.22, Fulton County, Georgia,9,6,3,3,2,1,0,0
-1,131210114231001.000000000000000,Block 1001, Block Group 1, Census Tract 114.23, Fulton County, Georgia,9,0,9,8,2,2,2,1
-1,131210114451012.000000000000000,Block 1012, Block Group 1, Census Tract 114.45, Fulton County, Georgia,9,1,8,8,8,0,0,0
-1,131210115122003.000000000000000,Block 2003, Block Group 2, Census Tract 115.12, Fulton County, Georgia,9,0,9,9,9,0,0,0
-1,131210116472014.000000000000000,Block 2014, Block Group 2, Census Tract 116.47, Fulton County, Georgia,9,1,8,4,0,2,1,4
-1,131210118021002.000000000000000,Block 1002, Block Group 1, Census Tract 118.02, Fulton County, Georgia,9,0,9,9,0,8,0,0
-1,131210118021016.000000000000000,Block 1016, Block Group 1, Census Tract 118.02, Fulton County, Georgia,9,0,9,9,2,7,0,0
-1,131210118022024.000000000000000,Block 2024, Block Group 2, Census Tract 118.02, Fulton County, Georgia,9,0,9,9,0,8,0,0
-1,131210119011000.000000000000000,Block 1000, Block Group 1, Census Tract 119.01, Fulton County, Georgia,9,1,8,2,0,2,0,6
-1,131210119021010.000000000000000,Block 1010, Block Group 1, Census Tract 119.02, Fulton County, Georgia,9,5,4,3,2,1,0,1
-1,131210120001001.000000000000000,Block 1001, Block Group 1, Census Tract 120, Fulton County, Georgia,9,0,9,8,0,8,0,1
-1,131210123002008.000000000000000,Block 2008, Block Group 2, Census Tract 123, Fulton County, Georgia,9,1,8,7,3,4,0,1
-1,131210123002022.000000000000000,Block 2022, Block Group 2, Census Tract 123, Fulton County, Georgia,9,0,9,9,4,5,0,0
-1,131210123002029.000000000000000,Block 2029, Block Group 2, Census Tract 123, Fulton County, Georgia,9,2,7,6,6,0,0,1
-1,131210123003012.000000000000000,Block 3012, Block Group 3, Census Tract 123, Fulton County, Georgia,9,2,7,4,1,3,0,3
-1,131210123003016.000000000000000,Block 3016, Block Group 3, Census Tract 123, Fulton County, Georgia,9,2,7,6,0,6,0,1
-1,131210123003018.000000000000000,Block 3018, Block Group 3, Census Tract 123, Fulton County, Georgia,9,4,5,5,0,5,0,0
-1,131210123004013.000000000000000,Block 4013, Block Group 4, Census Tract 123, Fulton County, Georgia,9,1,8,6,0,6,0,2
-1,131210005014005.000000000000000,Block 4005, Block Group 4, Census Tract 5.01, Fulton County, Georgia,8,3,5,1,0,0,1,4
-1,131210007001011.000000000000000,Block 1011, Block Group 1, Census Tract 7, Fulton County, Georgia,8,0,8,5,3,1,0,3
-1,131210007001028.000000000000000,Block 1028, Block Group 1, Census Tract 7, Fulton County, Georgia,8,3,5,3,1,2,0,2
-1,131210019021021.000000000000000,Block 1021, Block Group 1, Census Tract 19.02, Fulton County, Georgia,8,1,7,4,0,4,0,3
-1,131210019023015.000000000000000,Block 3015, Block Group 3, Census Tract 19.02, Fulton County, Georgia,8,2,6,6,3,0,0,0
-1,131210023001017.000000000000000,Block 1017, Block Group 1, Census Tract 23, Fulton County, Georgia,8,0,8,7,0,7,0,1
-1,131210023002006.000000000000000,Block 2006, Block Group 2, Census Tract 23, Fulton County, Georgia,8,0,8,6,0,6,0,2
-1,131210036002012.000000000000000,Block 2012, Block Group 2, Census Tract 36, Fulton County, Georgia,8,2,6,3,0,3,0,3
-1,131210038002009.000000000000000,Block 2009, Block Group 2, Census Tract 38, Fulton County, Georgia,8,0,8,7,0,7,0,1
-1,131210039001011.000000000000000,Block 1011, Block Group 1, Census Tract 39, Fulton County, Georgia,8,4,4,4,0,4,0,0
-1,131210049001020.000000000000000,Block 1020, Block Group 1, Census Tract 49, Fulton County, Georgia,8,3,5,2,0,2,0,3
-1,131210055011006.000000000000000,Block 1006, Block Group 1, Census Tract 55.01, Fulton County, Georgia,8,0,8,8,5,2,0,0
-1,131210063002008.000000000000000,Block 2008, Block Group 2, Census Tract 63, Fulton County, Georgia,8,0,8,7,3,3,1,1
-1,131210067021034.000000000000000,Block 1034, Block Group 1, Census Tract 67.02, Fulton County, Georgia,8,0,8,8,0,8,0,0
-1,131210076033026.000000000000000,Block 3026, Block Group 3, Census Tract 76.03, Fulton County, Georgia,8,3,5,4,2,2,0,1
-1,131210077053018.000000000000000,Block 3018, Block Group 3, Census Tract 77.05, Fulton County, Georgia,8,0,8,4,0,3,0,4
-1,131210079004010.000000000000000,Block 4010, Block Group 4, Census Tract 79, Fulton County, Georgia,8,0,8,8,1,7,0,0
-1,131210085002009.000000000000000,Block 2009, Block Group 2, Census Tract 85, Fulton County, Georgia,8,0,8,6,3,3,0,2
-1,131210085002015.000000000000000,Block 2015, Block Group 2, Census Tract 85, Fulton County, Georgia,8,0,8,8,0,8,0,0
-1,131210085002016.000000000000000,Block 2016, Block Group 2, Census Tract 85, Fulton County, Georgia,8,3,5,5,0,5,0,0
-1,131210087012009.000000000000000,Block 2009, Block Group 2, Census Tract 87.01, Fulton County, Georgia,8,2,6,4,0,4,0,2
-1,131210087022000.000000000000000,Block 2000, Block Group 2, Census Tract 87.02, Fulton County, Georgia,8,1,7,6,4,2,0,1
-1,131210088011024.000000000000000,Block 1024, Block Group 1, Census Tract 88.01, Fulton County, Georgia,8,1,7,7,0,4,0,0
-1,131210089054007.000000000000000,Block 4007, Block Group 4, Census Tract 89.05, Fulton County, Georgia,8,0,8,7,0,0,0,1
-1,131210090021008.000000000000000,Block 1008, Block Group 1, Census Tract 90.02, Fulton County, Georgia,8,1,7,7,7,0,0,0
-1,131210091033007.000000000000000,Block 3007, Block Group 3, Census Tract 91.03, Fulton County, Georgia,8,2,6,3,2,0,0,3
-1,131210103074013.000000000000000,Block 4013, Block Group 4, Census Tract 103.07, Fulton County, Georgia,8,0,8,5,3,0,2,3
-1,131210103111005.000000000000000,Block 1005, Block Group 1, Census Tract 103.11, Fulton County, Georgia,8,0,8,8,0,4,0,0
-1,131210103151016.000000000000000,Block 1016, Block Group 1, Census Tract 103.15, Fulton County, Georgia,8,0,8,8,0,6,1,0
-1,131210104011042.000000000000000,Block 1042, Block Group 1, Census Tract 104.01, Fulton County, Georgia,8,1,7,7,5,0,0,0
-1,131210104012006.000000000000000,Block 2006, Block Group 2, Census Tract 104.01, Fulton County, Georgia,8,3,5,5,5,0,0,0
-1,131210104012008.000000000000000,Block 2008, Block Group 2, Census Tract 104.01, Fulton County, Georgia,8,1,7,6,0,6,0,1
-1,131210104021013.000000000000000,Block 1013, Block Group 1, Census Tract 104.02, Fulton County, Georgia,8,0,8,7,6,1,0,1
-1,131210104021043.000000000000000,Block 1043, Block Group 1, Census Tract 104.02, Fulton County, Georgia,8,3,5,5,4,1,0,0
-1,131210104023062.000000000000000,Block 3062, Block Group 3, Census Tract 104.02, Fulton County, Georgia,8,1,7,7,7,0,0,0
-1,131210104023067.000000000000000,Block 3067, Block Group 3, Census Tract 104.02, Fulton County, Georgia,8,0,8,8,5,3,0,0
-1,131210105182008.000000000000000,Block 2008, Block Group 2, Census Tract 105.18, Fulton County, Georgia,8,1,7,6,0,6,0,1
-1,131210105183005.000000000000000,Block 3005, Block Group 3, Census Tract 105.18, Fulton County, Georgia,8,5,3,0,0,0,0,3
-1,131210105203022.000000000000000,Block 3022, Block Group 3, Census Tract 105.20, Fulton County, Georgia,8,2,6,6,6,0,0,0
-1,131210105261055.000000000000000,Block 1055, Block Group 1, Census Tract 105.26, Fulton County, Georgia,8,2,6,5,5,0,0,1
-1,131210105264000.000000000000000,Block 4000, Block Group 4, Census Tract 105.26, Fulton County, Georgia,8,2,6,4,0,4,0,2
-1,131210105302002.000000000000000,Block 2002, Block Group 2, Census Tract 105.30, Fulton County, Georgia,8,0,8,8,0,8,0,0
-1,131210105302035.000000000000000,Block 2035, Block Group 2, Census Tract 105.30, Fulton County, Georgia,8,0,8,4,0,4,0,4
-1,131210105342022.000000000000000,Block 2022, Block Group 2, Census Tract 105.34, Fulton County, Georgia,8,0,8,6,3,0,0,2
-1,131210105352023.000000000000000,Block 2023, Block Group 2, Census Tract 105.35, Fulton County, Georgia,8,1,7,7,2,5,0,0
-1,131210105381004.000000000000000,Block 1004, Block Group 1, Census Tract 105.38, Fulton County, Georgia,8,0,8,8,4,4,0,0
-1,131210105382018.000000000000000,Block 2018, Block Group 2, Census Tract 105.38, Fulton County, Georgia,8,0,8,3,3,0,0,5
-1,131210105382025.000000000000000,Block 2025, Block Group 2, Census Tract 105.38, Fulton County, Georgia,8,0,8,8,3,5,0,0
-1,131210105402031.000000000000000,Block 2031, Block Group 2, Census Tract 105.40, Fulton County, Georgia,8,0,8,7,4,2,0,1
-1,131210106011022.000000000000000,Block 1022, Block Group 1, Census Tract 106.01, Fulton County, Georgia,8,1,7,7,6,1,0,0
-1,131210106034023.000000000000000,Block 4023, Block Group 4, Census Tract 106.03, Fulton County, Georgia,8,1,7,6,0,6,0,1
-1,131210106034031.000000000000000,Block 4031, Block Group 4, Census Tract 106.03, Fulton County, Georgia,8,0,8,8,0,7,0,0
-1,131210106043002.000000000000000,Block 3002, Block Group 3, Census Tract 106.04, Fulton County, Georgia,8,0,8,4,0,1,0,4
-1,131210108012002.000000000000000,Block 2002, Block Group 2, Census Tract 108.01, Fulton County, Georgia,8,3,5,4,3,1,0,1
-1,131210108012017.000000000000000,Block 2017, Block Group 2, Census Tract 108.01, Fulton County, Georgia,8,1,7,6,5,1,0,1
-1,131210113015009.000000000000000,Block 5009, Block Group 5, Census Tract 113.01, Fulton County, Georgia,8,2,6,5,0,5,0,1
-1,131210114353019.000000000000000,Block 3019, Block Group 3, Census Tract 114.35, Fulton County, Georgia,8,1,7,6,6,0,0,1
-1,131210115082005.000000000000000,Block 2005, Block Group 2, Census Tract 115.08, Fulton County, Georgia,8,1,7,6,5,1,0,1
-1,131210115091008.000000000000000,Block 1008, Block Group 1, Census Tract 115.09, Fulton County, Georgia,8,0,8,3,1,0,0,5
-1,131210115102021.000000000000000,Block 2021, Block Group 2, Census Tract 115.10, Fulton County, Georgia,8,1,7,6,0,3,0,1
-1,131210115112011.000000000000000,Block 2011, Block Group 2, Census Tract 115.11, Fulton County, Georgia,8,5,3,1,1,0,0,2
-1,131210115141004.000000000000000,Block 1004, Block Group 1, Census Tract 115.14, Fulton County, Georgia,8,0,8,6,3,2,1,2
-1,131210116433008.000000000000000,Block 3008, Block Group 3, Census Tract 116.43, Fulton County, Georgia,8,3,5,4,0,0,1,1
-1,131210116532003.000000000000000,Block 2003, Block Group 2, Census Tract 116.53, Fulton County, Georgia,8,3,5,4,2,1,1,1
-1,131210116552014.000000000000000,Block 2014, Block Group 2, Census Tract 116.55, Fulton County, Georgia,8,4,4,2,2,0,0,2
-1,131210118021025.000000000000000,Block 1025, Block Group 1, Census Tract 118.02, Fulton County, Georgia,8,0,8,8,0,8,0,0
-1,131210118021036.000000000000000,Block 1036, Block Group 1, Census Tract 118.02, Fulton County, Georgia,8,1,7,7,0,5,0,0
-1,131210119022006.000000000000000,Block 2006, Block Group 2, Census Tract 119.02, Fulton County, Georgia,8,2,6,2,1,0,0,4
-1,131210120002011.000000000000000,Block 2011, Block Group 2, Census Tract 120, Fulton County, Georgia,8,0,8,8,3,5,0,0
-1,131210123003005.000000000000000,Block 3005, Block Group 3, Census Tract 123, Fulton County, Georgia,8,1,7,5,0,5,0,2
-1,131210123004020.000000000000000,Block 4020, Block Group 4, Census Tract 123, Fulton County, Georgia,8,3,5,4,2,2,0,1
-1,131210006011017.000000000000000,Block 1017, Block Group 1, Census Tract 6.01, Fulton County, Georgia,7,0,7,3,0,2,0,4
-1,131210006023000.000000000000000,Block 3000, Block Group 3, Census Tract 6.02, Fulton County, Georgia,7,5,2,2,0,2,0,0
-1,131210007001000.000000000000000,Block 1000, Block Group 1, Census Tract 7, Fulton County, Georgia,7,0,7,5,4,1,0,2
-1,131210023001001.000000000000000,Block 1001, Block Group 1, Census Tract 23, Fulton County, Georgia,7,0,7,7,0,5,0,0
-1,131210023001013.000000000000000,Block 1013, Block Group 1, Census Tract 23, Fulton County, Georgia,7,0,7,7,0,7,0,0
-1,131210023002013.000000000000000,Block 2013, Block Group 2, Census Tract 23, Fulton County, Georgia,7,1,6,6,0,6,0,0
-1,131210025002005.000000000000000,Block 2005, Block Group 2, Census Tract 25, Fulton County, Georgia,7,0,7,7,0,6,1,0
-1,131210026001015.000000000000000,Block 1015, Block Group 1, Census Tract 26, Fulton County, Georgia,7,3,4,4,0,4,0,0
-1,131210026002019.000000000000000,Block 2019, Block Group 2, Census Tract 26, Fulton County, Georgia,7,1,6,4,2,2,0,2
-1,131210031002005.000000000000000,Block 2005, Block Group 2, Census Tract 31, Fulton County, Georgia,7,3,4,2,1,0,0,2
-1,131210035001007.000000000000000,Block 1007, Block Group 1, Census Tract 35, Fulton County, Georgia,7,0,7,1,0,1,0,6
-1,131210035001025.000000000000000,Block 1025, Block Group 1, Census Tract 35, Fulton County, Georgia,7,1,6,3,0,0,3,3
-1,131210038001001.000000000000000,Block 1001, Block Group 1, Census Tract 38, Fulton County, Georgia,7,0,7,7,0,6,0,0
-1,131210039002006.000000000000000,Block 2006, Block Group 2, Census Tract 39, Fulton County, Georgia,7,0,7,7,0,4,3,0
-1,131210042003001.000000000000000,Block 3001, Block Group 3, Census Tract 42, Fulton County, Georgia,7,0,7,7,0,7,0,0
-1,131210044002024.000000000000000,Block 2024, Block Group 2, Census Tract 44, Fulton County, Georgia,7,0,7,6,2,4,0,1
-1,131210048001003.000000000000000,Block 1003, Block Group 1, Census Tract 48, Fulton County, Georgia,7,3,4,1,1,0,0,3
-1,131210053002000.000000000000000,Block 2000, Block Group 2, Census Tract 53, Fulton County, Georgia,7,1,6,5,3,0,0,1
-1,131210053002006.000000000000000,Block 2006, Block Group 2, Census Tract 53, Fulton County, Georgia,7,0,7,5,4,0,0,2
-1,131210055011008.000000000000000,Block 1008, Block Group 1, Census Tract 55.01, Fulton County, Georgia,7,0,7,6,4,1,0,1
-1,131210063002006.000000000000000,Block 2006, Block Group 2, Census Tract 63, Fulton County, Georgia,7,1,6,3,0,1,0,3
-1,131210065002017.000000000000000,Block 2017, Block Group 2, Census Tract 65, Fulton County, Georgia,7,2,5,5,1,4,0,0
-1,131210067021016.000000000000000,Block 1016, Block Group 1, Census Tract 67.02, Fulton County, Georgia,7,2,5,5,3,2,0,0
-1,131210074001010.000000000000000,Block 1010, Block Group 1, Census Tract 74, Fulton County, Georgia,7,6,1,1,0,1,0,0
-1,131210078052006.000000000000000,Block 2006, Block Group 2, Census Tract 78.05, Fulton County, Georgia,7,1,6,3,0,3,0,3
-1,131210079004020.000000000000000,Block 4020, Block Group 4, Census Tract 79, Fulton County, Georgia,7,0,7,7,1,6,0,0
-1,131210086012003.000000000000000,Block 2003, Block Group 2, Census Tract 86.01, Fulton County, Georgia,7,0,7,6,0,6,0,1
-1,131210088022007.000000000000000,Block 2007, Block Group 2, Census Tract 88.02, Fulton County, Georgia,7,0,7,5,3,1,0,2
-1,131210089054016.000000000000000,Block 4016, Block Group 4, Census Tract 89.05, Fulton County, Georgia,7,1,6,4,0,4,0,2
-1,131210097002015.000000000000000,Block 2015, Block Group 2, Census Tract 97, Fulton County, Georgia,7,5,2,2,1,0,1,0
-1,131210103051005.000000000000000,Block 1005, Block Group 1, Census Tract 103.05, Fulton County, Georgia,7,0,7,7,0,7,0,0
-1,131210103074010.000000000000000,Block 4010, Block Group 4, Census Tract 103.07, Fulton County, Georgia,7,0,7,2,1,0,0,5
-1,131210103074012.000000000000000,Block 4012, Block Group 4, Census Tract 103.07, Fulton County, Georgia,7,0,7,7,0,7,0,0
-1,131210103082007.000000000000000,Block 2007, Block Group 2, Census Tract 103.08, Fulton County, Georgia,7,3,4,3,3,0,0,1
-1,131210103091004.000000000000000,Block 1004, Block Group 1, Census Tract 103.09, Fulton County, Georgia,7,0,7,7,6,1,0,0
-1,131210103101001.000000000000000,Block 1001, Block Group 1, Census Tract 103.10, Fulton County, Georgia,7,3,4,4,4,0,0,0
-1,131210103122022.000000000000000,Block 2022, Block Group 2, Census Tract 103.12, Fulton County, Georgia,7,0,7,7,0,7,0,0
-1,131210103122039.000000000000000,Block 2039, Block Group 2, Census Tract 103.12, Fulton County, Georgia,7,0,7,2,0,1,1,5
-1,131210104022009.000000000000000,Block 2009, Block Group 2, Census Tract 104.02, Fulton County, Georgia,7,3,4,3,1,2,0,1
-1,131210104022014.000000000000000,Block 2014, Block Group 2, Census Tract 104.02, Fulton County, Georgia,7,1,6,6,0,5,1,0
-1,131210104022018.000000000000000,Block 2018, Block Group 2, Census Tract 104.02, Fulton County, Georgia,7,0,7,6,6,0,0,1
-1,131210104022067.000000000000000,Block 2067, Block Group 2, Census Tract 104.02, Fulton County, Georgia,7,3,4,4,1,3,0,0
-1,131210104023035.000000000000000,Block 3035, Block Group 3, Census Tract 104.02, Fulton County, Georgia,7,0,7,6,6,0,0,1
-1,131210105191011.000000000000000,Block 1011, Block Group 1, Census Tract 105.19, Fulton County, Georgia,7,3,4,4,4,0,0,0
-1,131210105192003.000000000000000,Block 2003, Block Group 2, Census Tract 105.19, Fulton County, Georgia,7,0,7,7,0,6,0,0
-1,131210105212005.000000000000000,Block 2005, Block Group 2, Census Tract 105.21, Fulton County, Georgia,7,2,5,5,0,4,1,0
-1,131210105231029.000000000000000,Block 1029, Block Group 1, Census Tract 105.23, Fulton County, Georgia,7,2,5,4,0,4,0,1
-1,131210105261011.000000000000000,Block 1011, Block Group 1, Census Tract 105.26, Fulton County, Georgia,7,3,4,4,0,1,3,0
-1,131210105263012.000000000000000,Block 3012, Block Group 3, Census Tract 105.26, Fulton County, Georgia,7,3,4,1,0,0,0,3
-1,131210105271002.000000000000000,Block 1002, Block Group 1, Census Tract 105.27, Fulton County, Georgia,7,5,2,0,0,0,0,2
-1,131210105281012.000000000000000,Block 1012, Block Group 1, Census Tract 105.28, Fulton County, Georgia,7,0,7,6,0,3,3,1
-1,131210105281018.000000000000000,Block 1018, Block Group 1, Census Tract 105.28, Fulton County, Georgia,7,3,4,4,0,3,0,0
-1,131210105282011.000000000000000,Block 2011, Block Group 2, Census Tract 105.28, Fulton County, Georgia,7,0,7,7,0,6,0,0
-1,131210105302023.000000000000000,Block 2023, Block Group 2, Census Tract 105.30, Fulton County, Georgia,7,1,6,5,0,5,0,1
-1,131210105351006.000000000000000,Block 1006, Block Group 1, Census Tract 105.35, Fulton County, Georgia,7,1,6,6,1,5,0,0
-1,131210105402012.000000000000000,Block 2012, Block Group 2, Census Tract 105.40, Fulton County, Georgia,7,6,1,0,0,0,0,1
-1,131210106011001.000000000000000,Block 1001, Block Group 1, Census Tract 106.01, Fulton County, Georgia,7,0,7,7,5,2,0,0
-1,131210106032001.000000000000000,Block 2001, Block Group 2, Census Tract 106.03, Fulton County, Georgia,7,1,6,6,0,5,0,0
-1,131210106034001.000000000000000,Block 4001, Block Group 4, Census Tract 106.03, Fulton County, Georgia,7,4,3,2,1,1,0,1
-1,131210108013020.000000000000000,Block 3020, Block Group 3, Census Tract 108.01, Fulton County, Georgia,7,1,6,6,2,4,0,0
-1,131210113015007.000000000000000,Block 5007, Block Group 5, Census Tract 113.01, Fulton County, Georgia,7,7,0,0,0,0,0,0
-1,131210116402012.000000000000000,Block 2012, Block Group 2, Census Tract 116.40, Fulton County, Georgia,7,4,3,3,1,2,0,0
-1,131210116472001.000000000000000,Block 2001, Block Group 2, Census Tract 116.47, Fulton County, Georgia,7,5,2,0,0,0,0,2
-1,131210116472010.000000000000000,Block 2010, Block Group 2, Census Tract 116.47, Fulton County, Georgia,7,1,6,6,3,3,0,0
-1,131210116551001.000000000000000,Block 1001, Block Group 1, Census Tract 116.55, Fulton County, Georgia,7,0,7,5,1,2,0,2
-1,131210118021032.000000000000000,Block 1032, Block Group 1, Census Tract 118.02, Fulton County, Georgia,7,0,7,7,0,7,0,0
-1,131210120001012.000000000000000,Block 1012, Block Group 1, Census Tract 120, Fulton County, Georgia,7,3,4,2,0,2,0,2
-1,131210123002056.000000000000000,Block 2056, Block Group 2, Census Tract 123, Fulton County, Georgia,7,1,6,6,1,5,0,0
-1,131210123003027.000000000000000,Block 3027, Block Group 3, Census Tract 123, Fulton County, Georgia,7,3,4,4,4,0,0,0
-1,131210123004001.000000000000000,Block 4001, Block Group 4, Census Tract 123, Fulton County, Georgia,7,3,4,4,0,4,0,0
-1,131210005022031.000000000000000,Block 2031, Block Group 2, Census Tract 5.02, Fulton County, Georgia,6,0,6,5,4,1,0,1
-1,131210019011005.000000000000000,Block 1005, Block Group 1, Census Tract 19.01, Fulton County, Georgia,6,2,4,0,0,0,0,4
-1,131210021001019.000000000000000,Block 1019, Block Group 1, Census Tract 21, Fulton County, Georgia,6,4,2,1,1,0,0,1
-1,131210023001014.000000000000000,Block 1014, Block Group 1, Census Tract 23, Fulton County, Georgia,6,4,2,2,0,2,0,0
-1,131210023002004.000000000000000,Block 2004, Block Group 2, Census Tract 23, Fulton County, Georgia,6,0,6,5,0,5,0,1
-1,131210023003014.000000000000000,Block 3014, Block Group 3, Census Tract 23, Fulton County, Georgia,6,0,6,6,3,1,0,0
-1,131210025001004.000000000000000,Block 1004, Block Group 1, Census Tract 25, Fulton County, Georgia,6,1,5,3,1,2,0,2
-1,131210039001012.000000000000000,Block 1012, Block Group 1, Census Tract 39, Fulton County, Georgia,6,2,4,2,0,2,0,2
-1,131210040001024.000000000000000,Block 1024, Block Group 1, Census Tract 40, Fulton County, Georgia,6,1,5,5,0,5,0,0
-1,131210061002000.000000000000000,Block 2000, Block Group 2, Census Tract 61, Fulton County, Georgia,6,0,6,3,0,3,0,3
-1,131210061002006.000000000000000,Block 2006, Block Group 2, Census Tract 61, Fulton County, Georgia,6,0,6,5,1,4,0,1
-1,131210063001030.000000000000000,Block 1030, Block Group 1, Census Tract 63, Fulton County, Georgia,6,1,5,3,0,3,0,2
-1,131210066021010.000000000000000,Block 1010, Block Group 1, Census Tract 66.02, Fulton County, Georgia,6,2,4,3,0,3,0,1
-1,131210067021044.000000000000000,Block 1044, Block Group 1, Census Tract 67.02, Fulton County, Georgia,6,0,6,6,4,2,0,0
-1,131210071001013.000000000000000,Block 1013, Block Group 1, Census Tract 71, Fulton County, Georgia,6,0,6,5,0,3,0,1
-1,131210075001008.000000000000000,Block 1008, Block Group 1, Census Tract 75, Fulton County, Georgia,6,2,4,4,2,2,0,0
-1,131210076041006.000000000000000,Block 1006, Block Group 1, Census Tract 76.04, Fulton County, Georgia,6,1,5,1,1,0,0,4
-1,131210078051018.000000000000000,Block 1018, Block Group 1, Census Tract 78.05, Fulton County, Georgia,6,0,6,3,1,2,0,3
-1,131210078103004.000000000000000,Block 3004, Block Group 3, Census Tract 78.10, Fulton County, Georgia,6,0,6,5,0,5,0,1
-1,131210082021001.000000000000000,Block 1001, Block Group 1, Census Tract 82.02, Fulton County, Georgia,6,0,6,5,0,5,0,1
-1,131210086011007.000000000000000,Block 1007, Block Group 1, Census Tract 86.01, Fulton County, Georgia,6,0,6,6,0,3,0,0
-1,131210086012000.000000000000000,Block 2000, Block Group 2, Census Tract 86.01, Fulton County, Georgia,6,1,5,5,0,5,0,0
-1,131210095041012.000000000000000,Block 1012, Block Group 1, Census Tract 95.04, Fulton County, Georgia,6,1,5,1,1,0,0,4
-1,131210098021004.000000000000000,Block 1004, Block Group 1, Census Tract 98.02, Fulton County, Georgia,6,0,6,6,4,0,0,0
-1,131210098023005.000000000000000,Block 3005, Block Group 3, Census Tract 98.02, Fulton County, Georgia,6,2,4,3,0,1,0,1
-1,131210103111024.000000000000000,Block 1024, Block Group 1, Census Tract 103.11, Fulton County, Georgia,6,1,5,5,0,5,0,0
-1,131210103122001.000000000000000,Block 2001, Block Group 2, Census Tract 103.12, Fulton County, Georgia,6,5,1,0,0,0,0,1
-1,131210104022055.000000000000000,Block 2055, Block Group 2, Census Tract 104.02, Fulton County, Georgia,6,0,6,6,5,1,0,0
-1,131210104022070.000000000000000,Block 2070, Block Group 2, Census Tract 104.02, Fulton County, Georgia,6,0,6,5,5,0,0,1
-1,131210104023039.000000000000000,Block 3039, Block Group 3, Census Tract 104.02, Fulton County, Georgia,6,2,4,4,3,0,0,0
-1,131210105203035.000000000000000,Block 3035, Block Group 3, Census Tract 105.20, Fulton County, Georgia,6,0,6,6,1,5,0,0
-1,131210105262000.000000000000000,Block 2000, Block Group 2, Census Tract 105.26, Fulton County, Georgia,6,0,6,1,0,1,0,5
-1,131210105262015.000000000000000,Block 2015, Block Group 2, Census Tract 105.26, Fulton County, Georgia,6,1,5,4,1,3,0,1
-1,131210105264004.000000000000000,Block 4004, Block Group 4, Census Tract 105.26, Fulton County, Georgia,6,0,6,6,2,3,1,0
-1,131210105283019.000000000000000,Block 3019, Block Group 3, Census Tract 105.28, Fulton County, Georgia,6,2,4,4,4,0,0,0
-1,131210105292017.000000000000000,Block 2017, Block Group 2, Census Tract 105.29, Fulton County, Georgia,6,2,4,4,3,0,0,0
-1,131210105293014.000000000000000,Block 3014, Block Group 3, Census Tract 105.29, Fulton County, Georgia,6,0,6,5,2,2,1,1
-1,131210105343019.000000000000000,Block 3019, Block Group 3, Census Tract 105.34, Fulton County, Georgia,6,0,6,6,1,3,2,0
-1,131210105371014.000000000000000,Block 1014, Block Group 1, Census Tract 105.37, Fulton County, Georgia,6,0,6,6,0,5,1,0
-1,131210105392016.000000000000000,Block 2016, Block Group 2, Census Tract 105.39, Fulton County, Georgia,6,1,5,4,0,2,0,1
-1,131210105402035.000000000000000,Block 2035, Block Group 2, Census Tract 105.40, Fulton County, Georgia,6,0,6,4,0,3,1,2
-1,131210106034021.000000000000000,Block 4021, Block Group 4, Census Tract 106.03, Fulton County, Georgia,6,1,5,4,0,4,0,1
-1,131210113061029.000000000000000,Block 1029, Block Group 1, Census Tract 113.06, Fulton County, Georgia,6,4,2,1,0,1,0,1
-1,131210114301004.000000000000000,Block 1004, Block Group 1, Census Tract 114.30, Fulton County, Georgia,6,3,3,0,0,0,0,3
-1,131210114451007.000000000000000,Block 1007, Block Group 1, Census Tract 114.45, Fulton County, Georgia,6,3,3,3,3,0,0,0
-1,131210115142002.000000000000000,Block 2002, Block Group 2, Census Tract 115.14, Fulton County, Georgia,6,1,5,5,5,0,0,0
-1,131210116551004.000000000000000,Block 1004, Block Group 1, Census Tract 116.55, Fulton County, Georgia,6,3,3,3,1,1,0,0
-1,131210118021026.000000000000000,Block 1026, Block Group 1, Census Tract 118.02, Fulton County, Georgia,6,1,5,5,0,4,0,0
-1,131210119022004.000000000000000,Block 2004, Block Group 2, Census Tract 119.02, Fulton County, Georgia,6,1,5,4,0,4,0,1
-1,131210120003003.000000000000000,Block 3003, Block Group 3, Census Tract 120, Fulton County, Georgia,6,0,6,5,3,2,0,1
-1,131210123002009.000000000000000,Block 2009, Block Group 2, Census Tract 123, Fulton County, Georgia,6,5,1,1,1,0,0,0
-1,131210007001027.000000000000000,Block 1027, Block Group 1, Census Tract 7, Fulton County, Georgia,5,0,5,5,5,0,0,0
-1,131210010012017.000000000000000,Block 2017, Block Group 2, Census Tract 10.01, Fulton County, Georgia,5,2,3,0,0,0,0,3
-1,131210019022000.000000000000000,Block 2000, Block Group 2, Census Tract 19.02, Fulton County, Georgia,5,2,3,0,0,0,0,3
-1,131210023002008.000000000000000,Block 2008, Block Group 2, Census Tract 23, Fulton County, Georgia,5,0,5,5,0,4,0,0
-1,131210023003006.000000000000000,Block 3006, Block Group 3, Census Tract 23, Fulton County, Georgia,5,3,2,2,0,2,0,0
-1,131210031001023.000000000000000,Block 1023, Block Group 1, Census Tract 31, Fulton County, Georgia,5,0,5,4,0,4,0,1
-1,131210035002024.000000000000000,Block 2024, Block Group 2, Census Tract 35, Fulton County, Georgia,5,4,1,0,0,0,0,1
-1,131210038001019.000000000000000,Block 1019, Block Group 1, Census Tract 38, Fulton County, Georgia,5,0,5,5,3,2,0,0
-1,131210040001010.000000000000000,Block 1010, Block Group 1, Census Tract 40, Fulton County, Georgia,5,4,1,0,0,0,0,1
-1,131210043003005.000000000000000,Block 3005, Block Group 3, Census Tract 43, Fulton County, Georgia,5,0,5,4,0,4,0,1
-1,131210044001001.000000000000000,Block 1001, Block Group 1, Census Tract 44, Fulton County, Georgia,5,0,5,5,2,0,0,0
-1,131210058001018.000000000000000,Block 1018, Block Group 1, Census Tract 58, Fulton County, Georgia,5,2,3,3,3,0,0,0
-1,131210058001024.000000000000000,Block 1024, Block Group 1, Census Tract 58, Fulton County, Georgia,5,0,5,4,1,3,0,1
-1,131210072002003.000000000000000,Block 2003, Block Group 2, Census Tract 72, Fulton County, Georgia,5,0,5,5,0,5,0,0
-1,131210078053019.000000000000000,Block 3019, Block Group 3, Census Tract 78.05, Fulton County, Georgia,5,3,2,1,0,1,0,1
-1,131210081032002.000000000000000,Block 2002, Block Group 2, Census Tract 81.03, Fulton County, Georgia,5,2,3,2,0,2,0,1
-1,131210083011019.000000000000000,Block 1019, Block Group 1, Census Tract 83.01, Fulton County, Georgia,5,0,5,5,4,1,0,0
-1,131210085003014.000000000000000,Block 3014, Block Group 3, Census Tract 85, Fulton County, Georgia,5,3,2,2,2,0,0,0
-1,131210089062014.000000000000000,Block 2014, Block Group 2, Census Tract 89.06, Fulton County, Georgia,5,1,4,4,0,4,0,0
-1,131210102114016.000000000000000,Block 4016, Block Group 4, Census Tract 102.11, Fulton County, Georgia,5,0,5,5,3,0,0,0
-1,131210103052012.000000000000000,Block 2012, Block Group 2, Census Tract 103.05, Fulton County, Georgia,5,2,3,0,0,0,0,3
-1,131210103063016.000000000000000,Block 3016, Block Group 3, Census Tract 103.06, Fulton County, Georgia,5,1,4,3,2,0,1,1
-1,131210103091037.000000000000000,Block 1037, Block Group 1, Census Tract 103.09, Fulton County, Georgia,5,0,5,3,1,2,0,2
-1,131210104011004.000000000000000,Block 1004, Block Group 1, Census Tract 104.01, Fulton County, Georgia,5,0,5,2,2,0,0,3
-1,131210104011029.000000000000000,Block 1029, Block Group 1, Census Tract 104.01, Fulton County, Georgia,5,2,3,2,1,1,0,1
-1,131210104013022.000000000000000,Block 3022, Block Group 3, Census Tract 104.01, Fulton County, Georgia,5,0,5,0,0,0,0,5
-1,131210104013048.000000000000000,Block 3048, Block Group 3, Census Tract 104.01, Fulton County, Georgia,5,0,5,3,0,3,0,2
-1,131210104023024.000000000000000,Block 3024, Block Group 3, Census Tract 104.02, Fulton County, Georgia,5,2,3,2,2,0,0,1
-1,131210105191044.000000000000000,Block 1044, Block Group 1, Census Tract 105.19, Fulton County, Georgia,5,1,4,4,3,1,0,0
-1,131210105201013.000000000000000,Block 1013, Block Group 1, Census Tract 105.20, Fulton County, Georgia,5,3,2,0,0,0,0,2
-1,131210105201022.000000000000000,Block 1022, Block Group 1, Census Tract 105.20, Fulton County, Georgia,5,3,2,0,0,0,0,2
-1,131210105212001.000000000000000,Block 2001, Block Group 2, Census Tract 105.21, Fulton County, Georgia,5,0,5,5,0,4,1,0
-1,131210105222003.000000000000000,Block 2003, Block Group 2, Census Tract 105.22, Fulton County, Georgia,5,1,4,4,0,0,2,0
-1,131210105223007.000000000000000,Block 3007, Block Group 3, Census Tract 105.22, Fulton County, Georgia,5,1,4,4,0,3,1,0
-1,131210105271000.000000000000000,Block 1000, Block Group 1, Census Tract 105.27, Fulton County, Georgia,5,3,2,1,0,0,1,1
-1,131210105281021.000000000000000,Block 1021, Block Group 1, Census Tract 105.28, Fulton County, Georgia,5,2,3,3,2,1,0,0
-1,131210105352006.000000000000000,Block 2006, Block Group 2, Census Tract 105.35, Fulton County, Georgia,5,1,4,4,2,2,0,0
-1,131210105352021.000000000000000,Block 2021, Block Group 2, Census Tract 105.35, Fulton County, Georgia,5,0,5,5,0,5,0,0
-1,131210105361010.000000000000000,Block 1010, Block Group 1, Census Tract 105.36, Fulton County, Georgia,5,1,4,4,0,1,2,0
-1,131210105382023.000000000000000,Block 2023, Block Group 2, Census Tract 105.38, Fulton County, Georgia,5,0,5,5,2,2,0,0
-1,131210105382029.000000000000000,Block 2029, Block Group 2, Census Tract 105.38, Fulton County, Georgia,5,2,3,1,0,1,0,2
-1,131210105391033.000000000000000,Block 1033, Block Group 1, Census Tract 105.39, Fulton County, Georgia,5,1,4,4,2,0,0,0
-1,131210105392017.000000000000000,Block 2017, Block Group 2, Census Tract 105.39, Fulton County, Georgia,5,0,5,5,0,5,0,0
-1,131210105402009.000000000000000,Block 2009, Block Group 2, Census Tract 105.40, Fulton County, Georgia,5,2,3,2,2,0,0,1
-1,131210106012012.000000000000000,Block 2012, Block Group 2, Census Tract 106.01, Fulton County, Georgia,5,2,3,3,0,0,0,0
-1,131210108012004.000000000000000,Block 2004, Block Group 2, Census Tract 108.01, Fulton County, Georgia,5,5,0,0,0,0,0,0
-1,131210112032023.000000000000000,Block 2023, Block Group 2, Census Tract 112.03, Fulton County, Georgia,5,0,5,3,0,1,2,2
-1,131210114163002.000000000000000,Block 3002, Block Group 3, Census Tract 114.16, Fulton County, Georgia,5,3,2,2,0,1,1,0
-1,131210115052004.000000000000000,Block 2004, Block Group 2, Census Tract 115.05, Fulton County, Georgia,5,0,5,5,0,5,0,0
-1,131210115092006.000000000000000,Block 2006, Block Group 2, Census Tract 115.09, Fulton County, Georgia,5,1,4,2,1,1,0,2
-1,131210115122023.000000000000000,Block 2023, Block Group 2, Census Tract 115.12, Fulton County, Georgia,5,0,5,3,0,2,0,2
-1,131210115122027.000000000000000,Block 2027, Block Group 2, Census Tract 115.12, Fulton County, Georgia,5,0,5,3,2,0,1,2
-1,131210116353017.000000000000000,Block 3017, Block Group 3, Census Tract 116.35, Fulton County, Georgia,5,0,5,5,0,0,0,0
-1,131210118022003.000000000000000,Block 2003, Block Group 2, Census Tract 118.02, Fulton County, Georgia,5,0,5,5,0,5,0,0
-1,131210119013024.000000000000000,Block 3024, Block Group 3, Census Tract 119.01, Fulton County, Georgia,5,1,4,4,0,4,0,0
-1,131210120002003.000000000000000,Block 2003, Block Group 2, Census Tract 120, Fulton County, Georgia,5,0,5,5,0,5,0,0
-1,131210123002019.000000000000000,Block 2019, Block Group 2, Census Tract 123, Fulton County, Georgia,5,3,2,1,1,0,0,1
-1,131210123002041.000000000000000,Block 2041, Block Group 2, Census Tract 123, Fulton County, Georgia,5,0,5,5,1,4,0,0
-1,131210123003007.000000000000000,Block 3007, Block Group 3, Census Tract 123, Fulton County, Georgia,5,0,5,5,1,3,0,0
-1,131210007001031.000000000000000,Block 1031, Block Group 1, Census Tract 7, Fulton County, Georgia,4,0,4,3,0,3,0,1
-1,131210023002005.000000000000000,Block 2005, Block Group 2, Census Tract 23, Fulton County, Georgia,4,0,4,4,2,2,0,0
-1,131210023003013.000000000000000,Block 3013, Block Group 3, Census Tract 23, Fulton County, Georgia,4,0,4,0,0,0,0,4
-1,131210035001002.000000000000000,Block 1002, Block Group 1, Census Tract 35, Fulton County, Georgia,4,0,4,4,1,3,0,0
-1,131210038001005.000000000000000,Block 1005, Block Group 1, Census Tract 38, Fulton County, Georgia,4,1,3,3,0,3,0,0
-1,131210039002014.000000000000000,Block 2014, Block Group 2, Census Tract 39, Fulton County, Georgia,4,0,4,4,0,4,0,0
-1,131210042003014.000000000000000,Block 3014, Block Group 3, Census Tract 42, Fulton County, Georgia,4,0,4,4,3,1,0,0
-1,131210055011007.000000000000000,Block 1007, Block Group 1, Census Tract 55.01, Fulton County, Georgia,4,0,4,4,0,4,0,0
-1,131210055041018.000000000000000,Block 1018, Block Group 1, Census Tract 55.04, Fulton County, Georgia,4,1,3,3,1,2,0,0
-1,131210067021010.000000000000000,Block 1010, Block Group 1, Census Tract 67.02, Fulton County, Georgia,4,0,4,3,0,3,0,1
-1,131210070024002.000000000000000,Block 4002, Block Group 4, Census Tract 70.02, Fulton County, Georgia,4,0,4,4,0,4,0,0
-1,131210077052000.000000000000000,Block 2000, Block Group 2, Census Tract 77.05, Fulton County, Georgia,4,3,1,0,0,0,0,1
-1,131210078052003.000000000000000,Block 2003, Block Group 2, Census Tract 78.05, Fulton County, Georgia,4,0,4,3,0,0,0,1
-1,131210078053023.000000000000000,Block 3023, Block Group 3, Census Tract 78.05, Fulton County, Georgia,4,0,4,4,2,2,0,0
-1,131210085003015.000000000000000,Block 3015, Block Group 3, Census Tract 85, Fulton County, Georgia,4,0,4,4,1,2,0,0
-1,131210086012011.000000000000000,Block 2011, Block Group 2, Census Tract 86.01, Fulton County, Georgia,4,0,4,1,1,0,0,3
-1,131210102233010.000000000000000,Block 3010, Block Group 3, Census Tract 102.23, Fulton County, Georgia,4,0,4,3,3,0,0,1
-1,131210103082014.000000000000000,Block 2014, Block Group 2, Census Tract 103.08, Fulton County, Georgia,4,0,4,3,0,3,0,1
-1,131210103092008.000000000000000,Block 2008, Block Group 2, Census Tract 103.09, Fulton County, Georgia,4,0,4,4,3,1,0,0
-1,131210103132002.000000000000000,Block 2002, Block Group 2, Census Tract 103.13, Fulton County, Georgia,4,0,4,4,0,4,0,0
-1,131210104021009.000000000000000,Block 1009, Block Group 1, Census Tract 104.02, Fulton County, Georgia,4,0,4,4,2,0,2,0
-1,131210104021014.000000000000000,Block 1014, Block Group 1, Census Tract 104.02, Fulton County, Georgia,4,0,4,4,3,0,0,0
-1,131210104023016.000000000000000,Block 3016, Block Group 3, Census Tract 104.02, Fulton County, Georgia,4,0,4,3,3,0,0,1
-1,131210104023066.000000000000000,Block 3066, Block Group 3, Census Tract 104.02, Fulton County, Georgia,4,0,4,3,3,0,0,1
-1,131210105083009.000000000000000,Block 3009, Block Group 3, Census Tract 105.08, Fulton County, Georgia,4,0,4,2,0,0,0,2
-1,131210105191016.000000000000000,Block 1016, Block Group 1, Census Tract 105.19, Fulton County, Georgia,4,1,3,2,0,1,0,1
-1,131210105191017.000000000000000,Block 1017, Block Group 1, Census Tract 105.19, Fulton County, Georgia,4,1,3,3,2,0,0,0
-1,131210105201002.000000000000000,Block 1002, Block Group 1, Census Tract 105.20, Fulton County, Georgia,4,3,1,1,0,1,0,0
-1,131210105203010.000000000000000,Block 3010, Block Group 3, Census Tract 105.20, Fulton County, Georgia,4,1,3,1,0,0,0,2
-1,131210105262013.000000000000000,Block 2013, Block Group 2, Census Tract 105.26, Fulton County, Georgia,4,1,3,3,0,0,2,0
-1,131210105301016.000000000000000,Block 1016, Block Group 1, Census Tract 105.30, Fulton County, Georgia,4,0,4,3,0,3,0,1
-1,131210105352022.000000000000000,Block 2022, Block Group 2, Census Tract 105.35, Fulton County, Georgia,4,0,4,3,3,0,0,1
-1,131210105381015.000000000000000,Block 1015, Block Group 1, Census Tract 105.38, Fulton County, Georgia,4,3,1,1,0,0,0,0
-1,131210106012006.000000000000000,Block 2006, Block Group 2, Census Tract 106.01, Fulton County, Georgia,4,0,4,4,0,4,0,0
-1,131210114223012.000000000000000,Block 3012, Block Group 3, Census Tract 114.22, Fulton County, Georgia,4,2,2,0,0,0,0,2
-1,131210114452001.000000000000000,Block 2001, Block Group 2, Census Tract 114.45, Fulton County, Georgia,4,0,4,3,3,0,0,1
-1,131210115122016.000000000000000,Block 2016, Block Group 2, Census Tract 115.12, Fulton County, Georgia,4,1,3,1,1,0,0,2
-1,131210115122018.000000000000000,Block 2018, Block Group 2, Census Tract 115.12, Fulton County, Georgia,4,0,4,1,1,0,0,3
-1,131210115122028.000000000000000,Block 2028, Block Group 2, Census Tract 115.12, Fulton County, Georgia,4,1,3,2,1,0,1,1
-1,131210118011008.000000000000000,Block 1008, Block Group 1, Census Tract 118.01, Fulton County, Georgia,4,1,3,1,0,0,1,2
-1,131210118021018.000000000000000,Block 1018, Block Group 1, Census Tract 118.02, Fulton County, Georgia,4,0,4,4,0,4,0,0
-1,131210118021035.000000000000000,Block 1035, Block Group 1, Census Tract 118.02, Fulton County, Georgia,4,1,3,3,0,3,0,0
-1,131210118022018.000000000000000,Block 2018, Block Group 2, Census Tract 118.02, Fulton County, Georgia,4,2,2,2,0,2,0,0
-1,131210120003028.000000000000000,Block 3028, Block Group 3, Census Tract 120, Fulton County, Georgia,4,0,4,1,0,1,0,3
-1,131210123004004.000000000000000,Block 4004, Block Group 4, Census Tract 123, Fulton County, Georgia,4,0,4,2,0,2,0,2
-1,131210023002007.000000000000000,Block 2007, Block Group 2, Census Tract 23, Fulton County, Georgia,3,0,3,1,0,1,0,2
-1,131210023003004.000000000000000,Block 3004, Block Group 3, Census Tract 23, Fulton County, Georgia,3,0,3,3,0,3,0,0
-1,131210028021001.000000000000000,Block 1001, Block Group 1, Census Tract 28.02, Fulton County, Georgia,3,0,3,3,0,3,0,0
-1,131210067021046.000000000000000,Block 1046, Block Group 1, Census Tract 67.02, Fulton County, Georgia,3,3,0,0,0,0,0,0
-1,131210078092019.000000000000000,Block 2019, Block Group 2, Census Tract 78.09, Fulton County, Georgia,3,0,3,3,0,3,0,0
-1,131210083011002.000000000000000,Block 1002, Block Group 1, Census Tract 83.01, Fulton County, Georgia,3,1,2,1,0,1,0,1
-1,131210089054012.000000000000000,Block 4012, Block Group 4, Census Tract 89.05, Fulton County, Georgia,3,2,1,0,0,0,0,1
-1,131210103091012.000000000000000,Block 1012, Block Group 1, Census Tract 103.09, Fulton County, Georgia,3,0,3,2,0,2,0,1
-1,131210104011038.000000000000000,Block 1038, Block Group 1, Census Tract 104.01, Fulton County, Georgia,3,3,0,0,0,0,0,0
-1,131210104013029.000000000000000,Block 3029, Block Group 3, Census Tract 104.01, Fulton County, Georgia,3,1,2,2,0,0,0,0
-1,131210104013045.000000000000000,Block 3045, Block Group 3, Census Tract 104.01, Fulton County, Georgia,3,1,2,1,0,1,0,1
-1,131210104021025.000000000000000,Block 1025, Block Group 1, Census Tract 104.02, Fulton County, Georgia,3,2,1,0,0,0,0,1
-1,131210104023020.000000000000000,Block 3020, Block Group 3, Census Tract 104.02, Fulton County, Georgia,3,0,3,3,2,0,0,0
-1,131210105203041.000000000000000,Block 3041, Block Group 3, Census Tract 105.20, Fulton County, Georgia,3,2,1,1,0,0,0,0
-1,131210105262009.000000000000000,Block 2009, Block Group 2, Census Tract 105.26, Fulton County, Georgia,3,0,3,2,1,0,1,1
-1,131210105264008.000000000000000,Block 4008, Block Group 4, Census Tract 105.26, Fulton County, Georgia,3,1,2,2,0,2,0,0
-1,131210105292016.000000000000000,Block 2016, Block Group 2, Census Tract 105.29, Fulton County, Georgia,3,1,2,1,1,0,0,1
-1,131210105312015.000000000000000,Block 2015, Block Group 2, Census Tract 105.31, Fulton County, Georgia,3,1,2,2,0,2,0,0
-1,131210105322009.000000000000000,Block 2009, Block Group 2, Census Tract 105.32, Fulton County, Georgia,3,0,3,3,0,3,0,0
-1,131210105362006.000000000000000,Block 2006, Block Group 2, Census Tract 105.36, Fulton County, Georgia,3,1,2,1,0,1,0,1
-1,131210108013035.000000000000000,Block 3035, Block Group 3, Census Tract 108.01, Fulton County, Georgia,3,2,1,0,0,0,0,1
-1,131210110003003.000000000000000,Block 3003, Block Group 3, Census Tract 110, Fulton County, Georgia,3,1,2,2,0,1,0,0
-1,131210114323004.000000000000000,Block 3004, Block Group 3, Census Tract 114.32, Fulton County, Georgia,3,2,1,0,0,0,0,1
-1,131210115071007.000000000000000,Block 1007, Block Group 1, Census Tract 115.07, Fulton County, Georgia,3,2,1,0,0,0,0,1
-1,131210118022009.000000000000000,Block 2009, Block Group 2, Census Tract 118.02, Fulton County, Georgia,3,1,2,1,0,1,0,1
-1,131210119013022.000000000000000,Block 3022, Block Group 3, Census Tract 119.01, Fulton County, Georgia,3,0,3,2,0,2,0,1
-1,131210123001006.000000000000000,Block 1006, Block Group 1, Census Tract 123, Fulton County, Georgia,3,0,3,3,2,1,0,0
-1,131210123002020.000000000000000,Block 2020, Block Group 2, Census Tract 123, Fulton County, Georgia,3,1,2,1,1,0,0,1
-1,131210021003005.000000000000000,Block 3005, Block Group 3, Census Tract 21, Fulton County, Georgia,2,1,1,1,1,0,0,0
-1,131210023001009.000000000000000,Block 1009, Block Group 1, Census Tract 23, Fulton County, Georgia,2,0,2,2,1,1,0,0
-1,131210028021005.000000000000000,Block 1005, Block Group 1, Census Tract 28.02, Fulton County, Georgia,2,0,2,2,0,2,0,0
-1,131210041003012.000000000000000,Block 3012, Block Group 3, Census Tract 41, Fulton County, Georgia,2,1,1,0,0,0,0,1
-1,131210042001000.000000000000000,Block 1000, Block Group 1, Census Tract 42, Fulton County, Georgia,2,0,2,1,0,1,0,1
-1,131210043001003.000000000000000,Block 1003, Block Group 1, Census Tract 43, Fulton County, Georgia,2,0,2,2,1,1,0,0
-1,131210057001012.000000000000000,Block 1012, Block Group 1, Census Tract 57, Fulton County, Georgia,2,0,2,0,0,0,0,2
-1,131210073021008.000000000000000,Block 1008, Block Group 1, Census Tract 73.02, Fulton County, Georgia,2,0,2,0,0,0,0,2
-1,131210083021005.000000000000000,Block 1005, Block Group 1, Census Tract 83.02, Fulton County, Georgia,2,2,0,0,0,0,0,0
-1,131210086012004.000000000000000,Block 2004, Block Group 2, Census Tract 86.01, Fulton County, Georgia,2,0,2,2,1,1,0,0
-1,131210089054022.000000000000000,Block 4022, Block Group 4, Census Tract 89.05, Fulton County, Georgia,2,2,0,0,0,0,0,0
-1,131210103082009.000000000000000,Block 2009, Block Group 2, Census Tract 103.08, Fulton County, Georgia,2,0,2,1,0,1,0,1
-1,131210103091006.000000000000000,Block 1006, Block Group 1, Census Tract 103.09, Fulton County, Georgia,2,0,2,2,0,2,0,0
-1,131210104013021.000000000000000,Block 3021, Block Group 3, Census Tract 104.01, Fulton County, Georgia,2,0,2,2,2,0,0,0
-1,131210104022001.000000000000000,Block 2001, Block Group 2, Census Tract 104.02, Fulton County, Georgia,2,0,2,2,0,2,0,0
-1,131210104022011.000000000000000,Block 2011, Block Group 2, Census Tract 104.02, Fulton County, Georgia,2,0,2,2,1,0,0,0
-1,131210105191043.000000000000000,Block 1043, Block Group 1, Census Tract 105.19, Fulton County, Georgia,2,2,0,0,0,0,0,0
-1,131210105201001.000000000000000,Block 1001, Block Group 1, Census Tract 105.20, Fulton County, Georgia,2,2,0,0,0,0,0,0
-1,131210105203014.000000000000000,Block 3014, Block Group 3, Census Tract 105.20, Fulton County, Georgia,2,0,2,1,0,0,0,1
-1,131210105212003.000000000000000,Block 2003, Block Group 2, Census Tract 105.21, Fulton County, Georgia,2,0,2,1,0,1,0,1
-1,131210105274007.000000000000000,Block 4007, Block Group 4, Census Tract 105.27, Fulton County, Georgia,2,2,0,0,0,0,0,0
-1,131210105351002.000000000000000,Block 1002, Block Group 1, Census Tract 105.35, Fulton County, Georgia,2,0,2,2,0,2,0,0
-1,131210105352019.000000000000000,Block 2019, Block Group 2, Census Tract 105.35, Fulton County, Georgia,2,0,2,2,1,1,0,0
-1,131210105362002.000000000000000,Block 2002, Block Group 2, Census Tract 105.36, Fulton County, Georgia,2,0,2,0,0,0,0,2
-1,131210105382028.000000000000000,Block 2028, Block Group 2, Census Tract 105.38, Fulton County, Georgia,2,1,1,0,0,0,0,1
-1,131210105402029.000000000000000,Block 2029, Block Group 2, Census Tract 105.40, Fulton County, Georgia,2,1,1,0,0,0,0,1
-1,131210111002012.000000000000000,Block 2012, Block Group 2, Census Tract 111, Fulton County, Georgia,2,1,1,1,1,0,0,0
-1,131210114451006.000000000000000,Block 1006, Block Group 1, Census Tract 114.45, Fulton County, Georgia,2,0,2,2,0,0,0,0
-1,131210118021013.000000000000000,Block 1013, Block Group 1, Census Tract 118.02, Fulton County, Georgia,2,0,2,2,0,2,0,0
-1,131210118021034.000000000000000,Block 1034, Block Group 1, Census Tract 118.02, Fulton County, Georgia,2,0,2,2,0,2,0,0
-1,131210120003043.000000000000000,Block 3043, Block Group 3, Census Tract 120, Fulton County, Georgia,2,1,1,1,1,0,0,0
-1,131210123002010.000000000000000,Block 2010, Block Group 2, Census Tract 123, Fulton County, Georgia,2,0,2,2,2,0,0,0
-1,131210023001005.000000000000000,Block 1005, Block Group 1, Census Tract 23, Fulton County, Georgia,1,0,1,1,1,0,0,0
-1,131210023002009.000000000000000,Block 2009, Block Group 2, Census Tract 23, Fulton County, Georgia,1,0,1,1,0,1,0,0
-1,131210023002011.000000000000000,Block 2011, Block Group 2, Census Tract 23, Fulton County, Georgia,1,1,0,0,0,0,0,0
-1,131210039002008.000000000000000,Block 2008, Block Group 2, Census Tract 39, Fulton County, Georgia,1,0,1,0,0,0,0,1
-1,131210067022016.000000000000000,Block 2016, Block Group 2, Census Tract 67.02, Fulton County, Georgia,1,0,1,1,0,0,1,0
-1,131210068011002.000000000000000,Block 1002, Block Group 1, Census Tract 68.01, Fulton County, Georgia,1,1,0,0,0,0,0,0
-1,131210086012024.000000000000000,Block 2024, Block Group 2, Census Tract 86.01, Fulton County, Georgia,1,1,0,0,0,0,0,0
-1,131210103092006.000000000000000,Block 2006, Block Group 2, Census Tract 103.09, Fulton County, Georgia,1,0,1,0,0,0,0,1
-1,131210103133013.000000000000000,Block 3013, Block Group 3, Census Tract 103.13, Fulton County, Georgia,1,1,0,0,0,0,0,0
-1,131210104022017.000000000000000,Block 2017, Block Group 2, Census Tract 104.02, Fulton County, Georgia,1,0,1,1,1,0,0,0
-1,131210104023048.000000000000000,Block 3048, Block Group 3, Census Tract 104.02, Fulton County, Georgia,1,1,0,0,0,0,0,0
-1,131210112023018.000000000000000,Block 3018, Block Group 3, Census Tract 112.02, Fulton County, Georgia,1,1,0,0,0,0,0,0
-1,131210118021014.000000000000000,Block 1014, Block Group 1, Census Tract 118.02, Fulton County, Georgia,1,0,1,1,0,1,0,0
-1,131210123002011.000000000000000,Block 2011, Block Group 2, Census Tract 123, Fulton County, Georgia,1,0,1,1,0,1,0,0
-1,131210001002009.000000000000000,Block 2009, Block Group 2, Census Tract 1, Fulton County, Georgia,0,0,0,0,0,0,0,0
-1,131210001004006.000000000000000,Block 4006, Block Group 4, Census Tract 1, Fulton County, Georgia,0,0,0,0,0,0,0,0
-1,131210001004011.000000000000000,Block 4011, Block Group 4, Census Tract 1, Fulton County, Georgia,0,0,0,0,0,0,0,0
-1,131210001004016.000000000000000,Block 4016, Block Group 4, Census Tract 1, Fulton County, Georgia,0,0,0,0,0,0,0,0
-1,131210001004018.000000000000000,Block 4018, Block Group 4, Census Tract 1, Fulton County, Georgia,0,0,0,0,0,0,0,0
-1,131210002011005.000000000000000,Block 1005, Block Group 1, Census Tract 2.01, Fulton County, Georgia,0,0,0,0,0,0,0,0
-1,131210002011007.000000000000000,Block 1007, Block Group 1, Census Tract 2.01, Fulton County, Georgia,0,0,0,0,0,0,0,0
-1,131210002011011.000000000000000,Block 1011, Block Group 1, Census Tract 2.01, Fulton County, Georgia,0,0,0,0,0,0,0,0
-1,131210002022009.000000000000000,Block 2009, Block Group 2, Census Tract 2.02, Fulton County, Georgia,0,0,0,0,0,0,0,0
-1,131210002023009.000000000000000,Block 3009, Block Group 3, Census Tract 2.02, Fulton County, Georgia,0,0,0,0,0,0,0,0
-1,131210002023012.000000000000000,Block 3012, Block Group 3, Census Tract 2.02, Fulton County, Georgia,0,0,0,0,0,0,0,0
-1,131210004001004.000000000000000,Block 1004, Block Group 1, Census Tract 4, Fulton County, Georgia,0,0,0,0,0,0,0,0
-1,131210004001005.000000000000000,Block 1005, Block Group 1, Census Tract 4, Fulton County, Georgia,0,0,0,0,0,0,0,0
-1,131210004001007.000000000000000,Block 1007, Block Group 1, Census Tract 4, Fulton County, Georgia,0,0,0,0,0,0,0,0
-1,131210004001008.000000000000000,Block 1008, Block Group 1, Census Tract 4, Fulton County, Georgia,0,0,0,0,0,0,0,0
-1,131210004001011.000000000000000,Block 1011, Block Group 1, Census Tract 4, Fulton County, Georgia,0,0,0,0,0,0,0,0
-1,131210004001013.000000000000000,Block 1013, Block Group 1, Census Tract 4, Fulton County, Georgia,0,0,0,0,0,0,0,0
-1,131210004001015.000000000000000,Block 1015, Block Group 1, Census Tract 4, Fulton County, Georgia,0,0,0,0,0,0,0,0
-1,131210004001016.000000000000000,Block 1016, Block Group 1, Census Tract 4, Fulton County, Georgia,0,0,0,0,0,0,0,0
-1,131210004002000.000000000000000,Block 2000, Block Group 2, Census Tract 4, Fulton County, Georgia,0,0,0,0,0,0,0,0
-1,131210004002001.000000000000000,Block 2001, Block Group 2, Census Tract 4, Fulton County, Georgia,0,0,0,0,0,0,0,0
-1,131210004002002.000000000000000,Block 2002, Block Group 2, Census Tract 4, Fulton County, Georgia,0,0,0,0,0,0,0,0
-1,131210004002005.000000000000000,Block 2005, Block Group 2, Census Tract 4, Fulton County, Georgia,0,0,0,0,0,0,0,0
-1,131210004002006.000000000000000,Block 2006, Block Group 2, Census Tract 4, Fulton County, Georgia,0,0,0,0,0,0,0,0
-1,131210004002007.000000000000000,Block 2007, Block Group 2, Census Tract 4, Fulton County, Georgia,0,0,0,0,0,0,0,0
-1,131210004002008.000000000000000,Block 2008, Block Group 2, Census Tract 4, Fulton County, Georgia,0,0,0,0,0,0,0,0
-1,131210005011000.000000000000000,Block 1000, Block Group 1, Census Tract 5.01, Fulton County, Georgia,0,0,0,0,0,0,0,0
-1,131210005011001.000000000000000,Block 1001, Block Group 1, Census Tract 5.01, Fulton County, Georgia,0,0,0,0,0,0,0,0
-1,131210005011003.000000000000000,Block 1003, Block Group 1, Census Tract 5.01, Fulton County, Georgia,0,0,0,0,0,0,0,0
-1,131210005011005.000000000000000,Block 1005, Block Group 1, Census Tract 5.01, Fulton County, Georgia,0,0,0,0,0,0,0,0
-1,131210005011011.000000000000000,Block 1011, Block Group 1, Census Tract 5.01, Fulton County, Georgia,0,0,0,0,0,0,0,0
-1,131210005012000.000000000000000,Block 2000, Block Group 2, Census Tract 5.01, Fulton County, Georgia,0,0,0,0,0,0,0,0
-1,131210005012002.000000000000000,Block 2002, Block Group 2, Census Tract 5.01, Fulton County, Georgia,0,0,0,0,0,0,0,0
-1,131210005012005.000000000000000,Block 2005, Block Group 2, Census Tract 5.01, Fulton County, Georgia,0,0,0,0,0,0,0,0
-1,131210005012006.000000000000000,Block 2006, Block Group 2, Census Tract 5.01, Fulton County, Georgia,0,0,0,0,0,0,0,0
-1,131210005012007.000000000000000,Block 2007, Block Group 2, Census Tract 5.01, Fulton County, Georgia,0,0,0,0,0,0,0,0
-1,131210005012008.000000000000000,Block 2008, Block Group 2, Census Tract 5.01, Fulton County, Georgia,0,0,0,0,0,0,0,0
-1,131210005012009.000000000000000,Block 2009, Block Group 2, Census Tract 5.01, Fulton County, Georgia,0,0,0,0,0,0,0,0
-1,131210005012014.000000000000000,Block 2014, Block Group 2, Census Tract 5.01, Fulton County, Georgia,0,0,0,0,0,0,0,0
-1,131210005012015.000000000000000,Block 2015, Block Group 2, Census Tract 5.01, Fulton County, Georgia,0,0,0,0,0,0,0,0
-1,131210005012016.000000000000000,Block 2016, Block Group 2, Census Tract 5.01, Fulton County, Georgia,0,0,0,0,0,0,0,0
-1,131210005013000.000000000000000,Block 3000, Block Group 3, Census Tract 5.01, Fulton County, Georgia,0,0,0,0,0,0,0,0
-1,131210005013001.000000000000000,Block 3001, Block Group 3, Census Tract 5.01, Fulton County, Georgia,0,0,0,0,0,0,0,0
-1,131210005013005.000000000000000,Block 3005, Block Group 3, Census Tract 5.01, Fulton County, Georgia,0,0,0,0,0,0,0,0
-1,131210005013006.000000000000000,Block 3006, Block Group 3, Census Tract 5.01, Fulton County, Georgia,0,0,0,0,0,0,0,0
-1,131210005013007.000000000000000,Block 3007, Block Group 3, Census Tract 5.01, Fulton County, Georgia,0,0,0,0,0,0,0,0
-1,131210005013008.000000000000000,Block 3008, Block Group 3, Census Tract 5.01, Fulton County, Georgia,0,0,0,0,0,0,0,0
-1,131210005013009.000000000000000,Block 3009, Block Group 3, Census Tract 5.01, Fulton County, Georgia,0,0,0,0,0,0,0,0
-1,131210005014000.000000000000000,Block 4000, Block Group 4, Census Tract 5.01, Fulton County, Georgia,0,0,0,0,0,0,0,0
-1,131210005014002.000000000000000,Block 4002, Block Group 4, Census Tract 5.01, Fulton County, Georgia,0,0,0,0,0,0,0,0
-1,131210005014006.000000000000000,Block 4006, Block Group 4, Census Tract 5.01, Fulton County, Georgia,0,0,0,0,0,0,0,0
-1,131210005014007.000000000000000,Block 4007, Block Group 4, Census Tract 5.01, Fulton County, Georgia,0,0,0,0,0,0,0,0
-1,131210005014008.000000000000000,Block 4008, Block Group 4, Census Tract 5.01, Fulton County, Georgia,0,0,0,0,0,0,0,0
-1,131210005014009.000000000000000,Block 4009, Block Group 4, Census Tract 5.01, Fulton County, Georgia,0,0,0,0,0,0,0,0
-1,131210005014010.000000000000000,Block 4010, Block Group 4, Census Tract 5.01, Fulton County, Georgia,0,0,0,0,0,0,0,0
-1,131210005014012.000000000000000,Block 4012, Block Group 4, Census Tract 5.01, Fulton County, Georgia,0,0,0,0,0,0,0,0
-1,131210005014013.000000000000000,Block 4013, Block Group 4, Census Tract 5.01, Fulton County, Georgia,0,0,0,0,0,0,0,0
-1,131210005014014.000000000000000,Block 4014, Block Group 4, Census Tract 5.01, Fulton County, Georgia,0,0,0,0,0,0,0,0
-1,131210005021000.000000000000000,Block 1000, Block Group 1, Census Tract 5.02, Fulton County, Georgia,0,0,0,0,0,0,0,0
-1,131210005022000.000000000000000,Block 2000, Block Group 2, Census Tract 5.02, Fulton County, Georgia,0,0,0,0,0,0,0,0
-1,131210005022001.000000000000000,Block 2001, Block Group 2, Census Tract 5.02, Fulton County, Georgia,0,0,0,0,0,0,0,0
-1,131210005022002.000000000000000,Block 2002, Block Group 2, Census Tract 5.02, Fulton County, Georgia,0,0,0,0,0,0,0,0
-1,131210005022003.000000000000000,Block 2003, Block Group 2, Census Tract 5.02, Fulton County, Georgia,0,0,0,0,0,0,0,0
-1,131210005022004.000000000000000,Block 2004, Block Group 2, Census Tract 5.02, Fulton County, Georgia,0,0,0,0,0,0,0,0
-1,131210005022005.000000000000000,Block 2005, Block Group 2, Census Tract 5.02, Fulton County, Georgia,0,0,0,0,0,0,0,0
-1,131210005022006.000000000000000,Block 2006, Block Group 2, Census Tract 5.02, Fulton County, Georgia,0,0,0,0,0,0,0,0
-1,131210005022007.000000000000000,Block 2007, Block Group 2, Census Tract 5.02, Fulton County, Georgia,0,0,0,0,0,0,0,0
-1,131210005022008.000000000000000,Block 2008, Block Group 2, Census Tract 5.02, Fulton County, Georgia,0,0,0,0,0,0,0,0
-1,131210005022009.000000000000000,Block 2009, Block Group 2, Census Tract 5.02, Fulton County, Georgia,0,0,0,0,0,0,0,0
-1,131210005022010.000000000000000,Block 2010, Block Group 2, Census Tract 5.02, Fulton County, Georgia,0,0,0,0,0,0,0,0
-1,131210005022011.000000000000000,Block 2011, Block Group 2, Census Tract 5.02, Fulton County, Georgia,0,0,0,0,0,0,0,0
-1,131210005022012.000000000000000,Block 2012, Block Group 2, Census Tract 5.02, Fulton County, Georgia,0,0,0,0,0,0,0,0
-1,131210005022013.000000000000000,Block 2013, Block Group 2, Census Tract 5.02, Fulton County, Georgia,0,0,0,0,0,0,0,0
-1,131210005022014.000000000000000,Block 2014, Block Group 2, Census Tract 5.02, Fulton County, Georgia,0,0,0,0,0,0,0,0
-1,131210005022019.000000000000000,Block 2019, Block Group 2, Census Tract 5.02, Fulton County, Georgia,0,0,0,0,0,0,0,0
-1,131210005022030.000000000000000,Block 2030, Block Group 2, Census Tract 5.02, Fulton County, Georgia,0,0,0,0,0,0,0,0
-1,131210005022036.000000000000000,Block 2036, Block Group 2, Census Tract 5.02, Fulton County, Georgia,0,0,0,0,0,0,0,0
-1,131210005022037.000000000000000,Block 2037, Block Group 2, Census Tract 5.02, Fulton County, Georgia,0,0,0,0,0,0,0,0
-1,131210006011000.000000000000000,Block 1000, Block Group 1, Census Tract 6.01, Fulton County, Georgia,0,0,0,0,0,0,0,0
-1,131210006011004.000000000000000,Block 1004, Block Group 1, Census Tract 6.01, Fulton County, Georgia,0,0,0,0,0,0,0,0
-1,131210006011008.000000000000000,Block 1008, Block Group 1, Census Tract 6.01, Fulton County, Georgia,0,0,0,0,0,0,0,0
-1,131210006011009.000000000000000,Block 1009, Block Group 1, Census Tract 6.01, Fulton County, Georgia,0,0,0,0,0,0,0,0
-1,131210006011013.000000000000000,Block 1013, Block Group 1, Census Tract 6.01, Fulton County, Georgia,0,0,0,0,0,0,0,0
-1,131210006011015.000000000000000,Block 1015, Block Group 1, Census Tract 6.01, Fulton County, Georgia,0,0,0,0,0,0,0,0
-1,131210006011016.000000000000000,Block 1016, Block Group 1, Census Tract 6.01, Fulton County, Georgia,0,0,0,0,0,0,0,0
-1,131210006012006.000000000000000,Block 2006, Block Group 2, Census Tract 6.01, Fulton County, Georgia,0,0,0,0,0,0,0,0
-1,131210006012007.000000000000000,Block 2007, Block Group 2, Census Tract 6.01, Fulton County, Georgia,0,0,0,0,0,0,0,0
-1,131210006012008.000000000000000,Block 2008, Block Group 2, Census Tract 6.01, Fulton County, Georgia,0,0,0,0,0,0,0,0
-1,131210006012011.000000000000000,Block 2011, Block Group 2, Census Tract 6.01, Fulton County, Georgia,0,0,0,0,0,0,0,0
-1,131210006013016.000000000000000,Block 3016, Block Group 3, Census Tract 6.01, Fulton County, Georgia,0,0,0,0,0,0,0,0
-1,131210006021005.000000000000000,Block 1005, Block Group 1, Census Tract 6.02, Fulton County, Georgia,0,0,0,0,0,0,0,0
-1,131210006023003.000000000000000,Block 3003, Block Group 3, Census Tract 6.02, Fulton County, Georgia,0,0,0,0,0,0,0,0
-1,131210006023004.000000000000000,Block 3004, Block Group 3, Census Tract 6.02, Fulton County, Georgia,0,0,0,0,0,0,0,0
-1,131210006023005.000000000000000,Block 3005, Block Group 3, Census Tract 6.02, Fulton County, Georgia,0,0,0,0,0,0,0,0
-1,131210006023006.000000000000000,Block 3006, Block Group 3, Census Tract 6.02, Fulton County, Georgia,0,0,0,0,0,0,0,0
-1,131210007001001.000000000000000,Block 1001, Block Group 1, Census Tract 7, Fulton County, Georgia,0,0,0,0,0,0,0,0
-1,131210007001005.000000000000000,Block 1005, Block Group 1, Census Tract 7, Fulton County, Georgia,0,0,0,0,0,0,0,0
-1,131210007001008.000000000000000,Block 1008, Block Group 1, Census Tract 7, Fulton County, Georgia,0,0,0,0,0,0,0,0
-1,131210007001010.000000000000000,Block 1010, Block Group 1, Census Tract 7, Fulton County, Georgia,0,0,0,0,0,0,0,0
-1,131210007001022.000000000000000,Block 1022, Block Group 1, Census Tract 7, Fulton County, Georgia,0,0,0,0,0,0,0,0
-1,131210010011000.000000000000000,Block 1000, Block Group 1, Census Tract 10.01, Fulton County, Georgia,0,0,0,0,0,0,0,0
-1,131210010011010.000000000000000,Block 1010, Block Group 1, Census Tract 10.01, Fulton County, Georgia,0,0,0,0,0,0,0,0
-1,131210010012001.000000000000000,Block 2001, Block Group 2, Census Tract 10.01, Fulton County, Georgia,0,0,0,0,0,0,0,0
-1,131210010012002.000000000000000,Block 2002, Block Group 2, Census Tract 10.01, Fulton County, Georgia,0,0,0,0,0,0,0,0
-1,131210010012003.000000000000000,Block 2003, Block Group 2, Census Tract 10.01, Fulton County, Georgia,0,0,0,0,0,0,0,0
-1,131210010012004.000000000000000,Block 2004, Block Group 2, Census Tract 10.01, Fulton County, Georgia,0,0,0,0,0,0,0,0
-1,131210010012005.000000000000000,Block 2005, Block Group 2, Census Tract 10.01, Fulton County, Georgia,0,0,0,0,0,0,0,0
-1,131210010012007.000000000000000,Block 2007, Block Group 2, Census Tract 10.01, Fulton County, Georgia,0,0,0,0,0,0,0,0
-1,131210010012010.000000000000000,Block 2010, Block Group 2, Census Tract 10.01, Fulton County, Georgia,0,0,0,0,0,0,0,0
-1,131210010012011.000000000000000,Block 2011, Block Group 2, Census Tract 10.01, Fulton County, Georgia,0,0,0,0,0,0,0,0
-1,131210010012018.000000000000000,Block 2018, Block Group 2, Census Tract 10.01, Fulton County, Georgia,0,0,0,0,0,0,0,0
-1,131210010012019.000000000000000,Block 2019, Block Group 2, Census Tract 10.01, Fulton County, Georgia,0,0,0,0,0,0,0,0
-1,131210010012022.000000000000000,Block 2022, Block Group 2, Census Tract 10.01, Fulton County, Georgia,0,0,0,0,0,0,0,0
-1,131210010012023.000000000000000,Block 2023, Block Group 2, Census Tract 10.01, Fulton County, Georgia,0,0,0,0,0,0,0,0
-1,131210010012025.000000000000000,Block 2025, Block Group 2, Census Tract 10.01, Fulton County, Georgia,0,0,0,0,0,0,0,0
-1,131210010012026.000000000000000,Block 2026, Block Group 2, Census Tract 10.01, Fulton County, Georgia,0,0,0,0,0,0,0,0
-1,131210010012027.000000000000000,Block 2027, Block Group 2, Census Tract 10.01, Fulton County, Georgia,0,0,0,0,0,0,0,0
-1,131210010012028.000000000000000,Block 2028, Block Group 2, Census Tract 10.01, Fulton County, Georgia,0,0,0,0,0,0,0,0
-1,131210010012029.000000000000000,Block 2029, Block Group 2, Census Tract 10.01, Fulton County, Georgia,0,0,0,0,0,0,0,0
-1,131210010021000.000000000000000,Block 1000, Block Group 1, Census Tract 10.02, Fulton County, Georgia,0,0,0,0,0,0,0,0
-1,131210010021001.000000000000000,Block 1001, Block Group 1, Census Tract 10.02, Fulton County, Georgia,0,0,0,0,0,0,0,0
-1,131210010021004.000000000000000,Block 1004, Block Group 1, Census Tract 10.02, Fulton County, Georgia,0,0,0,0,0,0,0,0
-1,131210010021005.000000000000000,Block 1005, Block Group 1, Census Tract 10.02, Fulton County, Georgia,0,0,0,0,0,0,0,0
-1,131210010021006.000000000000000,Block 1006, Block Group 1, Census Tract 10.02, Fulton County, Georgia,0,0,0,0,0,0,0,0
-1,131210010021007.000000000000000,Block 1007, Block Group 1, Census Tract 10.02, Fulton County, Georgia,0,0,0,0,0,0,0,0
-1,131210010021009.000000000000000,Block 1009, Block Group 1, Census Tract 10.02, Fulton County, Georgia,0,0,0,0,0,0,0,0
-1,131210010021012.000000000000000,Block 1012, Block Group 1, Census Tract 10.02, Fulton County, Georgia,0,0,0,0,0,0,0,0
-1,131210010021014.000000000000000,Block 1014, Block Group 1, Census Tract 10.02, Fulton County, Georgia,0,0,0,0,0,0,0,0
-1,131210010021015.000000000000000,Block 1015, Block Group 1, Census Tract 10.02, Fulton County, Georgia,0,0,0,0,0,0,0,0
-1,131210010021016.000000000000000,Block 1016, Block Group 1, Census Tract 10.02, Fulton County, Georgia,0,0,0,0,0,0,0,0
-1,131210010022000.000000000000000,Block 2000, Block Group 2, Census Tract 10.02, Fulton County, Georgia,0,0,0,0,0,0,0,0
-1,131210010022003.000000000000000,Block 2003, Block Group 2, Census Tract 10.02, Fulton County, Georgia,0,0,0,0,0,0,0,0
-1,131210010022004.000000000000000,Block 2004, Block Group 2, Census Tract 10.02, Fulton County, Georgia,0,0,0,0,0,0,0,0
-1,131210010022016.000000000000000,Block 2016, Block Group 2, Census Tract 10.02, Fulton County, Georgia,0,0,0,0,0,0,0,0
-1,131210010022018.000000000000000,Block 2018, Block Group 2, Census Tract 10.02, Fulton County, Georgia,0,0,0,0,0,0,0,0
-1,131210010022019.000000000000000,Block 2019, Block Group 2, Census Tract 10.02, Fulton County, Georgia,0,0,0,0,0,0,0,0
-1,131210010022020.000000000000000,Block 2020, Block Group 2, Census Tract 10.02, Fulton County, Georgia,0,0,0,0,0,0,0,0
-1,131210010022023.000000000000000,Block 2023, Block Group 2, Census Tract 10.02, Fulton County, Georgia,0,0,0,0,0,0,0,0
-1,131210010022024.000000000000000,Block 2024, Block Group 2, Census Tract 10.02, Fulton County, Georgia,0,0,0,0,0,0,0,0
-1,131210011011002.000000000000000,Block 1002, Block Group 1, Census Tract 11.01, Fulton County, Georgia,0,0,0,0,0,0,0,0
-1,131210011011003.000000000000000,Block 1003, Block Group 1, Census Tract 11.01, Fulton County, Georgia,0,0,0,0,0,0,0,0
-1,131210011013004.000000000000000,Block 3004, Block Group 3, Census Tract 11.01, Fulton County, Georgia,0,0,0,0,0,0,0,0
-1,131210011013006.000000000000000,Block 3006, Block Group 3, Census Tract 11.01, Fulton County, Georgia,0,0,0,0,0,0,0,0
-1,131210011013007.000000000000000,Block 3007, Block Group 3, Census Tract 11.01, Fulton County, Georgia,0,0,0,0,0,0,0,0
-1,131210011013008.000000000000000,Block 3008, Block Group 3, Census Tract 11.01, Fulton County, Georgia,0,0,0,0,0,0,0,0
-1,131210011022001.000000000000000,Block 2001, Block Group 2, Census Tract 11.02, Fulton County, Georgia,0,0,0,0,0,0,0,0
-1,131210011022007.000000000000000,Block 2007, Block Group 2, Census Tract 11.02, Fulton County, Georgia,0,0,0,0,0,0,0,0
-1,131210011022008.000000000000000,Block 2008, Block Group 2, Census Tract 11.02, Fulton County, Georgia,0,0,0,0,0,0,0,0
-1,131210011022011.000000000000000,Block 2011, Block Group 2, Census Tract 11.02, Fulton County, Georgia,0,0,0,0,0,0,0,0
-1,131210011022012.000000000000000,Block 2012, Block Group 2, Census Tract 11.02, Fulton County, Georgia,0,0,0,0,0,0,0,0
-1,131210012051004.000000000000000,Block 1004, Block Group 1, Census Tract 12.05, Fulton County, Georgia,0,0,0,0,0,0,0,0
-1,131210012051005.000000000000000,Block 1005, Block Group 1, Census Tract 12.05, Fulton County, Georgia,0,0,0,0,0,0,0,0
-1,131210012052001.000000000000000,Block 2001, Block Group 2, Census Tract 12.05, Fulton County, Georgia,0,0,0,0,0,0,0,0
-1,131210012052002.000000000000000,Block 2002, Block Group 2, Census Tract 12.05, Fulton County, Georgia,0,0,0,0,0,0,0,0
-1,131210012052003.000000000000000,Block 2003, Block Group 2, Census Tract 12.05, Fulton County, Georgia,0,0,0,0,0,0,0,0
-1,131210012052004.000000000000000,Block 2004, Block Group 2, Census Tract 12.05, Fulton County, Georgia,0,0,0,0,0,0,0,0
-1,131210012052008.000000000000000,Block 2008, Block Group 2, Census Tract 12.05, Fulton County, Georgia,0,0,0,0,0,0,0,0
-1,131210012061004.000000000000000,Block 1004, Block Group 1, Census Tract 12.06, Fulton County, Georgia,0,0,0,0,0,0,0,0
-1,131210012062000.000000000000000,Block 2000, Block Group 2, Census Tract 12.06, Fulton County, Georgia,0,0,0,0,0,0,0,0
-1,131210012062001.000000000000000,Block 2001, Block Group 2, Census Tract 12.06, Fulton County, Georgia,0,0,0,0,0,0,0,0
-1,131210012062005.000000000000000,Block 2005, Block Group 2, Census Tract 12.06, Fulton County, Georgia,0,0,0,0,0,0,0,0
-1,131210013011013.000000000000000,Block 1013, Block Group 1, Census Tract 13.01, Fulton County, Georgia,0,0,0,0,0,0,0,0
-1,131210013021005.000000000000000,Block 1005, Block Group 1, Census Tract 13.02, Fulton County, Georgia,0,0,0,0,0,0,0,0
-1,131210013022000.000000000000000,Block 2000, Block Group 2, Census Tract 13.02, Fulton County, Georgia,0,0,0,0,0,0,0,0
-1,131210013022005.000000000000000,Block 2005, Block Group 2, Census Tract 13.02, Fulton County, Georgia,0,0,0,0,0,0,0,0
-1,131210014002008.000000000000000,Block 2008, Block Group 2, Census Tract 14, Fulton County, Georgia,0,0,0,0,0,0,0,0
-1,131210015011002.000000000000000,Block 1002, Block Group 1, Census Tract 15.01, Fulton County, Georgia,0,0,0,0,0,0,0,0
-1,131210015011005.000000000000000,Block 1005, Block Group 1, Census Tract 15.01, Fulton County, Georgia,0,0,0,0,0,0,0,0
-1,131210016002002.000000000000000,Block 2002, Block Group 2, Census Tract 16, Fulton County, Georgia,0,0,0,0,0,0,0,0
-1,131210016002005.000000000000000,Block 2005, Block Group 2, Census Tract 16, Fulton County, Georgia,0,0,0,0,0,0,0,0
-1,131210017011009.000000000000000,Block 1009, Block Group 1, Census Tract 17.01, Fulton County, Georgia,0,0,0,0,0,0,0,0
-1,131210017022004.000000000000000,Block 2004, Block Group 2, Census Tract 17.02, Fulton County, Georgia,0,0,0,0,0,0,0,0
-1,131210017022009.000000000000000,Block 2009, Block Group 2, Census Tract 17.02, Fulton County, Georgia,0,0,0,0,0,0,0,0
-1,131210018011004.000000000000000,Block 1004, Block Group 1, Census Tract 18.01, Fulton County, Georgia,0,0,0,0,0,0,0,0
-1,131210018012003.000000000000000,Block 2003, Block Group 2, Census Tract 18.01, Fulton County, Georgia,0,0,0,0,0,0,0,0
-1,131210018021001.000000000000000,Block 1001, Block Group 1, Census Tract 18.02, Fulton County, Georgia,0,0,0,0,0,0,0,0
-1,131210018021004.000000000000000,Block 1004, Block Group 1, Census Tract 18.02, Fulton County, Georgia,0,0,0,0,0,0,0,0
-1,131210018021005.000000000000000,Block 1005, Block Group 1, Census Tract 18.02, Fulton County, Georgia,0,0,0,0,0,0,0,0
-1,131210019011004.000000000000000,Block 1004, Block Group 1, Census Tract 19.01, Fulton County, Georgia,0,0,0,0,0,0,0,0
-1,131210019021000.000000000000000,Block 1000, Block Group 1, Census Tract 19.02, Fulton County, Georgia,0,0,0,0,0,0,0,0
-1,131210019021001.000000000000000,Block 1001, Block Group 1, Census Tract 19.02, Fulton County, Georgia,0,0,0,0,0,0,0,0
-1,131210019021002.000000000000000,Block 1002, Block Group 1, Census Tract 19.02, Fulton County, Georgia,0,0,0,0,0,0,0,0
-1,131210019021003.000000000000000,Block 1003, Block Group 1, Census Tract 19.02, Fulton County, Georgia,0,0,0,0,0,0,0,0
-1,131210019021004.000000000000000,Block 1004, Block Group 1, Census Tract 19.02, Fulton County, Georgia,0,0,0,0,0,0,0,0
-1,131210019021005.000000000000000,Block 1005, Block Group 1, Census Tract 19.02, Fulton County, Georgia,0,0,0,0,0,0,0,0
-1,131210019021007.000000000000000,Block 1007, Block Group 1, Census Tract 19.02, Fulton County, Georgia,0,0,0,0,0,0,0,0
-1,131210019021009.000000000000000,Block 1009, Block Group 1, Census Tract 19.02, Fulton County, Georgia,0,0,0,0,0,0,0,0
-1,131210019021011.000000000000000,Block 1011, Block Group 1, Census Tract 19.02, Fulton County, Georgia,0,0,0,0,0,0,0,0
-1,131210019021013.000000000000000,Block 1013, Block Group 1, Census Tract 19.02, Fulton County, Georgia,0,0,0,0,0,0,0,0
-1,131210019021014.000000000000000,Block 1014, Block Group 1, Census Tract 19.02, Fulton County, Georgia,0,0,0,0,0,0,0,0
-1,131210019021015.000000000000000,Block 1015, Block Group 1, Census Tract 19.02, Fulton County, Georgia,0,0,0,0,0,0,0,0
-1,131210019021016.000000000000000,Block 1016, Block Group 1, Census Tract 19.02, Fulton County, Georgia,0,0,0,0,0,0,0,0
-1,131210019021018.000000000000000,Block 1018, Block Group 1, Census Tract 19.02, Fulton County, Georgia,0,0,0,0,0,0,0,0
-1,131210019021019.000000000000000,Block 1019, Block Group 1, Census Tract 19.02, Fulton County, Georgia,0,0,0,0,0,0,0,0
-1,131210019021022.000000000000000,Block 1022, Block Group 1, Census Tract 19.02, Fulton County, Georgia,0,0,0,0,0,0,0,0
-1,131210019022001.000000000000000,Block 2001, Block Group 2, Census Tract 19.02, Fulton County, Georgia,0,0,0,0,0,0,0,0
-1,131210019023002.000000000000000,Block 3002, Block Group 3, Census Tract 19.02, Fulton County, Georgia,0,0,0,0,0,0,0,0
-1,131210019023003.000000000000000,Block 3003, Block Group 3, Census Tract 19.02, Fulton County, Georgia,0,0,0,0,0,0,0,0
-1,131210019023004.000000000000000,Block 3004, Block Group 3, Census Tract 19.02, Fulton County, Georgia,0,0,0,0,0,0,0,0
-1,131210019023005.000000000000000,Block 3005, Block Group 3, Census Tract 19.02, Fulton County, Georgia,0,0,0,0,0,0,0,0
-1,131210019023006.000000000000000,Block 3006, Block Group 3, Census Tract 19.02, Fulton County, Georgia,0,0,0,0,0,0,0,0
-1,131210019023008.000000000000000,Block 3008, Block Group 3, Census Tract 19.02, Fulton County, Georgia,0,0,0,0,0,0,0,0
-1,131210019023009.000000000000000,Block 3009, Block Group 3, Census Tract 19.02, Fulton County, Georgia,0,0,0,0,0,0,0,0
-1,131210019023010.000000000000000,Block 3010, Block Group 3, Census Tract 19.02, Fulton County, Georgia,0,0,0,0,0,0,0,0
-1,131210019023012.000000000000000,Block 3012, Block Group 3, Census Tract 19.02, Fulton County, Georgia,0,0,0,0,0,0,0,0
-1,131210019023013.000000000000000,Block 3013, Block Group 3, Census Tract 19.02, Fulton County, Georgia,0,0,0,0,0,0,0,0
-1,131210019023014.000000000000000,Block 3014, Block Group 3, Census Tract 19.02, Fulton County, Georgia,0,0,0,0,0,0,0,0
-1,131210021001000.000000000000000,Block 1000, Block Group 1, Census Tract 21, Fulton County, Georgia,0,0,0,0,0,0,0,0
-1,131210021001002.000000000000000,Block 1002, Block Group 1, Census Tract 21, Fulton County, Georgia,0,0,0,0,0,0,0,0
-1,131210021001006.000000000000000,Block 1006, Block Group 1, Census Tract 21, Fulton County, Georgia,0,0,0,0,0,0,0,0
-1,131210021001007.000000000000000,Block 1007, Block Group 1, Census Tract 21, Fulton County, Georgia,0,0,0,0,0,0,0,0
-1,131210021001008.000000000000000,Block 1008, Block Group 1, Census Tract 21, Fulton County, Georgia,0,0,0,0,0,0,0,0
-1,131210021001009.000000000000000,Block 1009, Block Group 1, Census Tract 21, Fulton County, Georgia,0,0,0,0,0,0,0,0
-1,131210021001010.000000000000000,Block 1010, Block Group 1, Census Tract 21, Fulton County, Georgia,0,0,0,0,0,0,0,0
-1,131210021001011.000000000000000,Block 1011, Block Group 1, Census Tract 21, Fulton County, Georgia,0,0,0,0,0,0,0,0
-1,131210021001012.000000000000000,Block 1012, Block Group 1, Census Tract 21, Fulton County, Georgia,0,0,0,0,0,0,0,0
-1,131210021001016.000000000000000,Block 1016, Block Group 1, Census Tract 21, Fulton County, Georgia,0,0,0,0,0,0,0,0
-1,131210021001017.000000000000000,Block 1017, Block Group 1, Census Tract 21, Fulton County, Georgia,0,0,0,0,0,0,0,0
-1,131210021001018.000000000000000,Block 1018, Block Group 1, Census Tract 21, Fulton County, Georgia,0,0,0,0,0,0,0,0
-1,131210021001021.000000000000000,Block 1021, Block Group 1, Census Tract 21, Fulton County, Georgia,0,0,0,0,0,0,0,0
-1,131210021001023.000000000000000,Block 1023, Block Group 1, Census Tract 21, Fulton County, Georgia,0,0,0,0,0,0,0,0
-1,131210023003007.000000000000000,Block 3007, Block Group 3, Census Tract 23, Fulton County, Georgia,0,0,0,0,0,0,0,0
-1,131210024001002.000000000000000,Block 1002, Block Group 1, Census Tract 24, Fulton County, Georgia,0,0,0,0,0,0,0,0
-1,131210024001012.000000000000000,Block 1012, Block Group 1, Census Tract 24, Fulton County, Georgia,0,0,0,0,0,0,0,0
-1,131210024001014.000000000000000,Block 1014, Block Group 1, Census Tract 24, Fulton County, Georgia,0,0,0,0,0,0,0,0
-1,131210024002011.000000000000000,Block 2011, Block Group 2, Census Tract 24, Fulton County, Georgia,0,0,0,0,0,0,0,0
-1,131210025001000.000000000000000,Block 1000, Block Group 1, Census Tract 25, Fulton County, Georgia,0,0,0,0,0,0,0,0
-1,131210025001006.000000000000000,Block 1006, Block Group 1, Census Tract 25, Fulton County, Georgia,0,0,0,0,0,0,0,0
-1,131210025001007.000000000000000,Block 1007, Block Group 1, Census Tract 25, Fulton County, Georgia,0,0,0,0,0,0,0,0
-1,131210025001016.000000000000000,Block 1016, Block Group 1, Census Tract 25, Fulton County, Georgia,0,0,0,0,0,0,0,0
-1,131210025001017.000000000000000,Block 1017, Block Group 1, Census Tract 25, Fulton County, Georgia,0,0,0,0,0,0,0,0
-1,131210025001018.000000000000000,Block 1018, Block Group 1, Census Tract 25, Fulton County, Georgia,0,0,0,0,0,0,0,0
-1,131210025002006.000000000000000,Block 2006, Block Group 2, Census Tract 25, Fulton County, Georgia,0,0,0,0,0,0,0,0
-1,131210025002011.000000000000000,Block 2011, Block Group 2, Census Tract 25, Fulton County, Georgia,0,0,0,0,0,0,0,0
-1,131210025003008.000000000000000,Block 3008, Block Group 3, Census Tract 25, Fulton County, Georgia,0,0,0,0,0,0,0,0
-1,131210026001000.000000000000000,Block 1000, Block Group 1, Census Tract 26, Fulton County, Georgia,0,0,0,0,0,0,0,0
-1,131210026001007.000000000000000,Block 1007, Block Group 1, Census Tract 26, Fulton County, Georgia,0,0,0,0,0,0,0,0
-1,131210026001016.000000000000000,Block 1016, Block Group 1, Census Tract 26, Fulton County, Georgia,0,0,0,0,0,0,0,0
-1,131210026001017.000000000000000,Block 1017, Block Group 1, Census Tract 26, Fulton County, Georgia,0,0,0,0,0,0,0,0
-1,131210026001018.000000000000000,Block 1018, Block Group 1, Census Tract 26, Fulton County, Georgia,0,0,0,0,0,0,0,0
-1,131210026001020.000000000000000,Block 1020, Block Group 1, Census Tract 26, Fulton County, Georgia,0,0,0,0,0,0,0,0
-1,131210026001021.000000000000000,Block 1021, Block Group 1, Census Tract 26, Fulton County, Georgia,0,0,0,0,0,0,0,0
-1,131210026001022.000000000000000,Block 1022, Block Group 1, Census Tract 26, Fulton County, Georgia,0,0,0,0,0,0,0,0
-1,131210026001023.000000000000000,Block 1023, Block Group 1, Census Tract 26, Fulton County, Georgia,0,0,0,0,0,0,0,0
-1,131210026002000.000000000000000,Block 2000, Block Group 2, Census Tract 26, Fulton County, Georgia,0,0,0,0,0,0,0,0
-1,131210026002001.000000000000000,Block 2001, Block Group 2, Census Tract 26, Fulton County, Georgia,0,0,0,0,0,0,0,0
-1,131210026002002.000000000000000,Block 2002, Block Group 2, Census Tract 26, Fulton County, Georgia,0,0,0,0,0,0,0,0
-1,131210026002003.000000000000000,Block 2003, Block Group 2, Census Tract 26, Fulton County, Georgia,0,0,0,0,0,0,0,0
-1,131210026002004.000000000000000,Block 2004, Block Group 2, Census Tract 26, Fulton County, Georgia,0,0,0,0,0,0,0,0
-1,131210026002005.000000000000000,Block 2005, Block Group 2, Census Tract 26, Fulton County, Georgia,0,0,0,0,0,0,0,0
-1,131210026002006.000000000000000,Block 2006, Block Group 2, Census Tract 26, Fulton County, Georgia,0,0,0,0,0,0,0,0
-1,131210026002008.000000000000000,Block 2008, Block Group 2, Census Tract 26, Fulton County, Georgia,0,0,0,0,0,0,0,0
-1,131210026002009.000000000000000,Block 2009, Block Group 2, Census Tract 26, Fulton County, Georgia,0,0,0,0,0,0,0,0
-1,131210026002011.000000000000000,Block 2011, Block Group 2, Census Tract 26, Fulton County, Georgia,0,0,0,0,0,0,0,0
-1,131210026002012.000000000000000,Block 2012, Block Group 2, Census Tract 26, Fulton County, Georgia,0,0,0,0,0,0,0,0
-1,131210026002013.000000000000000,Block 2013, Block Group 2, Census Tract 26, Fulton County, Georgia,0,0,0,0,0,0,0,0
-1,131210026002014.000000000000000,Block 2014, Block Group 2, Census Tract 26, Fulton County, Georgia,0,0,0,0,0,0,0,0
-1,131210026002015.000000000000000,Block 2015, Block Group 2, Census Tract 26, Fulton County, Georgia,0,0,0,0,0,0,0,0
-1,131210026002016.000000000000000,Block 2016, Block Group 2, Census Tract 26, Fulton County, Georgia,0,0,0,0,0,0,0,0
-1,131210026002020.000000000000000,Block 2020, Block Group 2, Census Tract 26, Fulton County, Georgia,0,0,0,0,0,0,0,0
-1,131210028011001.000000000000000,Block 1001, Block Group 1, Census Tract 28.01, Fulton County, Georgia,0,0,0,0,0,0,0,0
-1,131210028011003.000000000000000,Block 1003, Block Group 1, Census Tract 28.01, Fulton County, Georgia,0,0,0,0,0,0,0,0
-1,131210028011004.000000000000000,Block 1004, Block Group 1, Census Tract 28.01, Fulton County, Georgia,0,0,0,0,0,0,0,0
-1,131210028011006.000000000000000,Block 1006, Block Group 1, Census Tract 28.01, Fulton County, Georgia,0,0,0,0,0,0,0,0
-1,131210028011008.000000000000000,Block 1008, Block Group 1, Census Tract 28.01, Fulton County, Georgia,0,0,0,0,0,0,0,0
-1,131210028021002.000000000000000,Block 1002, Block Group 1, Census Tract 28.02, Fulton County, Georgia,0,0,0,0,0,0,0,0
-1,131210028021008.000000000000000,Block 1008, Block Group 1, Census Tract 28.02, Fulton County, Georgia,0,0,0,0,0,0,0,0
-1,131210028021010.000000000000000,Block 1010, Block Group 1, Census Tract 28.02, Fulton County, Georgia,0,0,0,0,0,0,0,0
-1,131210028022001.000000000000000,Block 2001, Block Group 2, Census Tract 28.02, Fulton County, Georgia,0,0,0,0,0,0,0,0
-1,131210028022007.000000000000000,Block 2007, Block Group 2, Census Tract 28.02, Fulton County, Georgia,0,0,0,0,0,0,0,0
-1,131210028022008.000000000000000,Block 2008, Block Group 2, Census Tract 28.02, Fulton County, Georgia,0,0,0,0,0,0,0,0
-1,131210028022009.000000000000000,Block 2009, Block Group 2, Census Tract 28.02, Fulton County, Georgia,0,0,0,0,0,0,0,0
-1,131210029001003.000000000000000,Block 1003, Block Group 1, Census Tract 29, Fulton County, Georgia,0,0,0,0,0,0,0,0
-1,131210029001007.000000000000000,Block 1007, Block Group 1, Census Tract 29, Fulton County, Georgia,0,0,0,0,0,0,0,0
-1,131210029001010.000000000000000,Block 1010, Block Group 1, Census Tract 29, Fulton County, Georgia,0,0,0,0,0,0,0,0
-1,131210029001012.000000000000000,Block 1012, Block Group 1, Census Tract 29, Fulton County, Georgia,0,0,0,0,0,0,0,0
-1,131210029001013.000000000000000,Block 1013, Block Group 1, Census Tract 29, Fulton County, Georgia,0,0,0,0,0,0,0,0
-1,131210029002003.000000000000000,Block 2003, Block Group 2, Census Tract 29, Fulton County, Georgia,0,0,0,0,0,0,0,0
-1,131210029002004.000000000000000,Block 2004, Block Group 2, Census Tract 29, Fulton County, Georgia,0,0,0,0,0,0,0,0
-1,131210030001000.000000000000000,Block 1000, Block Group 1, Census Tract 30, Fulton County, Georgia,0,0,0,0,0,0,0,0
-1,131210030001010.000000000000000,Block 1010, Block Group 1, Census Tract 30, Fulton County, Georgia,0,0,0,0,0,0,0,0
-1,131210030001013.000000000000000,Block 1013, Block Group 1, Census Tract 30, Fulton County, Georgia,0,0,0,0,0,0,0,0
-1,131210030001020.000000000000000,Block 1020, Block Group 1, Census Tract 30, Fulton County, Georgia,0,0,0,0,0,0,0,0
-1,131210030001024.000000000000000,Block 1024, Block Group 1, Census Tract 30, Fulton County, Georgia,0,0,0,0,0,0,0,0
-1,131210030001027.000000000000000,Block 1027, Block Group 1, Census Tract 30, Fulton County, Georgia,0,0,0,0,0,0,0,0
-1,131210030001028.000000000000000,Block 1028, Block Group 1, Census Tract 30, Fulton County, Georgia,0,0,0,0,0,0,0,0
-1,131210030002010.000000000000000,Block 2010, Block Group 2, Census Tract 30, Fulton County, Georgia,0,0,0,0,0,0,0,0
-1,131210031001013.000000000000000,Block 1013, Block Group 1, Census Tract 31, Fulton County, Georgia,0,0,0,0,0,0,0,0
-1,131210031001016.000000000000000,Block 1016, Block Group 1, Census Tract 31, Fulton County, Georgia,0,0,0,0,0,0,0,0
-1,131210031001017.000000000000000,Block 1017, Block Group 1, Census Tract 31, Fulton County, Georgia,0,0,0,0,0,0,0,0
-1,131210031001027.000000000000000,Block 1027, Block Group 1, Census Tract 31, Fulton County, Georgia,0,0,0,0,0,0,0,0
-1,131210031002003.000000000000000,Block 2003, Block Group 2, Census Tract 31, Fulton County, Georgia,0,0,0,0,0,0,0,0
-1,131210032001009.000000000000000,Block 1009, Block Group 1, Census Tract 32, Fulton County, Georgia,0,0,0,0,0,0,0,0
-1,131210032002003.000000000000000,Block 2003, Block Group 2, Census Tract 32, Fulton County, Georgia,0,0,0,0,0,0,0,0
-1,131210032002004.000000000000000,Block 2004, Block Group 2, Census Tract 32, Fulton County, Georgia,0,0,0,0,0,0,0,0
-1,131210032002014.000000000000000,Block 2014, Block Group 2, Census Tract 32, Fulton County, Georgia,0,0,0,0,0,0,0,0
-1,131210035001000.000000000000000,Block 1000, Block Group 1, Census Tract 35, Fulton County, Georgia,0,0,0,0,0,0,0,0
-1,131210035001003.000000000000000,Block 1003, Block Group 1, Census Tract 35, Fulton County, Georgia,0,0,0,0,0,0,0,0
-1,131210035001004.000000000000000,Block 1004, Block Group 1, Census Tract 35, Fulton County, Georgia,0,0,0,0,0,0,0,0
-1,131210035001005.000000000000000,Block 1005, Block Group 1, Census Tract 35, Fulton County, Georgia,0,0,0,0,0,0,0,0
-1,131210035001006.000000000000000,Block 1006, Block Group 1, Census Tract 35, Fulton County, Georgia,0,0,0,0,0,0,0,0
-1,131210035001008.000000000000000,Block 1008, Block Group 1, Census Tract 35, Fulton County, Georgia,0,0,0,0,0,0,0,0
-1,131210035001009.000000000000000,Block 1009, Block Group 1, Census Tract 35, Fulton County, Georgia,0,0,0,0,0,0,0,0
-1,131210035001010.000000000000000,Block 1010, Block Group 1, Census Tract 35, Fulton County, Georgia,0,0,0,0,0,0,0,0
-1,131210035001012.000000000000000,Block 1012, Block Group 1, Census Tract 35, Fulton County, Georgia,0,0,0,0,0,0,0,0
-1,131210035001017.000000000000000,Block 1017, Block Group 1, Census Tract 35, Fulton County, Georgia,0,0,0,0,0,0,0,0
-1,131210035001018.000000000000000,Block 1018, Block Group 1, Census Tract 35, Fulton County, Georgia,0,0,0,0,0,0,0,0
-1,131210035001019.000000000000000,Block 1019, Block Group 1, Census Tract 35, Fulton County, Georgia,0,0,0,0,0,0,0,0
-1,131210035001020.000000000000000,Block 1020, Block Group 1, Census Tract 35, Fulton County, Georgia,0,0,0,0,0,0,0,0
-1,131210035001021.000000000000000,Block 1021, Block Group 1, Census Tract 35, Fulton County, Georgia,0,0,0,0,0,0,0,0
-1,131210035001022.000000000000000,Block 1022, Block Group 1, Census Tract 35, Fulton County, Georgia,0,0,0,0,0,0,0,0
-1,131210035001023.000000000000000,Block 1023, Block Group 1, Census Tract 35, Fulton County, Georgia,0,0,0,0,0,0,0,0
-1,131210035001024.000000000000000,Block 1024, Block Group 1, Census Tract 35, Fulton County, Georgia,0,0,0,0,0,0,0,0
-1,131210035001026.000000000000000,Block 1026, Block Group 1, Census Tract 35, Fulton County, Georgia,0,0,0,0,0,0,0,0
-1,131210035001027.000000000000000,Block 1027, Block Group 1, Census Tract 35, Fulton County, Georgia,0,0,0,0,0,0,0,0
-1,131210035001028.000000000000000,Block 1028, Block Group 1, Census Tract 35, Fulton County, Georgia,0,0,0,0,0,0,0,0
-1,131210035001029.000000000000000,Block 1029, Block Group 1, Census Tract 35, Fulton County, Georgia,0,0,0,0,0,0,0,0
-1,131210035001030.000000000000000,Block 1030, Block Group 1, Census Tract 35, Fulton County, Georgia,0,0,0,0,0,0,0,0
-1,131210035001031.000000000000000,Block 1031, Block Group 1, Census Tract 35, Fulton County, Georgia,0,0,0,0,0,0,0,0
-1,131210035001032.000000000000000,Block 1032, Block Group 1, Census Tract 35, Fulton County, Georgia,0,0,0,0,0,0,0,0
-1,131210035001033.000000000000000,Block 1033, Block Group 1, Census Tract 35, Fulton County, Georgia,0,0,0,0,0,0,0,0
-1,131210035001034.000000000000000,Block 1034, Block Group 1, Census Tract 35, Fulton County, Georgia,0,0,0,0,0,0,0,0
-1,131210035001035.000000000000000,Block 1035, Block Group 1, Census Tract 35, Fulton County, Georgia,0,0,0,0,0,0,0,0
-1,131210035002001.000000000000000,Block 2001, Block Group 2, Census Tract 35, Fulton County, Georgia,0,0,0,0,0,0,0,0
-1,131210035002002.000000000000000,Block 2002, Block Group 2, Census Tract 35, Fulton County, Georgia,0,0,0,0,0,0,0,0
-1,131210035002003.000000000000000,Block 2003, Block Group 2, Census Tract 35, Fulton County, Georgia,0,0,0,0,0,0,0,0
-1,131210035002004.000000000000000,Block 2004, Block Group 2, Census Tract 35, Fulton County, Georgia,0,0,0,0,0,0,0,0
-1,131210035002005.000000000000000,Block 2005, Block Group 2, Census Tract 35, Fulton County, Georgia,0,0,0,0,0,0,0,0
-1,131210035002006.000000000000000,Block 2006, Block Group 2, Census Tract 35, Fulton County, Georgia,0,0,0,0,0,0,0,0
-1,131210035002008.000000000000000,Block 2008, Block Group 2, Census Tract 35, Fulton County, Georgia,0,0,0,0,0,0,0,0
-1,131210035002009.000000000000000,Block 2009, Block Group 2, Census Tract 35, Fulton County, Georgia,0,0,0,0,0,0,0,0
-1,131210035002011.000000000000000,Block 2011, Block Group 2, Census Tract 35, Fulton County, Georgia,0,0,0,0,0,0,0,0
-1,131210035002012.000000000000000,Block 2012, Block Group 2, Census Tract 35, Fulton County, Georgia,0,0,0,0,0,0,0,0
-1,131210035002014.000000000000000,Block 2014, Block Group 2, Census Tract 35, Fulton County, Georgia,0,0,0,0,0,0,0,0
-1,131210035002015.000000000000000,Block 2015, Block Group 2, Census Tract 35, Fulton County, Georgia,0,0,0,0,0,0,0,0
-1,131210035002016.000000000000000,Block 2016, Block Group 2, Census Tract 35, Fulton County, Georgia,0,0,0,0,0,0,0,0
-1,131210035002017.000000000000000,Block 2017, Block Group 2, Census Tract 35, Fulton County, Georgia,0,0,0,0,0,0,0,0
-1,131210035002018.000000000000000,Block 2018, Block Group 2, Census Tract 35, Fulton County, Georgia,0,0,0,0,0,0,0,0
-1,131210035002020.000000000000000,Block 2020, Block Group 2, Census Tract 35, Fulton County, Georgia,0,0,0,0,0,0,0,0
-1,131210035002021.000000000000000,Block 2021, Block Group 2, Census Tract 35, Fulton County, Georgia,0,0,0,0,0,0,0,0
-1,131210035002022.000000000000000,Block 2022, Block Group 2, Census Tract 35, Fulton County, Georgia,0,0,0,0,0,0,0,0
-1,131210035002025.000000000000000,Block 2025, Block Group 2, Census Tract 35, Fulton County, Georgia,0,0,0,0,0,0,0,0
-1,131210035002028.000000000000000,Block 2028, Block Group 2, Census Tract 35, Fulton County, Georgia,0,0,0,0,0,0,0,0
-1,131210035002029.000000000000000,Block 2029, Block Group 2, Census Tract 35, Fulton County, Georgia,0,0,0,0,0,0,0,0
-1,131210035002030.000000000000000,Block 2030, Block Group 2, Census Tract 35, Fulton County, Georgia,0,0,0,0,0,0,0,0
-1,131210035002034.000000000000000,Block 2034, Block Group 2, Census Tract 35, Fulton County, Georgia,0,0,0,0,0,0,0,0
-1,131210035002036.000000000000000,Block 2036, Block Group 2, Census Tract 35, Fulton County, Georgia,0,0,0,0,0,0,0,0
-1,131210035002039.000000000000000,Block 2039, Block Group 2, Census Tract 35, Fulton County, Georgia,0,0,0,0,0,0,0,0
-1,131210035002040.000000000000000,Block 2040, Block Group 2, Census Tract 35, Fulton County, Georgia,0,0,0,0,0,0,0,0
-1,131210035002041.000000000000000,Block 2041, Block Group 2, Census Tract 35, Fulton County, Georgia,0,0,0,0,0,0,0,0
-1,131210036001000.000000000000000,Block 1000, Block Group 1, Census Tract 36, Fulton County, Georgia,0,0,0,0,0,0,0,0
-1,131210036001003.000000000000000,Block 1003, Block Group 1, Census Tract 36, Fulton County, Georgia,0,0,0,0,0,0,0,0
-1,131210036001004.000000000000000,Block 1004, Block Group 1, Census Tract 36, Fulton County, Georgia,0,0,0,0,0,0,0,0
-1,131210036001005.000000000000000,Block 1005, Block Group 1, Census Tract 36, Fulton County, Georgia,0,0,0,0,0,0,0,0
-1,131210036001006.000000000000000,Block 1006, Block Group 1, Census Tract 36, Fulton County, Georgia,0,0,0,0,0,0,0,0
-1,131210036002000.000000000000000,Block 2000, Block Group 2, Census Tract 36, Fulton County, Georgia,0,0,0,0,0,0,0,0
-1,131210036002001.000000000000000,Block 2001, Block Group 2, Census Tract 36, Fulton County, Georgia,0,0,0,0,0,0,0,0
-1,131210036002002.000000000000000,Block 2002, Block Group 2, Census Tract 36, Fulton County, Georgia,0,0,0,0,0,0,0,0
-1,131210036002004.000000000000000,Block 2004, Block Group 2, Census Tract 36, Fulton County, Georgia,0,0,0,0,0,0,0,0
-1,131210036002008.000000000000000,Block 2008, Block Group 2, Census Tract 36, Fulton County, Georgia,0,0,0,0,0,0,0,0
-1,131210036002009.000000000000000,Block 2009, Block Group 2, Census Tract 36, Fulton County, Georgia,0,0,0,0,0,0,0,0
-1,131210036002010.000000000000000,Block 2010, Block Group 2, Census Tract 36, Fulton County, Georgia,0,0,0,0,0,0,0,0
-1,131210037001003.000000000000000,Block 1003, Block Group 1, Census Tract 37, Fulton County, Georgia,0,0,0,0,0,0,0,0
-1,131210037001004.000000000000000,Block 1004, Block Group 1, Census Tract 37, Fulton County, Georgia,0,0,0,0,0,0,0,0
-1,131210037001005.000000000000000,Block 1005, Block Group 1, Census Tract 37, Fulton County, Georgia,0,0,0,0,0,0,0,0
-1,131210037001006.000000000000000,Block 1006, Block Group 1, Census Tract 37, Fulton County, Georgia,0,0,0,0,0,0,0,0
-1,131210038001002.000000000000000,Block 1002, Block Group 1, Census Tract 38, Fulton County, Georgia,0,0,0,0,0,0,0,0
-1,131210038001006.000000000000000,Block 1006, Block Group 1, Census Tract 38, Fulton County, Georgia,0,0,0,0,0,0,0,0
-1,131210038001007.000000000000000,Block 1007, Block Group 1, Census Tract 38, Fulton County, Georgia,0,0,0,0,0,0,0,0
-1,131210038001008.000000000000000,Block 1008, Block Group 1, Census Tract 38, Fulton County, Georgia,0,0,0,0,0,0,0,0
-1,131210038002000.000000000000000,Block 2000, Block Group 2, Census Tract 38, Fulton County, Georgia,0,0,0,0,0,0,0,0
-1,131210038002002.000000000000000,Block 2002, Block Group 2, Census Tract 38, Fulton County, Georgia,0,0,0,0,0,0,0,0
-1,131210038002008.000000000000000,Block 2008, Block Group 2, Census Tract 38, Fulton County, Georgia,0,0,0,0,0,0,0,0
-1,131210038002010.000000000000000,Block 2010, Block Group 2, Census Tract 38, Fulton County, Georgia,0,0,0,0,0,0,0,0
-1,131210038002011.000000000000000,Block 2011, Block Group 2, Census Tract 38, Fulton County, Georgia,0,0,0,0,0,0,0,0
-1,131210038002014.000000000000000,Block 2014, Block Group 2, Census Tract 38, Fulton County, Georgia,0,0,0,0,0,0,0,0
-1,131210038002015.000000000000000,Block 2015, Block Group 2, Census Tract 38, Fulton County, Georgia,0,0,0,0,0,0,0,0
-1,131210039001010.000000000000000,Block 1010, Block Group 1, Census Tract 39, Fulton County, Georgia,0,0,0,0,0,0,0,0
-1,131210039002011.000000000000000,Block 2011, Block Group 2, Census Tract 39, Fulton County, Georgia,0,0,0,0,0,0,0,0
-1,131210040001017.000000000000000,Block 1017, Block Group 1, Census Tract 40, Fulton County, Georgia,0,0,0,0,0,0,0,0
-1,131210040001018.000000000000000,Block 1018, Block Group 1, Census Tract 40, Fulton County, Georgia,0,0,0,0,0,0,0,0
-1,131210040002000.000000000000000,Block 2000, Block Group 2, Census Tract 40, Fulton County, Georgia,0,0,0,0,0,0,0,0
-1,131210040002003.000000000000000,Block 2003, Block Group 2, Census Tract 40, Fulton County, Georgia,0,0,0,0,0,0,0,0
-1,131210040002004.000000000000000,Block 2004, Block Group 2, Census Tract 40, Fulton County, Georgia,0,0,0,0,0,0,0,0
-1,131210040002006.000000000000000,Block 2006, Block Group 2, Census Tract 40, Fulton County, Georgia,0,0,0,0,0,0,0,0
-1,131210040002007.000000000000000,Block 2007, Block Group 2, Census Tract 40, Fulton County, Georgia,0,0,0,0,0,0,0,0
-1,131210040002014.000000000000000,Block 2014, Block Group 2, Census Tract 40, Fulton County, Georgia,0,0,0,0,0,0,0,0
-1,131210041001003.000000000000000,Block 1003, Block Group 1, Census Tract 41, Fulton County, Georgia,0,0,0,0,0,0,0,0
-1,131210041001004.000000000000000,Block 1004, Block Group 1, Census Tract 41, Fulton County, Georgia,0,0,0,0,0,0,0,0
-1,131210041001005.000000000000000,Block 1005, Block Group 1, Census Tract 41, Fulton County, Georgia,0,0,0,0,0,0,0,0
-1,131210041002009.000000000000000,Block 2009, Block Group 2, Census Tract 41, Fulton County, Georgia,0,0,0,0,0,0,0,0
-1,131210041003007.000000000000000,Block 3007, Block Group 3, Census Tract 41, Fulton County, Georgia,0,0,0,0,0,0,0,0
-1,131210041003011.000000000000000,Block 3011, Block Group 3, Census Tract 41, Fulton County, Georgia,0,0,0,0,0,0,0,0
-1,131210042001005.000000000000000,Block 1005, Block Group 1, Census Tract 42, Fulton County, Georgia,0,0,0,0,0,0,0,0
-1,131210042001007.000000000000000,Block 1007, Block Group 1, Census Tract 42, Fulton County, Georgia,0,0,0,0,0,0,0,0
-1,131210042001010.000000000000000,Block 1010, Block Group 1, Census Tract 42, Fulton County, Georgia,0,0,0,0,0,0,0,0
-1,131210042002000.000000000000000,Block 2000, Block Group 2, Census Tract 42, Fulton County, Georgia,0,0,0,0,0,0,0,0
-1,131210042002001.000000000000000,Block 2001, Block Group 2, Census Tract 42, Fulton County, Georgia,0,0,0,0,0,0,0,0
-1,131210042002002.000000000000000,Block 2002, Block Group 2, Census Tract 42, Fulton County, Georgia,0,0,0,0,0,0,0,0
-1,131210042002003.000000000000000,Block 2003, Block Group 2, Census Tract 42, Fulton County, Georgia,0,0,0,0,0,0,0,0
-1,131210042002005.000000000000000,Block 2005, Block Group 2, Census Tract 42, Fulton County, Georgia,0,0,0,0,0,0,0,0
-1,131210042003000.000000000000000,Block 3000, Block Group 3, Census Tract 42, Fulton County, Georgia,0,0,0,0,0,0,0,0
-1,131210042003002.000000000000000,Block 3002, Block Group 3, Census Tract 42, Fulton County, Georgia,0,0,0,0,0,0,0,0
-1,131210042003004.000000000000000,Block 3004, Block Group 3, Census Tract 42, Fulton County, Georgia,0,0,0,0,0,0,0,0
-1,131210042003005.000000000000000,Block 3005, Block Group 3, Census Tract 42, Fulton County, Georgia,0,0,0,0,0,0,0,0
-1,131210042003007.000000000000000,Block 3007, Block Group 3, Census Tract 42, Fulton County, Georgia,0,0,0,0,0,0,0,0
-1,131210042003009.000000000000000,Block 3009, Block Group 3, Census Tract 42, Fulton County, Georgia,0,0,0,0,0,0,0,0
-1,131210042003010.000000000000000,Block 3010, Block Group 3, Census Tract 42, Fulton County, Georgia,0,0,0,0,0,0,0,0
-1,131210042003011.000000000000000,Block 3011, Block Group 3, Census Tract 42, Fulton County, Georgia,0,0,0,0,0,0,0,0
-1,131210042003012.000000000000000,Block 3012, Block Group 3, Census Tract 42, Fulton County, Georgia,0,0,0,0,0,0,0,0
-1,131210042003013.000000000000000,Block 3013, Block Group 3, Census Tract 42, Fulton County, Georgia,0,0,0,0,0,0,0,0
-1,131210042003015.000000000000000,Block 3015, Block Group 3, Census Tract 42, Fulton County, Georgia,0,0,0,0,0,0,0,0
-1,131210043001002.000000000000000,Block 1002, Block Group 1, Census Tract 43, Fulton County, Georgia,0,0,0,0,0,0,0,0
-1,131210043001005.000000000000000,Block 1005, Block Group 1, Census Tract 43, Fulton County, Georgia,0,0,0,0,0,0,0,0
-1,131210043001007.000000000000000,Block 1007, Block Group 1, Census Tract 43, Fulton County, Georgia,0,0,0,0,0,0,0,0
-1,131210043001008.000000000000000,Block 1008, Block Group 1, Census Tract 43, Fulton County, Georgia,0,0,0,0,0,0,0,0
-1,131210043001009.000000000000000,Block 1009, Block Group 1, Census Tract 43, Fulton County, Georgia,0,0,0,0,0,0,0,0
-1,131210043001010.000000000000000,Block 1010, Block Group 1, Census Tract 43, Fulton County, Georgia,0,0,0,0,0,0,0,0
-1,131210043001011.000000000000000,Block 1011, Block Group 1, Census Tract 43, Fulton County, Georgia,0,0,0,0,0,0,0,0
-1,131210043003001.000000000000000,Block 3001, Block Group 3, Census Tract 43, Fulton County, Georgia,0,0,0,0,0,0,0,0
-1,131210043003006.000000000000000,Block 3006, Block Group 3, Census Tract 43, Fulton County, Georgia,0,0,0,0,0,0,0,0
-1,131210044001002.000000000000000,Block 1002, Block Group 1, Census Tract 44, Fulton County, Georgia,0,0,0,0,0,0,0,0
-1,131210044001003.000000000000000,Block 1003, Block Group 1, Census Tract 44, Fulton County, Georgia,0,0,0,0,0,0,0,0
-1,131210044001007.000000000000000,Block 1007, Block Group 1, Census Tract 44, Fulton County, Georgia,0,0,0,0,0,0,0,0
-1,131210044002000.000000000000000,Block 2000, Block Group 2, Census Tract 44, Fulton County, Georgia,0,0,0,0,0,0,0,0
-1,131210044002002.000000000000000,Block 2002, Block Group 2, Census Tract 44, Fulton County, Georgia,0,0,0,0,0,0,0,0
-1,131210044002003.000000000000000,Block 2003, Block Group 2, Census Tract 44, Fulton County, Georgia,0,0,0,0,0,0,0,0
-1,131210044002004.000000000000000,Block 2004, Block Group 2, Census Tract 44, Fulton County, Georgia,0,0,0,0,0,0,0,0
-1,131210044002005.000000000000000,Block 2005, Block Group 2, Census Tract 44, Fulton County, Georgia,0,0,0,0,0,0,0,0
-1,131210044002009.000000000000000,Block 2009, Block Group 2, Census Tract 44, Fulton County, Georgia,0,0,0,0,0,0,0,0
-1,131210044002010.000000000000000,Block 2010, Block Group 2, Census Tract 44, Fulton County, Georgia,0,0,0,0,0,0,0,0
-1,131210044002019.000000000000000,Block 2019, Block Group 2, Census Tract 44, Fulton County, Georgia,0,0,0,0,0,0,0,0
-1,131210044002021.000000000000000,Block 2021, Block Group 2, Census Tract 44, Fulton County, Georgia,0,0,0,0,0,0,0,0
-1,131210044002026.000000000000000,Block 2026, Block Group 2, Census Tract 44, Fulton County, Georgia,0,0,0,0,0,0,0,0
-1,131210048001001.000000000000000,Block 1001, Block Group 1, Census Tract 48, Fulton County, Georgia,0,0,0,0,0,0,0,0
-1,131210048001002.000000000000000,Block 1002, Block Group 1, Census Tract 48, Fulton County, Georgia,0,0,0,0,0,0,0,0
-1,131210048001005.000000000000000,Block 1005, Block Group 1, Census Tract 48, Fulton County, Georgia,0,0,0,0,0,0,0,0
-1,131210048002003.000000000000000,Block 2003, Block Group 2, Census Tract 48, Fulton County, Georgia,0,0,0,0,0,0,0,0
-1,131210048002004.000000000000000,Block 2004, Block Group 2, Census Tract 48, Fulton County, Georgia,0,0,0,0,0,0,0,0
-1,131210048002006.000000000000000,Block 2006, Block Group 2, Census Tract 48, Fulton County, Georgia,0,0,0,0,0,0,0,0
-1,131210048002008.000000000000000,Block 2008, Block Group 2, Census Tract 48, Fulton County, Georgia,0,0,0,0,0,0,0,0
-1,131210048002009.000000000000000,Block 2009, Block Group 2, Census Tract 48, Fulton County, Georgia,0,0,0,0,0,0,0,0
-1,131210048002010.000000000000000,Block 2010, Block Group 2, Census Tract 48, Fulton County, Georgia,0,0,0,0,0,0,0,0
-1,131210049001010.000000000000000,Block 1010, Block Group 1, Census Tract 49, Fulton County, Georgia,0,0,0,0,0,0,0,0
-1,131210049001011.000000000000000,Block 1011, Block Group 1, Census Tract 49, Fulton County, Georgia,0,0,0,0,0,0,0,0
-1,131210049001017.000000000000000,Block 1017, Block Group 1, Census Tract 49, Fulton County, Georgia,0,0,0,0,0,0,0,0
-1,131210049001018.000000000000000,Block 1018, Block Group 1, Census Tract 49, Fulton County, Georgia,0,0,0,0,0,0,0,0
-1,131210049002008.000000000000000,Block 2008, Block Group 2, Census Tract 49, Fulton County, Georgia,0,0,0,0,0,0,0,0
-1,131210049002032.000000000000000,Block 2032, Block Group 2, Census Tract 49, Fulton County, Georgia,0,0,0,0,0,0,0,0
-1,131210050001001.000000000000000,Block 1001, Block Group 1, Census Tract 50, Fulton County, Georgia,0,0,0,0,0,0,0,0
-1,131210050001003.000000000000000,Block 1003, Block Group 1, Census Tract 50, Fulton County, Georgia,0,0,0,0,0,0,0,0
-1,131210050001007.000000000000000,Block 1007, Block Group 1, Census Tract 50, Fulton County, Georgia,0,0,0,0,0,0,0,0
-1,131210050001008.000000000000000,Block 1008, Block Group 1, Census Tract 50, Fulton County, Georgia,0,0,0,0,0,0,0,0
-1,131210050002013.000000000000000,Block 2013, Block Group 2, Census Tract 50, Fulton County, Georgia,0,0,0,0,0,0,0,0
-1,131210052004001.000000000000000,Block 4001, Block Group 4, Census Tract 52, Fulton County, Georgia,0,0,0,0,0,0,0,0
-1,131210052004010.000000000000000,Block 4010, Block Group 4, Census Tract 52, Fulton County, Georgia,0,0,0,0,0,0,0,0
-1,131210052004011.000000000000000,Block 4011, Block Group 4, Census Tract 52, Fulton County, Georgia,0,0,0,0,0,0,0,0
-1,131210052004017.000000000000000,Block 4017, Block Group 4, Census Tract 52, Fulton County, Georgia,0,0,0,0,0,0,0,0
-1,131210053002024.000000000000000,Block 2024, Block Group 2, Census Tract 53, Fulton County, Georgia,0,0,0,0,0,0,0,0
-1,131210055011002.000000000000000,Block 1002, Block Group 1, Census Tract 55.01, Fulton County, Georgia,0,0,0,0,0,0,0,0
-1,131210055011003.000000000000000,Block 1003, Block Group 1, Census Tract 55.01, Fulton County, Georgia,0,0,0,0,0,0,0,0
-1,131210055012008.000000000000000,Block 2008, Block Group 2, Census Tract 55.01, Fulton County, Georgia,0,0,0,0,0,0,0,0
-1,131210055012019.000000000000000,Block 2019, Block Group 2, Census Tract 55.01, Fulton County, Georgia,0,0,0,0,0,0,0,0
-1,131210055032001.000000000000000,Block 2001, Block Group 2, Census Tract 55.03, Fulton County, Georgia,0,0,0,0,0,0,0,0
-1,131210055032003.000000000000000,Block 2003, Block Group 2, Census Tract 55.03, Fulton County, Georgia,0,0,0,0,0,0,0,0
-1,131210055032004.000000000000000,Block 2004, Block Group 2, Census Tract 55.03, Fulton County, Georgia,0,0,0,0,0,0,0,0
-1,131210055032005.000000000000000,Block 2005, Block Group 2, Census Tract 55.03, Fulton County, Georgia,0,0,0,0,0,0,0,0
-1,131210055032006.000000000000000,Block 2006, Block Group 2, Census Tract 55.03, Fulton County, Georgia,0,0,0,0,0,0,0,0
-1,131210055032007.000000000000000,Block 2007, Block Group 2, Census Tract 55.03, Fulton County, Georgia,0,0,0,0,0,0,0,0
-1,131210055032009.000000000000000,Block 2009, Block Group 2, Census Tract 55.03, Fulton County, Georgia,0,0,0,0,0,0,0,0
-1,131210055041001.000000000000000,Block 1001, Block Group 1, Census Tract 55.04, Fulton County, Georgia,0,0,0,0,0,0,0,0
-1,131210055041016.000000000000000,Block 1016, Block Group 1, Census Tract 55.04, Fulton County, Georgia,0,0,0,0,0,0,0,0
-1,131210055042002.000000000000000,Block 2002, Block Group 2, Census Tract 55.04, Fulton County, Georgia,0,0,0,0,0,0,0,0
-1,131210057002000.000000000000000,Block 2000, Block Group 2, Census Tract 57, Fulton County, Georgia,0,0,0,0,0,0,0,0
-1,131210057002001.000000000000000,Block 2001, Block Group 2, Census Tract 57, Fulton County, Georgia,0,0,0,0,0,0,0,0
-1,131210057002002.000000000000000,Block 2002, Block Group 2, Census Tract 57, Fulton County, Georgia,0,0,0,0,0,0,0,0
-1,131210057002006.000000000000000,Block 2006, Block Group 2, Census Tract 57, Fulton County, Georgia,0,0,0,0,0,0,0,0
-1,131210057002007.000000000000000,Block 2007, Block Group 2, Census Tract 57, Fulton County, Georgia,0,0,0,0,0,0,0,0
-1,131210057002008.000000000000000,Block 2008, Block Group 2, Census Tract 57, Fulton County, Georgia,0,0,0,0,0,0,0,0
-1,131210058001000.000000000000000,Block 1000, Block Group 1, Census Tract 58, Fulton County, Georgia,0,0,0,0,0,0,0,0
-1,131210058001001.000000000000000,Block 1001, Block Group 1, Census Tract 58, Fulton County, Georgia,0,0,0,0,0,0,0,0
-1,131210058001003.000000000000000,Block 1003, Block Group 1, Census Tract 58, Fulton County, Georgia,0,0,0,0,0,0,0,0
-1,131210058001004.000000000000000,Block 1004, Block Group 1, Census Tract 58, Fulton County, Georgia,0,0,0,0,0,0,0,0
-1,131210058001005.000000000000000,Block 1005, Block Group 1, Census Tract 58, Fulton County, Georgia,0,0,0,0,0,0,0,0
-1,131210058001006.000000000000000,Block 1006, Block Group 1, Census Tract 58, Fulton County, Georgia,0,0,0,0,0,0,0,0
-1,131210058001007.000000000000000,Block 1007, Block Group 1, Census Tract 58, Fulton County, Georgia,0,0,0,0,0,0,0,0
-1,131210058001008.000000000000000,Block 1008, Block Group 1, Census Tract 58, Fulton County, Georgia,0,0,0,0,0,0,0,0
-1,131210058001009.000000000000000,Block 1009, Block Group 1, Census Tract 58, Fulton County, Georgia,0,0,0,0,0,0,0,0
-1,131210058001010.000000000000000,Block 1010, Block Group 1, Census Tract 58, Fulton County, Georgia,0,0,0,0,0,0,0,0
-1,131210058001011.000000000000000,Block 1011, Block Group 1, Census Tract 58, Fulton County, Georgia,0,0,0,0,0,0,0,0
-1,131210058001012.000000000000000,Block 1012, Block Group 1, Census Tract 58, Fulton County, Georgia,0,0,0,0,0,0,0,0
-1,131210058001013.000000000000000,Block 1013, Block Group 1, Census Tract 58, Fulton County, Georgia,0,0,0,0,0,0,0,0
-1,131210058001014.000000000000000,Block 1014, Block Group 1, Census Tract 58, Fulton County, Georgia,0,0,0,0,0,0,0,0
-1,131210058001015.000000000000000,Block 1015, Block Group 1, Census Tract 58, Fulton County, Georgia,0,0,0,0,0,0,0,0
-1,131210058001016.000000000000000,Block 1016, Block Group 1, Census Tract 58, Fulton County, Georgia,0,0,0,0,0,0,0,0
-1,131210058001017.000000000000000,Block 1017, Block Group 1, Census Tract 58, Fulton County, Georgia,0,0,0,0,0,0,0,0
-1,131210058001019.000000000000000,Block 1019, Block Group 1, Census Tract 58, Fulton County, Georgia,0,0,0,0,0,0,0,0
-1,131210058001020.000000000000000,Block 1020, Block Group 1, Census Tract 58, Fulton County, Georgia,0,0,0,0,0,0,0,0
-1,131210058001022.000000000000000,Block 1022, Block Group 1, Census Tract 58, Fulton County, Georgia,0,0,0,0,0,0,0,0
-1,131210058001023.000000000000000,Block 1023, Block Group 1, Census Tract 58, Fulton County, Georgia,0,0,0,0,0,0,0,0
-1,131210058001026.000000000000000,Block 1026, Block Group 1, Census Tract 58, Fulton County, Georgia,0,0,0,0,0,0,0,0
-1,131210058001027.000000000000000,Block 1027, Block Group 1, Census Tract 58, Fulton County, Georgia,0,0,0,0,0,0,0,0
-1,131210058001028.000000000000000,Block 1028, Block Group 1, Census Tract 58, Fulton County, Georgia,0,0,0,0,0,0,0,0
-1,131210058001029.000000000000000,Block 1029, Block Group 1, Census Tract 58, Fulton County, Georgia,0,0,0,0,0,0,0,0
-1,131210058001051.000000000000000,Block 1051, Block Group 1, Census Tract 58, Fulton County, Georgia,0,0,0,0,0,0,0,0
-1,131210058001052.000000000000000,Block 1052, Block Group 1, Census Tract 58, Fulton County, Georgia,0,0,0,0,0,0,0,0
-1,131210061001001.000000000000000,Block 1001, Block Group 1, Census Tract 61, Fulton County, Georgia,0,0,0,0,0,0,0,0
-1,131210061002012.000000000000000,Block 2012, Block Group 2, Census Tract 61, Fulton County, Georgia,0,0,0,0,0,0,0,0
-1,131210062001003.000000000000000,Block 1003, Block Group 1, Census Tract 62, Fulton County, Georgia,0,0,0,0,0,0,0,0
-1,131210062001005.000000000000000,Block 1005, Block Group 1, Census Tract 62, Fulton County, Georgia,0,0,0,0,0,0,0,0
-1,131210062001006.000000000000000,Block 1006, Block Group 1, Census Tract 62, Fulton County, Georgia,0,0,0,0,0,0,0,0
-1,131210062001010.000000000000000,Block 1010, Block Group 1, Census Tract 62, Fulton County, Georgia,0,0,0,0,0,0,0,0
-1,131210063001033.000000000000000,Block 1033, Block Group 1, Census Tract 63, Fulton County, Georgia,0,0,0,0,0,0,0,0
-1,131210063001034.000000000000000,Block 1034, Block Group 1, Census Tract 63, Fulton County, Georgia,0,0,0,0,0,0,0,0
-1,131210063001035.000000000000000,Block 1035, Block Group 1, Census Tract 63, Fulton County, Georgia,0,0,0,0,0,0,0,0
-1,131210063001036.000000000000000,Block 1036, Block Group 1, Census Tract 63, Fulton County, Georgia,0,0,0,0,0,0,0,0
-1,131210063001037.000000000000000,Block 1037, Block Group 1, Census Tract 63, Fulton County, Georgia,0,0,0,0,0,0,0,0
-1,131210063001038.000000000000000,Block 1038, Block Group 1, Census Tract 63, Fulton County, Georgia,0,0,0,0,0,0,0,0
-1,131210064001000.000000000000000,Block 1000, Block Group 1, Census Tract 64, Fulton County, Georgia,0,0,0,0,0,0,0,0
-1,131210064001015.000000000000000,Block 1015, Block Group 1, Census Tract 64, Fulton County, Georgia,0,0,0,0,0,0,0,0
-1,131210065001000.000000000000000,Block 1000, Block Group 1, Census Tract 65, Fulton County, Georgia,0,0,0,0,0,0,0,0
-1,131210065001012.000000000000000,Block 1012, Block Group 1, Census Tract 65, Fulton County, Georgia,0,0,0,0,0,0,0,0
-1,131210065001013.000000000000000,Block 1013, Block Group 1, Census Tract 65, Fulton County, Georgia,0,0,0,0,0,0,0,0
-1,131210065001014.000000000000000,Block 1014, Block Group 1, Census Tract 65, Fulton County, Georgia,0,0,0,0,0,0,0,0
-1,131210065001015.000000000000000,Block 1015, Block Group 1, Census Tract 65, Fulton County, Georgia,0,0,0,0,0,0,0,0
-1,131210065001016.000000000000000,Block 1016, Block Group 1, Census Tract 65, Fulton County, Georgia,0,0,0,0,0,0,0,0
-1,131210065001017.000000000000000,Block 1017, Block Group 1, Census Tract 65, Fulton County, Georgia,0,0,0,0,0,0,0,0
-1,131210065003000.000000000000000,Block 3000, Block Group 3, Census Tract 65, Fulton County, Georgia,0,0,0,0,0,0,0,0
-1,131210065003001.000000000000000,Block 3001, Block Group 3, Census Tract 65, Fulton County, Georgia,0,0,0,0,0,0,0,0
-1,131210065003002.000000000000000,Block 3002, Block Group 3, Census Tract 65, Fulton County, Georgia,0,0,0,0,0,0,0,0
-1,131210065003005.000000000000000,Block 3005, Block Group 3, Census Tract 65, Fulton County, Georgia,0,0,0,0,0,0,0,0
-1,131210065003010.000000000000000,Block 3010, Block Group 3, Census Tract 65, Fulton County, Georgia,0,0,0,0,0,0,0,0
-1,131210066011000.000000000000000,Block 1000, Block Group 1, Census Tract 66.01, Fulton County, Georgia,0,0,0,0,0,0,0,0
-1,131210066011001.000000000000000,Block 1001, Block Group 1, Census Tract 66.01, Fulton County, Georgia,0,0,0,0,0,0,0,0
-1,131210066011003.000000000000000,Block 1003, Block Group 1, Census Tract 66.01, Fulton County, Georgia,0,0,0,0,0,0,0,0
-1,131210066011004.000000000000000,Block 1004, Block Group 1, Census Tract 66.01, Fulton County, Georgia,0,0,0,0,0,0,0,0
-1,131210066011013.000000000000000,Block 1013, Block Group 1, Census Tract 66.01, Fulton County, Georgia,0,0,0,0,0,0,0,0
-1,131210066012015.000000000000000,Block 2015, Block Group 2, Census Tract 66.01, Fulton County, Georgia,0,0,0,0,0,0,0,0
-1,131210066012016.000000000000000,Block 2016, Block Group 2, Census Tract 66.01, Fulton County, Georgia,0,0,0,0,0,0,0,0
-1,131210066012017.000000000000000,Block 2017, Block Group 2, Census Tract 66.01, Fulton County, Georgia,0,0,0,0,0,0,0,0
-1,131210066012018.000000000000000,Block 2018, Block Group 2, Census Tract 66.01, Fulton County, Georgia,0,0,0,0,0,0,0,0
-1,131210066021011.000000000000000,Block 1011, Block Group 1, Census Tract 66.02, Fulton County, Georgia,0,0,0,0,0,0,0,0
-1,131210066021012.000000000000000,Block 1012, Block Group 1, Census Tract 66.02, Fulton County, Georgia,0,0,0,0,0,0,0,0
-1,131210067011007.000000000000000,Block 1007, Block Group 1, Census Tract 67.01, Fulton County, Georgia,0,0,0,0,0,0,0,0
-1,131210067012000.000000000000000,Block 2000, Block Group 2, Census Tract 67.01, Fulton County, Georgia,0,0,0,0,0,0,0,0
-1,131210067012001.000000000000000,Block 2001, Block Group 2, Census Tract 67.01, Fulton County, Georgia,0,0,0,0,0,0,0,0
-1,131210067021004.000000000000000,Block 1004, Block Group 1, Census Tract 67.02, Fulton County, Georgia,0,0,0,0,0,0,0,0
-1,131210067021005.000000000000000,Block 1005, Block Group 1, Census Tract 67.02, Fulton County, Georgia,0,0,0,0,0,0,0,0
-1,131210067021014.000000000000000,Block 1014, Block Group 1, Census Tract 67.02, Fulton County, Georgia,0,0,0,0,0,0,0,0
-1,131210067021043.000000000000000,Block 1043, Block Group 1, Census Tract 67.02, Fulton County, Georgia,0,0,0,0,0,0,0,0
-1,131210067022003.000000000000000,Block 2003, Block Group 2, Census Tract 67.02, Fulton County, Georgia,0,0,0,0,0,0,0,0
-1,131210067022009.000000000000000,Block 2009, Block Group 2, Census Tract 67.02, Fulton County, Georgia,0,0,0,0,0,0,0,0
-1,131210067022012.000000000000000,Block 2012, Block Group 2, Census Tract 67.02, Fulton County, Georgia,0,0,0,0,0,0,0,0
-1,131210067022013.000000000000000,Block 2013, Block Group 2, Census Tract 67.02, Fulton County, Georgia,0,0,0,0,0,0,0,0
-1,131210068021001.000000000000000,Block 1001, Block Group 1, Census Tract 68.02, Fulton County, Georgia,0,0,0,0,0,0,0,0
-1,131210068021004.000000000000000,Block 1004, Block Group 1, Census Tract 68.02, Fulton County, Georgia,0,0,0,0,0,0,0,0
-1,131210069003000.000000000000000,Block 3000, Block Group 3, Census Tract 69, Fulton County, Georgia,0,0,0,0,0,0,0,0
-1,131210069003001.000000000000000,Block 3001, Block Group 3, Census Tract 69, Fulton County, Georgia,0,0,0,0,0,0,0,0
-1,131210069003002.000000000000000,Block 3002, Block Group 3, Census Tract 69, Fulton County, Georgia,0,0,0,0,0,0,0,0
-1,131210069003017.000000000000000,Block 3017, Block Group 3, Census Tract 69, Fulton County, Georgia,0,0,0,0,0,0,0,0
-1,131210070012006.000000000000000,Block 2006, Block Group 2, Census Tract 70.01, Fulton County, Georgia,0,0,0,0,0,0,0,0
-1,131210070012007.000000000000000,Block 2007, Block Group 2, Census Tract 70.01, Fulton County, Georgia,0,0,0,0,0,0,0,0
-1,131210070012008.000000000000000,Block 2008, Block Group 2, Census Tract 70.01, Fulton County, Georgia,0,0,0,0,0,0,0,0
-1,131210070014000.000000000000000,Block 4000, Block Group 4, Census Tract 70.01, Fulton County, Georgia,0,0,0,0,0,0,0,0
-1,131210070014001.000000000000000,Block 4001, Block Group 4, Census Tract 70.01, Fulton County, Georgia,0,0,0,0,0,0,0,0
-1,131210070014003.000000000000000,Block 4003, Block Group 4, Census Tract 70.01, Fulton County, Georgia,0,0,0,0,0,0,0,0
-1,131210070014004.000000000000000,Block 4004, Block Group 4, Census Tract 70.01, Fulton County, Georgia,0,0,0,0,0,0,0,0
-1,131210070014012.000000000000000,Block 4012, Block Group 4, Census Tract 70.01, Fulton County, Georgia,0,0,0,0,0,0,0,0
-1,131210070022009.000000000000000,Block 2009, Block Group 2, Census Tract 70.02, Fulton County, Georgia,0,0,0,0,0,0,0,0
-1,131210070024003.000000000000000,Block 4003, Block Group 4, Census Tract 70.02, Fulton County, Georgia,0,0,0,0,0,0,0,0
-1,131210070024005.000000000000000,Block 4005, Block Group 4, Census Tract 70.02, Fulton County, Georgia,0,0,0,0,0,0,0,0
-1,131210070024008.000000000000000,Block 4008, Block Group 4, Census Tract 70.02, Fulton County, Georgia,0,0,0,0,0,0,0,0
-1,131210071001009.000000000000000,Block 1009, Block Group 1, Census Tract 71, Fulton County, Georgia,0,0,0,0,0,0,0,0
-1,131210071001011.000000000000000,Block 1011, Block Group 1, Census Tract 71, Fulton County, Georgia,0,0,0,0,0,0,0,0
-1,131210071001019.000000000000000,Block 1019, Block Group 1, Census Tract 71, Fulton County, Georgia,0,0,0,0,0,0,0,0
-1,131210071001021.000000000000000,Block 1021, Block Group 1, Census Tract 71, Fulton County, Georgia,0,0,0,0,0,0,0,0
-1,131210071002001.000000000000000,Block 2001, Block Group 2, Census Tract 71, Fulton County, Georgia,0,0,0,0,0,0,0,0
-1,131210071002004.000000000000000,Block 2004, Block Group 2, Census Tract 71, Fulton County, Georgia,0,0,0,0,0,0,0,0
-1,131210072001006.000000000000000,Block 1006, Block Group 1, Census Tract 72, Fulton County, Georgia,0,0,0,0,0,0,0,0
-1,131210072001007.000000000000000,Block 1007, Block Group 1, Census Tract 72, Fulton County, Georgia,0,0,0,0,0,0,0,0
-1,131210072001009.000000000000000,Block 1009, Block Group 1, Census Tract 72, Fulton County, Georgia,0,0,0,0,0,0,0,0
-1,131210072001010.000000000000000,Block 1010, Block Group 1, Census Tract 72, Fulton County, Georgia,0,0,0,0,0,0,0,0
-1,131210072001011.000000000000000,Block 1011, Block Group 1, Census Tract 72, Fulton County, Georgia,0,0,0,0,0,0,0,0
-1,131210072001012.000000000000000,Block 1012, Block Group 1, Census Tract 72, Fulton County, Georgia,0,0,0,0,0,0,0,0
-1,131210072001013.000000000000000,Block 1013, Block Group 1, Census Tract 72, Fulton County, Georgia,0,0,0,0,0,0,0,0
-1,131210072001014.000000000000000,Block 1014, Block Group 1, Census Tract 72, Fulton County, Georgia,0,0,0,0,0,0,0,0
-1,131210072001015.000000000000000,Block 1015, Block Group 1, Census Tract 72, Fulton County, Georgia,0,0,0,0,0,0,0,0
-1,131210072001016.000000000000000,Block 1016, Block Group 1, Census Tract 72, Fulton County, Georgia,0,0,0,0,0,0,0,0
-1,131210072001017.000000000000000,Block 1017, Block Group 1, Census Tract 72, Fulton County, Georgia,0,0,0,0,0,0,0,0
-1,131210072001018.000000000000000,Block 1018, Block Group 1, Census Tract 72, Fulton County, Georgia,0,0,0,0,0,0,0,0
-1,131210072001019.000000000000000,Block 1019, Block Group 1, Census Tract 72, Fulton County, Georgia,0,0,0,0,0,0,0,0
-1,131210072001020.000000000000000,Block 1020, Block Group 1, Census Tract 72, Fulton County, Georgia,0,0,0,0,0,0,0,0
-1,131210072001021.000000000000000,Block 1021, Block Group 1, Census Tract 72, Fulton County, Georgia,0,0,0,0,0,0,0,0
-1,131210072001022.000000000000000,Block 1022, Block Group 1, Census Tract 72, Fulton County, Georgia,0,0,0,0,0,0,0,0
-1,131210072001023.000000000000000,Block 1023, Block Group 1, Census Tract 72, Fulton County, Georgia,0,0,0,0,0,0,0,0
-1,131210072002000.000000000000000,Block 2000, Block Group 2, Census Tract 72, Fulton County, Georgia,0,0,0,0,0,0,0,0
-1,131210072003005.000000000000000,Block 3005, Block Group 3, Census Tract 72, Fulton County, Georgia,0,0,0,0,0,0,0,0
-1,131210072003006.000000000000000,Block 3006, Block Group 3, Census Tract 72, Fulton County, Georgia,0,0,0,0,0,0,0,0
-1,131210072003007.000000000000000,Block 3007, Block Group 3, Census Tract 72, Fulton County, Georgia,0,0,0,0,0,0,0,0
-1,131210072003014.000000000000000,Block 3014, Block Group 3, Census Tract 72, Fulton County, Georgia,0,0,0,0,0,0,0,0
-1,131210072003015.000000000000000,Block 3015, Block Group 3, Census Tract 72, Fulton County, Georgia,0,0,0,0,0,0,0,0
-1,131210072003016.000000000000000,Block 3016, Block Group 3, Census Tract 72, Fulton County, Georgia,0,0,0,0,0,0,0,0
-1,131210072003017.000000000000000,Block 3017, Block Group 3, Census Tract 72, Fulton County, Georgia,0,0,0,0,0,0,0,0
-1,131210073011001.000000000000000,Block 1001, Block Group 1, Census Tract 73.01, Fulton County, Georgia,0,0,0,0,0,0,0,0
-1,131210073011005.000000000000000,Block 1005, Block Group 1, Census Tract 73.01, Fulton County, Georgia,0,0,0,0,0,0,0,0
-1,131210073011017.000000000000000,Block 1017, Block Group 1, Census Tract 73.01, Fulton County, Georgia,0,0,0,0,0,0,0,0
-1,131210073011018.000000000000000,Block 1018, Block Group 1, Census Tract 73.01, Fulton County, Georgia,0,0,0,0,0,0,0,0
-1,131210073011019.000000000000000,Block 1019, Block Group 1, Census Tract 73.01, Fulton County, Georgia,0,0,0,0,0,0,0,0
-1,131210073021009.000000000000000,Block 1009, Block Group 1, Census Tract 73.02, Fulton County, Georgia,0,0,0,0,0,0,0,0
-1,131210074001002.000000000000000,Block 1002, Block Group 1, Census Tract 74, Fulton County, Georgia,0,0,0,0,0,0,0,0
-1,131210074001005.000000000000000,Block 1005, Block Group 1, Census Tract 74, Fulton County, Georgia,0,0,0,0,0,0,0,0
-1,131210074001006.000000000000000,Block 1006, Block Group 1, Census Tract 74, Fulton County, Georgia,0,0,0,0,0,0,0,0
-1,131210074001007.000000000000000,Block 1007, Block Group 1, Census Tract 74, Fulton County, Georgia,0,0,0,0,0,0,0,0
-1,131210074001009.000000000000000,Block 1009, Block Group 1, Census Tract 74, Fulton County, Georgia,0,0,0,0,0,0,0,0
-1,131210074002000.000000000000000,Block 2000, Block Group 2, Census Tract 74, Fulton County, Georgia,0,0,0,0,0,0,0,0
-1,131210074002015.000000000000000,Block 2015, Block Group 2, Census Tract 74, Fulton County, Georgia,0,0,0,0,0,0,0,0
-1,131210074003000.000000000000000,Block 3000, Block Group 3, Census Tract 74, Fulton County, Georgia,0,0,0,0,0,0,0,0
-1,131210074003004.000000000000000,Block 3004, Block Group 3, Census Tract 74, Fulton County, Georgia,0,0,0,0,0,0,0,0
-1,131210074003005.000000000000000,Block 3005, Block Group 3, Census Tract 74, Fulton County, Georgia,0,0,0,0,0,0,0,0
-1,131210075001000.000000000000000,Block 1000, Block Group 1, Census Tract 75, Fulton County, Georgia,0,0,0,0,0,0,0,0
-1,131210075001004.000000000000000,Block 1004, Block Group 1, Census Tract 75, Fulton County, Georgia,0,0,0,0,0,0,0,0
-1,131210075001006.000000000000000,Block 1006, Block Group 1, Census Tract 75, Fulton County, Georgia,0,0,0,0,0,0,0,0
-1,131210075001012.000000000000000,Block 1012, Block Group 1, Census Tract 75, Fulton County, Georgia,0,0,0,0,0,0,0,0
-1,131210075001013.000000000000000,Block 1013, Block Group 1, Census Tract 75, Fulton County, Georgia,0,0,0,0,0,0,0,0
-1,131210075001014.000000000000000,Block 1014, Block Group 1, Census Tract 75, Fulton County, Georgia,0,0,0,0,0,0,0,0
-1,131210075001015.000000000000000,Block 1015, Block Group 1, Census Tract 75, Fulton County, Georgia,0,0,0,0,0,0,0,0
-1,131210075001016.000000000000000,Block 1016, Block Group 1, Census Tract 75, Fulton County, Georgia,0,0,0,0,0,0,0,0
-1,131210075001017.000000000000000,Block 1017, Block Group 1, Census Tract 75, Fulton County, Georgia,0,0,0,0,0,0,0,0
-1,131210075001020.000000000000000,Block 1020, Block Group 1, Census Tract 75, Fulton County, Georgia,0,0,0,0,0,0,0,0
-1,131210075001021.000000000000000,Block 1021, Block Group 1, Census Tract 75, Fulton County, Georgia,0,0,0,0,0,0,0,0
-1,131210075001022.000000000000000,Block 1022, Block Group 1, Census Tract 75, Fulton County, Georgia,0,0,0,0,0,0,0,0
-1,131210075001023.000000000000000,Block 1023, Block Group 1, Census Tract 75, Fulton County, Georgia,0,0,0,0,0,0,0,0
-1,131210075002003.000000000000000,Block 2003, Block Group 2, Census Tract 75, Fulton County, Georgia,0,0,0,0,0,0,0,0
-1,131210075002004.000000000000000,Block 2004, Block Group 2, Census Tract 75, Fulton County, Georgia,0,0,0,0,0,0,0,0
-1,131210075002005.000000000000000,Block 2005, Block Group 2, Census Tract 75, Fulton County, Georgia,0,0,0,0,0,0,0,0
-1,131210075002007.000000000000000,Block 2007, Block Group 2, Census Tract 75, Fulton County, Georgia,0,0,0,0,0,0,0,0
-1,131210075002008.000000000000000,Block 2008, Block Group 2, Census Tract 75, Fulton County, Georgia,0,0,0,0,0,0,0,0
-1,131210075002009.000000000000000,Block 2009, Block Group 2, Census Tract 75, Fulton County, Georgia,0,0,0,0,0,0,0,0
-1,131210075002011.000000000000000,Block 2011, Block Group 2, Census Tract 75, Fulton County, Georgia,0,0,0,0,0,0,0,0
-1,131210075003019.000000000000000,Block 3019, Block Group 3, Census Tract 75, Fulton County, Georgia,0,0,0,0,0,0,0,0
-1,131210076022004.000000000000000,Block 2004, Block Group 2, Census Tract 76.02, Fulton County, Georgia,0,0,0,0,0,0,0,0
-1,131210076031008.000000000000000,Block 1008, Block Group 1, Census Tract 76.03, Fulton County, Georgia,0,0,0,0,0,0,0,0
-1,131210076031009.000000000000000,Block 1009, Block Group 1, Census Tract 76.03, Fulton County, Georgia,0,0,0,0,0,0,0,0
-1,131210076031010.000000000000000,Block 1010, Block Group 1, Census Tract 76.03, Fulton County, Georgia,0,0,0,0,0,0,0,0
-1,131210076033000.000000000000000,Block 3000, Block Group 3, Census Tract 76.03, Fulton County, Georgia,0,0,0,0,0,0,0,0
-1,131210076033001.000000000000000,Block 3001, Block Group 3, Census Tract 76.03, Fulton County, Georgia,0,0,0,0,0,0,0,0
-1,131210076033002.000000000000000,Block 3002, Block Group 3, Census Tract 76.03, Fulton County, Georgia,0,0,0,0,0,0,0,0
-1,131210076033003.000000000000000,Block 3003, Block Group 3, Census Tract 76.03, Fulton County, Georgia,0,0,0,0,0,0,0,0
-1,131210076033004.000000000000000,Block 3004, Block Group 3, Census Tract 76.03, Fulton County, Georgia,0,0,0,0,0,0,0,0
-1,131210076033005.000000000000000,Block 3005, Block Group 3, Census Tract 76.03, Fulton County, Georgia,0,0,0,0,0,0,0,0
-1,131210076033006.000000000000000,Block 3006, Block Group 3, Census Tract 76.03, Fulton County, Georgia,0,0,0,0,0,0,0,0
-1,131210076033007.000000000000000,Block 3007, Block Group 3, Census Tract 76.03, Fulton County, Georgia,0,0,0,0,0,0,0,0
-1,131210076033009.000000000000000,Block 3009, Block Group 3, Census Tract 76.03, Fulton County, Georgia,0,0,0,0,0,0,0,0
-1,131210076033010.000000000000000,Block 3010, Block Group 3, Census Tract 76.03, Fulton County, Georgia,0,0,0,0,0,0,0,0
-1,131210076033011.000000000000000,Block 3011, Block Group 3, Census Tract 76.03, Fulton County, Georgia,0,0,0,0,0,0,0,0
-1,131210076033012.000000000000000,Block 3012, Block Group 3, Census Tract 76.03, Fulton County, Georgia,0,0,0,0,0,0,0,0
-1,131210076033013.000000000000000,Block 3013, Block Group 3, Census Tract 76.03, Fulton County, Georgia,0,0,0,0,0,0,0,0
-1,131210076033014.000000000000000,Block 3014, Block Group 3, Census Tract 76.03, Fulton County, Georgia,0,0,0,0,0,0,0,0
-1,131210076033015.000000000000000,Block 3015, Block Group 3, Census Tract 76.03, Fulton County, Georgia,0,0,0,0,0,0,0,0
-1,131210076033016.000000000000000,Block 3016, Block Group 3, Census Tract 76.03, Fulton County, Georgia,0,0,0,0,0,0,0,0
-1,131210076033017.000000000000000,Block 3017, Block Group 3, Census Tract 76.03, Fulton County, Georgia,0,0,0,0,0,0,0,0
-1,131210076033023.000000000000000,Block 3023, Block Group 3, Census Tract 76.03, Fulton County, Georgia,0,0,0,0,0,0,0,0
-1,131210076033024.000000000000000,Block 3024, Block Group 3, Census Tract 76.03, Fulton County, Georgia,0,0,0,0,0,0,0,0
-1,131210076033025.000000000000000,Block 3025, Block Group 3, Census Tract 76.03, Fulton County, Georgia,0,0,0,0,0,0,0,0
-1,131210076033027.000000000000000,Block 3027, Block Group 3, Census Tract 76.03, Fulton County, Georgia,0,0,0,0,0,0,0,0
-1,131210076033028.000000000000000,Block 3028, Block Group 3, Census Tract 76.03, Fulton County, Georgia,0,0,0,0,0,0,0,0
-1,131210076033029.000000000000000,Block 3029, Block Group 3, Census Tract 76.03, Fulton County, Georgia,0,0,0,0,0,0,0,0
-1,131210076033030.000000000000000,Block 3030, Block Group 3, Census Tract 76.03, Fulton County, Georgia,0,0,0,0,0,0,0,0
-1,131210076033031.000000000000000,Block 3031, Block Group 3, Census Tract 76.03, Fulton County, Georgia,0,0,0,0,0,0,0,0
-1,131210076041005.000000000000000,Block 1005, Block Group 1, Census Tract 76.04, Fulton County, Georgia,0,0,0,0,0,0,0,0
-1,131210076042004.000000000000000,Block 2004, Block Group 2, Census Tract 76.04, Fulton County, Georgia,0,0,0,0,0,0,0,0
-1,131210076042005.000000000000000,Block 2005, Block Group 2, Census Tract 76.04, Fulton County, Georgia,0,0,0,0,0,0,0,0
-1,131210076042006.000000000000000,Block 2006, Block Group 2, Census Tract 76.04, Fulton County, Georgia,0,0,0,0,0,0,0,0
-1,131210077031002.000000000000000,Block 1002, Block Group 1, Census Tract 77.03, Fulton County, Georgia,0,0,0,0,0,0,0,0
-1,131210077031003.000000000000000,Block 1003, Block Group 1, Census Tract 77.03, Fulton County, Georgia,0,0,0,0,0,0,0,0
-1,131210077033000.000000000000000,Block 3000, Block Group 3, Census Tract 77.03, Fulton County, Georgia,0,0,0,0,0,0,0,0
-1,131210077033001.000000000000000,Block 3001, Block Group 3, Census Tract 77.03, Fulton County, Georgia,0,0,0,0,0,0,0,0
-1,131210077033003.000000000000000,Block 3003, Block Group 3, Census Tract 77.03, Fulton County, Georgia,0,0,0,0,0,0,0,0
-1,131210077033015.000000000000000,Block 3015, Block Group 3, Census Tract 77.03, Fulton County, Georgia,0,0,0,0,0,0,0,0
-1,131210077033016.000000000000000,Block 3016, Block Group 3, Census Tract 77.03, Fulton County, Georgia,0,0,0,0,0,0,0,0
-1,131210077033017.000000000000000,Block 3017, Block Group 3, Census Tract 77.03, Fulton County, Georgia,0,0,0,0,0,0,0,0
-1,131210077051002.000000000000000,Block 1002, Block Group 1, Census Tract 77.05, Fulton County, Georgia,0,0,0,0,0,0,0,0
-1,131210077051003.000000000000000,Block 1003, Block Group 1, Census Tract 77.05, Fulton County, Georgia,0,0,0,0,0,0,0,0
-1,131210077071008.000000000000000,Block 1008, Block Group 1, Census Tract 77.07, Fulton County, Georgia,0,0,0,0,0,0,0,0
-1,131210077071009.000000000000000,Block 1009, Block Group 1, Census Tract 77.07, Fulton County, Georgia,0,0,0,0,0,0,0,0
-1,131210077071010.000000000000000,Block 1010, Block Group 1, Census Tract 77.07, Fulton County, Georgia,0,0,0,0,0,0,0,0
-1,131210077072004.000000000000000,Block 2004, Block Group 2, Census Tract 77.07, Fulton County, Georgia,0,0,0,0,0,0,0,0
-1,131210077072005.000000000000000,Block 2005, Block Group 2, Census Tract 77.07, Fulton County, Georgia,0,0,0,0,0,0,0,0
-1,131210077081002.000000000000000,Block 1002, Block Group 1, Census Tract 77.08, Fulton County, Georgia,0,0,0,0,0,0,0,0
-1,131210077081005.000000000000000,Block 1005, Block Group 1, Census Tract 77.08, Fulton County, Georgia,0,0,0,0,0,0,0,0
-1,131210077081006.000000000000000,Block 1006, Block Group 1, Census Tract 77.08, Fulton County, Georgia,0,0,0,0,0,0,0,0
-1,131210077081007.000000000000000,Block 1007, Block Group 1, Census Tract 77.08, Fulton County, Georgia,0,0,0,0,0,0,0,0
-1,131210077082002.000000000000000,Block 2002, Block Group 2, Census Tract 77.08, Fulton County, Georgia,0,0,0,0,0,0,0,0
-1,131210077091000.000000000000000,Block 1000, Block Group 1, Census Tract 77.09, Fulton County, Georgia,0,0,0,0,0,0,0,0
-1,131210077091005.000000000000000,Block 1005, Block Group 1, Census Tract 77.09, Fulton County, Georgia,0,0,0,0,0,0,0,0
-1,131210077091008.000000000000000,Block 1008, Block Group 1, Census Tract 77.09, Fulton County, Georgia,0,0,0,0,0,0,0,0
-1,131210077091010.000000000000000,Block 1010, Block Group 1, Census Tract 77.09, Fulton County, Georgia,0,0,0,0,0,0,0,0
-1,131210077091011.000000000000000,Block 1011, Block Group 1, Census Tract 77.09, Fulton County, Georgia,0,0,0,0,0,0,0,0
-1,131210077091013.000000000000000,Block 1013, Block Group 1, Census Tract 77.09, Fulton County, Georgia,0,0,0,0,0,0,0,0
-1,131210077091015.000000000000000,Block 1015, Block Group 1, Census Tract 77.09, Fulton County, Georgia,0,0,0,0,0,0,0,0
-1,131210077091016.000000000000000,Block 1016, Block Group 1, Census Tract 77.09, Fulton County, Georgia,0,0,0,0,0,0,0,0
-1,131210077091017.000000000000000,Block 1017, Block Group 1, Census Tract 77.09, Fulton County, Georgia,0,0,0,0,0,0,0,0
-1,131210077093006.000000000000000,Block 3006, Block Group 3, Census Tract 77.09, Fulton County, Georgia,0,0,0,0,0,0,0,0
-1,131210077093007.000000000000000,Block 3007, Block Group 3, Census Tract 77.09, Fulton County, Georgia,0,0,0,0,0,0,0,0
-1,131210077101001.000000000000000,Block 1001, Block Group 1, Census Tract 77.10, Fulton County, Georgia,0,0,0,0,0,0,0,0
-1,131210077101002.000000000000000,Block 1002, Block Group 1, Census Tract 77.10, Fulton County, Georgia,0,0,0,0,0,0,0,0
-1,131210077102000.000000000000000,Block 2000, Block Group 2, Census Tract 77.10, Fulton County, Georgia,0,0,0,0,0,0,0,0
-1,131210077102004.000000000000000,Block 2004, Block Group 2, Census Tract 77.10, Fulton County, Georgia,0,0,0,0,0,0,0,0
-1,131210077102005.000000000000000,Block 2005, Block Group 2, Census Tract 77.10, Fulton County, Georgia,0,0,0,0,0,0,0,0
-1,131210077102006.000000000000000,Block 2006, Block Group 2, Census Tract 77.10, Fulton County, Georgia,0,0,0,0,0,0,0,0
-1,131210077102007.000000000000000,Block 2007, Block Group 2, Census Tract 77.10, Fulton County, Georgia,0,0,0,0,0,0,0,0
-1,131210077102008.000000000000000,Block 2008, Block Group 2, Census Tract 77.10, Fulton County, Georgia,0,0,0,0,0,0,0,0
-1,131210077103007.000000000000000,Block 3007, Block Group 3, Census Tract 77.10, Fulton County, Georgia,0,0,0,0,0,0,0,0
-1,131210077103009.000000000000000,Block 3009, Block Group 3, Census Tract 77.10, Fulton County, Georgia,0,0,0,0,0,0,0,0
-1,131210077103010.000000000000000,Block 3010, Block Group 3, Census Tract 77.10, Fulton County, Georgia,0,0,0,0,0,0,0,0
-1,131210077111001.000000000000000,Block 1001, Block Group 1, Census Tract 77.11, Fulton County, Georgia,0,0,0,0,0,0,0,0
-1,131210077112000.000000000000000,Block 2000, Block Group 2, Census Tract 77.11, Fulton County, Georgia,0,0,0,0,0,0,0,0
-1,131210077112005.000000000000000,Block 2005, Block Group 2, Census Tract 77.11, Fulton County, Georgia,0,0,0,0,0,0,0,0
-1,131210078051000.000000000000000,Block 1000, Block Group 1, Census Tract 78.05, Fulton County, Georgia,0,0,0,0,0,0,0,0
-1,131210078051001.000000000000000,Block 1001, Block Group 1, Census Tract 78.05, Fulton County, Georgia,0,0,0,0,0,0,0,0
-1,131210078051002.000000000000000,Block 1002, Block Group 1, Census Tract 78.05, Fulton County, Georgia,0,0,0,0,0,0,0,0
-1,131210078051003.000000000000000,Block 1003, Block Group 1, Census Tract 78.05, Fulton County, Georgia,0,0,0,0,0,0,0,0
-1,131210078051004.000000000000000,Block 1004, Block Group 1, Census Tract 78.05, Fulton County, Georgia,0,0,0,0,0,0,0,0
-1,131210078051005.000000000000000,Block 1005, Block Group 1, Census Tract 78.05, Fulton County, Georgia,0,0,0,0,0,0,0,0
-1,131210078051006.000000000000000,Block 1006, Block Group 1, Census Tract 78.05, Fulton County, Georgia,0,0,0,0,0,0,0,0
-1,131210078051007.000000000000000,Block 1007, Block Group 1, Census Tract 78.05, Fulton County, Georgia,0,0,0,0,0,0,0,0
-1,131210078051008.000000000000000,Block 1008, Block Group 1, Census Tract 78.05, Fulton County, Georgia,0,0,0,0,0,0,0,0
-1,131210078051009.000000000000000,Block 1009, Block Group 1, Census Tract 78.05, Fulton County, Georgia,0,0,0,0,0,0,0,0
-1,131210078051010.000000000000000,Block 1010, Block Group 1, Census Tract 78.05, Fulton County, Georgia,0,0,0,0,0,0,0,0
-1,131210078051011.000000000000000,Block 1011, Block Group 1, Census Tract 78.05, Fulton County, Georgia,0,0,0,0,0,0,0,0
-1,131210078051012.000000000000000,Block 1012, Block Group 1, Census Tract 78.05, Fulton County, Georgia,0,0,0,0,0,0,0,0
-1,131210078051013.000000000000000,Block 1013, Block Group 1, Census Tract 78.05, Fulton County, Georgia,0,0,0,0,0,0,0,0
-1,131210078051014.000000000000000,Block 1014, Block Group 1, Census Tract 78.05, Fulton County, Georgia,0,0,0,0,0,0,0,0
-1,131210078051015.000000000000000,Block 1015, Block Group 1, Census Tract 78.05, Fulton County, Georgia,0,0,0,0,0,0,0,0
-1,131210078051016.000000000000000,Block 1016, Block Group 1, Census Tract 78.05, Fulton County, Georgia,0,0,0,0,0,0,0,0
-1,131210078051017.000000000000000,Block 1017, Block Group 1, Census Tract 78.05, Fulton County, Georgia,0,0,0,0,0,0,0,0
-1,131210078051019.000000000000000,Block 1019, Block Group 1, Census Tract 78.05, Fulton County, Georgia,0,0,0,0,0,0,0,0
-1,131210078051020.000000000000000,Block 1020, Block Group 1, Census Tract 78.05, Fulton County, Georgia,0,0,0,0,0,0,0,0
-1,131210078051021.000000000000000,Block 1021, Block Group 1, Census Tract 78.05, Fulton County, Georgia,0,0,0,0,0,0,0,0
-1,131210078051024.000000000000000,Block 1024, Block Group 1, Census Tract 78.05, Fulton County, Georgia,0,0,0,0,0,0,0,0
-1,131210078051032.000000000000000,Block 1032, Block Group 1, Census Tract 78.05, Fulton County, Georgia,0,0,0,0,0,0,0,0
-1,131210078051036.000000000000000,Block 1036, Block Group 1, Census Tract 78.05, Fulton County, Georgia,0,0,0,0,0,0,0,0
-1,131210078051039.000000000000000,Block 1039, Block Group 1, Census Tract 78.05, Fulton County, Georgia,0,0,0,0,0,0,0,0
-1,131210078051040.000000000000000,Block 1040, Block Group 1, Census Tract 78.05, Fulton County, Georgia,0,0,0,0,0,0,0,0
-1,131210078051041.000000000000000,Block 1041, Block Group 1, Census Tract 78.05, Fulton County, Georgia,0,0,0,0,0,0,0,0
-1,131210078052002.000000000000000,Block 2002, Block Group 2, Census Tract 78.05, Fulton County, Georgia,0,0,0,0,0,0,0,0
-1,131210078052004.000000000000000,Block 2004, Block Group 2, Census Tract 78.05, Fulton County, Georgia,0,0,0,0,0,0,0,0
-1,131210078052010.000000000000000,Block 2010, Block Group 2, Census Tract 78.05, Fulton County, Georgia,0,0,0,0,0,0,0,0
-1,131210078053001.000000000000000,Block 3001, Block Group 3, Census Tract 78.05, Fulton County, Georgia,0,0,0,0,0,0,0,0
-1,131210078053002.000000000000000,Block 3002, Block Group 3, Census Tract 78.05, Fulton County, Georgia,0,0,0,0,0,0,0,0
-1,131210078053006.000000000000000,Block 3006, Block Group 3, Census Tract 78.05, Fulton County, Georgia,0,0,0,0,0,0,0,0
-1,131210078053009.000000000000000,Block 3009, Block Group 3, Census Tract 78.05, Fulton County, Georgia,0,0,0,0,0,0,0,0
-1,131210078053010.000000000000000,Block 3010, Block Group 3, Census Tract 78.05, Fulton County, Georgia,0,0,0,0,0,0,0,0
-1,131210078053011.000000000000000,Block 3011, Block Group 3, Census Tract 78.05, Fulton County, Georgia,0,0,0,0,0,0,0,0
-1,131210078053012.000000000000000,Block 3012, Block Group 3, Census Tract 78.05, Fulton County, Georgia,0,0,0,0,0,0,0,0
-1,131210078053013.000000000000000,Block 3013, Block Group 3, Census Tract 78.05, Fulton County, Georgia,0,0,0,0,0,0,0,0
-1,131210078053014.000000000000000,Block 3014, Block Group 3, Census Tract 78.05, Fulton County, Georgia,0,0,0,0,0,0,0,0
-1,131210078053015.000000000000000,Block 3015, Block Group 3, Census Tract 78.05, Fulton County, Georgia,0,0,0,0,0,0,0,0
-1,131210078053016.000000000000000,Block 3016, Block Group 3, Census Tract 78.05, Fulton County, Georgia,0,0,0,0,0,0,0,0
-1,131210078053018.000000000000000,Block 3018, Block Group 3, Census Tract 78.05, Fulton County, Georgia,0,0,0,0,0,0,0,0
-1,131210078053021.000000000000000,Block 3021, Block Group 3, Census Tract 78.05, Fulton County, Georgia,0,0,0,0,0,0,0,0
-1,131210078053022.000000000000000,Block 3022, Block Group 3, Census Tract 78.05, Fulton County, Georgia,0,0,0,0,0,0,0,0
-1,131210078053024.000000000000000,Block 3024, Block Group 3, Census Tract 78.05, Fulton County, Georgia,0,0,0,0,0,0,0,0
-1,131210078053025.000000000000000,Block 3025, Block Group 3, Census Tract 78.05, Fulton County, Georgia,0,0,0,0,0,0,0,0
-1,131210078053026.000000000000000,Block 3026, Block Group 3, Census Tract 78.05, Fulton County, Georgia,0,0,0,0,0,0,0,0
-1,131210078053027.000000000000000,Block 3027, Block Group 3, Census Tract 78.05, Fulton County, Georgia,0,0,0,0,0,0,0,0
-1,131210078053028.000000000000000,Block 3028, Block Group 3, Census Tract 78.05, Fulton County, Georgia,0,0,0,0,0,0,0,0
-1,131210078053029.000000000000000,Block 3029, Block Group 3, Census Tract 78.05, Fulton County, Georgia,0,0,0,0,0,0,0,0
-1,131210078053030.000000000000000,Block 3030, Block Group 3, Census Tract 78.05, Fulton County, Georgia,0,0,0,0,0,0,0,0
-1,131210078053031.000000000000000,Block 3031, Block Group 3, Census Tract 78.05, Fulton County, Georgia,0,0,0,0,0,0,0,0
-1,131210078053032.000000000000000,Block 3032, Block Group 3, Census Tract 78.05, Fulton County, Georgia,0,0,0,0,0,0,0,0
-1,131210078053033.000000000000000,Block 3033, Block Group 3, Census Tract 78.05, Fulton County, Georgia,0,0,0,0,0,0,0,0
-1,131210078063001.000000000000000,Block 3001, Block Group 3, Census Tract 78.06, Fulton County, Georgia,0,0,0,0,0,0,0,0
-1,131210078063002.000000000000000,Block 3002, Block Group 3, Census Tract 78.06, Fulton County, Georgia,0,0,0,0,0,0,0,0
-1,131210078063003.000000000000000,Block 3003, Block Group 3, Census Tract 78.06, Fulton County, Georgia,0,0,0,0,0,0,0,0
-1,131210078063004.000000000000000,Block 3004, Block Group 3, Census Tract 78.06, Fulton County, Georgia,0,0,0,0,0,0,0,0
-1,131210078063005.000000000000000,Block 3005, Block Group 3, Census Tract 78.06, Fulton County, Georgia,0,0,0,0,0,0,0,0
-1,131210078064007.000000000000000,Block 4007, Block Group 4, Census Tract 78.06, Fulton County, Georgia,0,0,0,0,0,0,0,0
-1,131210078071001.000000000000000,Block 1001, Block Group 1, Census Tract 78.07, Fulton County, Georgia,0,0,0,0,0,0,0,0
-1,131210078071002.000000000000000,Block 1002, Block Group 1, Census Tract 78.07, Fulton County, Georgia,0,0,0,0,0,0,0,0
-1,131210078071003.000000000000000,Block 1003, Block Group 1, Census Tract 78.07, Fulton County, Georgia,0,0,0,0,0,0,0,0
-1,131210078071006.000000000000000,Block 1006, Block Group 1, Census Tract 78.07, Fulton County, Georgia,0,0,0,0,0,0,0,0
-1,131210078073008.000000000000000,Block 3008, Block Group 3, Census Tract 78.07, Fulton County, Georgia,0,0,0,0,0,0,0,0
-1,131210078073009.000000000000000,Block 3009, Block Group 3, Census Tract 78.07, Fulton County, Georgia,0,0,0,0,0,0,0,0
-1,131210078081001.000000000000000,Block 1001, Block Group 1, Census Tract 78.08, Fulton County, Georgia,0,0,0,0,0,0,0,0
-1,131210078081002.000000000000000,Block 1002, Block Group 1, Census Tract 78.08, Fulton County, Georgia,0,0,0,0,0,0,0,0
-1,131210078081005.000000000000000,Block 1005, Block Group 1, Census Tract 78.08, Fulton County, Georgia,0,0,0,0,0,0,0,0
-1,131210078082002.000000000000000,Block 2002, Block Group 2, Census Tract 78.08, Fulton County, Georgia,0,0,0,0,0,0,0,0
-1,131210078082003.000000000000000,Block 2003, Block Group 2, Census Tract 78.08, Fulton County, Georgia,0,0,0,0,0,0,0,0
-1,131210078082004.000000000000000,Block 2004, Block Group 2, Census Tract 78.08, Fulton County, Georgia,0,0,0,0,0,0,0,0
-1,131210078101001.000000000000000,Block 1001, Block Group 1, Census Tract 78.10, Fulton County, Georgia,0,0,0,0,0,0,0,0
-1,131210078101010.000000000000000,Block 1010, Block Group 1, Census Tract 78.10, Fulton County, Georgia,0,0,0,0,0,0,0,0
-1,131210078103001.000000000000000,Block 3001, Block Group 3, Census Tract 78.10, Fulton County, Georgia,0,0,0,0,0,0,0,0
-1,131210078103002.000000000000000,Block 3002, Block Group 3, Census Tract 78.10, Fulton County, Georgia,0,0,0,0,0,0,0,0
-1,131210079003009.000000000000000,Block 3009, Block Group 3, Census Tract 79, Fulton County, Georgia,0,0,0,0,0,0,0,0
-1,131210079003010.000000000000000,Block 3010, Block Group 3, Census Tract 79, Fulton County, Georgia,0,0,0,0,0,0,0,0
-1,131210079003011.000000000000000,Block 3011, Block Group 3, Census Tract 79, Fulton County, Georgia,0,0,0,0,0,0,0,0
-1,131210079003012.000000000000000,Block 3012, Block Group 3, Census Tract 79, Fulton County, Georgia,0,0,0,0,0,0,0,0
-1,131210079003013.000000000000000,Block 3013, Block Group 3, Census Tract 79, Fulton County, Georgia,0,0,0,0,0,0,0,0
-1,131210079003016.000000000000000,Block 3016, Block Group 3, Census Tract 79, Fulton County, Georgia,0,0,0,0,0,0,0,0
-1,131210079003019.000000000000000,Block 3019, Block Group 3, Census Tract 79, Fulton County, Georgia,0,0,0,0,0,0,0,0
-1,131210079003023.000000000000000,Block 3023, Block Group 3, Census Tract 79, Fulton County, Georgia,0,0,0,0,0,0,0,0
-1,131210079004000.000000000000000,Block 4000, Block Group 4, Census Tract 79, Fulton County, Georgia,0,0,0,0,0,0,0,0
-1,131210079004003.000000000000000,Block 4003, Block Group 4, Census Tract 79, Fulton County, Georgia,0,0,0,0,0,0,0,0
-1,131210079004006.000000000000000,Block 4006, Block Group 4, Census Tract 79, Fulton County, Georgia,0,0,0,0,0,0,0,0
-1,131210079004008.000000000000000,Block 4008, Block Group 4, Census Tract 79, Fulton County, Georgia,0,0,0,0,0,0,0,0
-1,131210079004011.000000000000000,Block 4011, Block Group 4, Census Tract 79, Fulton County, Georgia,0,0,0,0,0,0,0,0
-1,131210079004012.000000000000000,Block 4012, Block Group 4, Census Tract 79, Fulton County, Georgia,0,0,0,0,0,0,0,0
-1,131210079004021.000000000000000,Block 4021, Block Group 4, Census Tract 79, Fulton County, Georgia,0,0,0,0,0,0,0,0
-1,131210079004022.000000000000000,Block 4022, Block Group 4, Census Tract 79, Fulton County, Georgia,0,0,0,0,0,0,0,0
-1,131210079004023.000000000000000,Block 4023, Block Group 4, Census Tract 79, Fulton County, Georgia,0,0,0,0,0,0,0,0
-1,131210079004024.000000000000000,Block 4024, Block Group 4, Census Tract 79, Fulton County, Georgia,0,0,0,0,0,0,0,0
-1,131210079004025.000000000000000,Block 4025, Block Group 4, Census Tract 79, Fulton County, Georgia,0,0,0,0,0,0,0,0
-1,131210079004026.000000000000000,Block 4026, Block Group 4, Census Tract 79, Fulton County, Georgia,0,0,0,0,0,0,0,0
-1,131210080004005.000000000000000,Block 4005, Block Group 4, Census Tract 80, Fulton County, Georgia,0,0,0,0,0,0,0,0
-1,131210080004007.000000000000000,Block 4007, Block Group 4, Census Tract 80, Fulton County, Georgia,0,0,0,0,0,0,0,0
-1,131210080005013.000000000000000,Block 5013, Block Group 5, Census Tract 80, Fulton County, Georgia,0,0,0,0,0,0,0,0
-1,131210081032000.000000000000000,Block 2000, Block Group 2, Census Tract 81.03, Fulton County, Georgia,0,0,0,0,0,0,0,0
-1,131210081033001.000000000000000,Block 3001, Block Group 3, Census Tract 81.03, Fulton County, Georgia,0,0,0,0,0,0,0,0
-1,131210081033002.000000000000000,Block 3002, Block Group 3, Census Tract 81.03, Fulton County, Georgia,0,0,0,0,0,0,0,0
-1,131210081033003.000000000000000,Block 3003, Block Group 3, Census Tract 81.03, Fulton County, Georgia,0,0,0,0,0,0,0,0
-1,131210081033004.000000000000000,Block 3004, Block Group 3, Census Tract 81.03, Fulton County, Georgia,0,0,0,0,0,0,0,0
-1,131210081033010.000000000000000,Block 3010, Block Group 3, Census Tract 81.03, Fulton County, Georgia,0,0,0,0,0,0,0,0
-1,131210081041001.000000000000000,Block 1001, Block Group 1, Census Tract 81.04, Fulton County, Georgia,0,0,0,0,0,0,0,0
-1,131210081041002.000000000000000,Block 1002, Block Group 1, Census Tract 81.04, Fulton County, Georgia,0,0,0,0,0,0,0,0
-1,131210081041004.000000000000000,Block 1004, Block Group 1, Census Tract 81.04, Fulton County, Georgia,0,0,0,0,0,0,0,0
-1,131210081041009.000000000000000,Block 1009, Block Group 1, Census Tract 81.04, Fulton County, Georgia,0,0,0,0,0,0,0,0
-1,131210081041015.000000000000000,Block 1015, Block Group 1, Census Tract 81.04, Fulton County, Georgia,0,0,0,0,0,0,0,0
-1,131210081042004.000000000000000,Block 2004, Block Group 2, Census Tract 81.04, Fulton County, Georgia,0,0,0,0,0,0,0,0
-1,131210082021002.000000000000000,Block 1002, Block Group 1, Census Tract 82.02, Fulton County, Georgia,0,0,0,0,0,0,0,0
-1,131210082023002.000000000000000,Block 3002, Block Group 3, Census Tract 82.02, Fulton County, Georgia,0,0,0,0,0,0,0,0
-1,131210082023004.000000000000000,Block 3004, Block Group 3, Census Tract 82.02, Fulton County, Georgia,0,0,0,0,0,0,0,0
-1,131210082024000.000000000000000,Block 4000, Block Group 4, Census Tract 82.02, Fulton County, Georgia,0,0,0,0,0,0,0,0
-1,131210082024001.000000000000000,Block 4001, Block Group 4, Census Tract 82.02, Fulton County, Georgia,0,0,0,0,0,0,0,0
-1,131210082024002.000000000000000,Block 4002, Block Group 4, Census Tract 82.02, Fulton County, Georgia,0,0,0,0,0,0,0,0
-1,131210082024003.000000000000000,Block 4003, Block Group 4, Census Tract 82.02, Fulton County, Georgia,0,0,0,0,0,0,0,0
-1,131210082024004.000000000000000,Block 4004, Block Group 4, Census Tract 82.02, Fulton County, Georgia,0,0,0,0,0,0,0,0
-1,131210082024005.000000000000000,Block 4005, Block Group 4, Census Tract 82.02, Fulton County, Georgia,0,0,0,0,0,0,0,0
-1,131210082024006.000000000000000,Block 4006, Block Group 4, Census Tract 82.02, Fulton County, Georgia,0,0,0,0,0,0,0,0
-1,131210082024007.000000000000000,Block 4007, Block Group 4, Census Tract 82.02, Fulton County, Georgia,0,0,0,0,0,0,0,0
-1,131210082024008.000000000000000,Block 4008, Block Group 4, Census Tract 82.02, Fulton County, Georgia,0,0,0,0,0,0,0,0
-1,131210082024009.000000000000000,Block 4009, Block Group 4, Census Tract 82.02, Fulton County, Georgia,0,0,0,0,0,0,0,0
-1,131210082024010.000000000000000,Block 4010, Block Group 4, Census Tract 82.02, Fulton County, Georgia,0,0,0,0,0,0,0,0
-1,131210082024011.000000000000000,Block 4011, Block Group 4, Census Tract 82.02, Fulton County, Georgia,0,0,0,0,0,0,0,0
-1,131210082042016.000000000000000,Block 2016, Block Group 2, Census Tract 82.04, Fulton County, Georgia,0,0,0,0,0,0,0,0
-1,131210082043008.000000000000000,Block 3008, Block Group 3, Census Tract 82.04, Fulton County, Georgia,0,0,0,0,0,0,0,0
-1,131210082043009.000000000000000,Block 3009, Block Group 3, Census Tract 82.04, Fulton County, Georgia,0,0,0,0,0,0,0,0
-1,131210082043017.000000000000000,Block 3017, Block Group 3, Census Tract 82.04, Fulton County, Georgia,0,0,0,0,0,0,0,0
-1,131210083011011.000000000000000,Block 1011, Block Group 1, Census Tract 83.01, Fulton County, Georgia,0,0,0,0,0,0,0,0
-1,131210083011020.000000000000000,Block 1020, Block Group 1, Census Tract 83.01, Fulton County, Georgia,0,0,0,0,0,0,0,0
-1,131210083011021.000000000000000,Block 1021, Block Group 1, Census Tract 83.01, Fulton County, Georgia,0,0,0,0,0,0,0,0
-1,131210083012005.000000000000000,Block 2005, Block Group 2, Census Tract 83.01, Fulton County, Georgia,0,0,0,0,0,0,0,0
-1,131210083021007.000000000000000,Block 1007, Block Group 1, Census Tract 83.02, Fulton County, Georgia,0,0,0,0,0,0,0,0
-1,131210083022005.000000000000000,Block 2005, Block Group 2, Census Tract 83.02, Fulton County, Georgia,0,0,0,0,0,0,0,0
-1,131210084004000.000000000000000,Block 4000, Block Group 4, Census Tract 84, Fulton County, Georgia,0,0,0,0,0,0,0,0
-1,131210084004001.000000000000000,Block 4001, Block Group 4, Census Tract 84, Fulton County, Georgia,0,0,0,0,0,0,0,0
-1,131210085001000.000000000000000,Block 1000, Block Group 1, Census Tract 85, Fulton County, Georgia,0,0,0,0,0,0,0,0
-1,131210085001001.000000000000000,Block 1001, Block Group 1, Census Tract 85, Fulton County, Georgia,0,0,0,0,0,0,0,0
-1,131210085001003.000000000000000,Block 1003, Block Group 1, Census Tract 85, Fulton County, Georgia,0,0,0,0,0,0,0,0
-1,131210085001006.000000000000000,Block 1006, Block Group 1, Census Tract 85, Fulton County, Georgia,0,0,0,0,0,0,0,0
-1,131210085001007.000000000000000,Block 1007, Block Group 1, Census Tract 85, Fulton County, Georgia,0,0,0,0,0,0,0,0
-1,131210085001008.000000000000000,Block 1008, Block Group 1, Census Tract 85, Fulton County, Georgia,0,0,0,0,0,0,0,0
-1,131210085001009.000000000000000,Block 1009, Block Group 1, Census Tract 85, Fulton County, Georgia,0,0,0,0,0,0,0,0
-1,131210085001015.000000000000000,Block 1015, Block Group 1, Census Tract 85, Fulton County, Georgia,0,0,0,0,0,0,0,0
-1,131210085002003.000000000000000,Block 2003, Block Group 2, Census Tract 85, Fulton County, Georgia,0,0,0,0,0,0,0,0
-1,131210085003003.000000000000000,Block 3003, Block Group 3, Census Tract 85, Fulton County, Georgia,0,0,0,0,0,0,0,0
-1,131210085003006.000000000000000,Block 3006, Block Group 3, Census Tract 85, Fulton County, Georgia,0,0,0,0,0,0,0,0
-1,131210085003008.000000000000000,Block 3008, Block Group 3, Census Tract 85, Fulton County, Georgia,0,0,0,0,0,0,0,0
-1,131210085003021.000000000000000,Block 3021, Block Group 3, Census Tract 85, Fulton County, Georgia,0,0,0,0,0,0,0,0
-1,131210085003023.000000000000000,Block 3023, Block Group 3, Census Tract 85, Fulton County, Georgia,0,0,0,0,0,0,0,0
-1,131210085003025.000000000000000,Block 3025, Block Group 3, Census Tract 85, Fulton County, Georgia,0,0,0,0,0,0,0,0
-1,131210085003029.000000000000000,Block 3029, Block Group 3, Census Tract 85, Fulton County, Georgia,0,0,0,0,0,0,0,0
-1,131210086011002.000000000000000,Block 1002, Block Group 1, Census Tract 86.01, Fulton County, Georgia,0,0,0,0,0,0,0,0
-1,131210086011003.000000000000000,Block 1003, Block Group 1, Census Tract 86.01, Fulton County, Georgia,0,0,0,0,0,0,0,0
-1,131210086011010.000000000000000,Block 1010, Block Group 1, Census Tract 86.01, Fulton County, Georgia,0,0,0,0,0,0,0,0
-1,131210086012005.000000000000000,Block 2005, Block Group 2, Census Tract 86.01, Fulton County, Georgia,0,0,0,0,0,0,0,0
-1,131210086012014.000000000000000,Block 2014, Block Group 2, Census Tract 86.01, Fulton County, Georgia,0,0,0,0,0,0,0,0
-1,131210086012016.000000000000000,Block 2016, Block Group 2, Census Tract 86.01, Fulton County, Georgia,0,0,0,0,0,0,0,0
-1,131210086012017.000000000000000,Block 2017, Block Group 2, Census Tract 86.01, Fulton County, Georgia,0,0,0,0,0,0,0,0
-1,131210086012020.000000000000000,Block 2020, Block Group 2, Census Tract 86.01, Fulton County, Georgia,0,0,0,0,0,0,0,0
-1,131210086021001.000000000000000,Block 1001, Block Group 1, Census Tract 86.02, Fulton County, Georgia,0,0,0,0,0,0,0,0
-1,131210086021002.000000000000000,Block 1002, Block Group 1, Census Tract 86.02, Fulton County, Georgia,0,0,0,0,0,0,0,0
-1,131210086021003.000000000000000,Block 1003, Block Group 1, Census Tract 86.02, Fulton County, Georgia,0,0,0,0,0,0,0,0
-1,131210086021004.000000000000000,Block 1004, Block Group 1, Census Tract 86.02, Fulton County, Georgia,0,0,0,0,0,0,0,0
-1,131210086021005.000000000000000,Block 1005, Block Group 1, Census Tract 86.02, Fulton County, Georgia,0,0,0,0,0,0,0,0
-1,131210086022000.000000000000000,Block 2000, Block Group 2, Census Tract 86.02, Fulton County, Georgia,0,0,0,0,0,0,0,0
-1,131210086022001.000000000000000,Block 2001, Block Group 2, Census Tract 86.02, Fulton County, Georgia,0,0,0,0,0,0,0,0
-1,131210086022003.000000000000000,Block 2003, Block Group 2, Census Tract 86.02, Fulton County, Georgia,0,0,0,0,0,0,0,0
-1,131210086022004.000000000000000,Block 2004, Block Group 2, Census Tract 86.02, Fulton County, Georgia,0,0,0,0,0,0,0,0
-1,131210086022005.000000000000000,Block 2005, Block Group 2, Census Tract 86.02, Fulton County, Georgia,0,0,0,0,0,0,0,0
-1,131210086022006.000000000000000,Block 2006, Block Group 2, Census Tract 86.02, Fulton County, Georgia,0,0,0,0,0,0,0,0
-1,131210086022010.000000000000000,Block 2010, Block Group 2, Census Tract 86.02, Fulton County, Georgia,0,0,0,0,0,0,0,0
-1,131210086022014.000000000000000,Block 2014, Block Group 2, Census Tract 86.02, Fulton County, Georgia,0,0,0,0,0,0,0,0
-1,131210086022015.000000000000000,Block 2015, Block Group 2, Census Tract 86.02, Fulton County, Georgia,0,0,0,0,0,0,0,0
-1,131210087011004.000000000000000,Block 1004, Block Group 1, Census Tract 87.01, Fulton County, Georgia,0,0,0,0,0,0,0,0
-1,131210087011006.000000000000000,Block 1006, Block Group 1, Census Tract 87.01, Fulton County, Georgia,0,0,0,0,0,0,0,0
-1,131210087011007.000000000000000,Block 1007, Block Group 1, Census Tract 87.01, Fulton County, Georgia,0,0,0,0,0,0,0,0
-1,131210087011008.000000000000000,Block 1008, Block Group 1, Census Tract 87.01, Fulton County, Georgia,0,0,0,0,0,0,0,0
-1,131210087011009.000000000000000,Block 1009, Block Group 1, Census Tract 87.01, Fulton County, Georgia,0,0,0,0,0,0,0,0
-1,131210087011010.000000000000000,Block 1010, Block Group 1, Census Tract 87.01, Fulton County, Georgia,0,0,0,0,0,0,0,0
-1,131210087013001.000000000000000,Block 3001, Block Group 3, Census Tract 87.01, Fulton County, Georgia,0,0,0,0,0,0,0,0
-1,131210087013002.000000000000000,Block 3002, Block Group 3, Census Tract 87.01, Fulton County, Georgia,0,0,0,0,0,0,0,0
-1,131210087013009.000000000000000,Block 3009, Block Group 3, Census Tract 87.01, Fulton County, Georgia,0,0,0,0,0,0,0,0
-1,131210087021000.000000000000000,Block 1000, Block Group 1, Census Tract 87.02, Fulton County, Georgia,0,0,0,0,0,0,0,0
-1,131210087021001.000000000000000,Block 1001, Block Group 1, Census Tract 87.02, Fulton County, Georgia,0,0,0,0,0,0,0,0
-1,131210087021010.000000000000000,Block 1010, Block Group 1, Census Tract 87.02, Fulton County, Georgia,0,0,0,0,0,0,0,0
-1,131210087022003.000000000000000,Block 2003, Block Group 2, Census Tract 87.02, Fulton County, Georgia,0,0,0,0,0,0,0,0
-1,131210087022010.000000000000000,Block 2010, Block Group 2, Census Tract 87.02, Fulton County, Georgia,0,0,0,0,0,0,0,0
-1,131210087022011.000000000000000,Block 2011, Block Group 2, Census Tract 87.02, Fulton County, Georgia,0,0,0,0,0,0,0,0
-1,131210087022013.000000000000000,Block 2013, Block Group 2, Census Tract 87.02, Fulton County, Georgia,0,0,0,0,0,0,0,0
-1,131210087022014.000000000000000,Block 2014, Block Group 2, Census Tract 87.02, Fulton County, Georgia,0,0,0,0,0,0,0,0
-1,131210087022019.000000000000000,Block 2019, Block Group 2, Census Tract 87.02, Fulton County, Georgia,0,0,0,0,0,0,0,0
-1,131210087022020.000000000000000,Block 2020, Block Group 2, Census Tract 87.02, Fulton County, Georgia,0,0,0,0,0,0,0,0
-1,131210087022021.000000000000000,Block 2021, Block Group 2, Census Tract 87.02, Fulton County, Georgia,0,0,0,0,0,0,0,0
-1,131210088011000.000000000000000,Block 1000, Block Group 1, Census Tract 88.01, Fulton County, Georgia,0,0,0,0,0,0,0,0
-1,131210088011009.000000000000000,Block 1009, Block Group 1, Census Tract 88.01, Fulton County, Georgia,0,0,0,0,0,0,0,0
-1,131210088011010.000000000000000,Block 1010, Block Group 1, Census Tract 88.01, Fulton County, Georgia,0,0,0,0,0,0,0,0
-1,131210088011011.000000000000000,Block 1011, Block Group 1, Census Tract 88.01, Fulton County, Georgia,0,0,0,0,0,0,0,0
-1,131210088011012.000000000000000,Block 1012, Block Group 1, Census Tract 88.01, Fulton County, Georgia,0,0,0,0,0,0,0,0
-1,131210088011014.000000000000000,Block 1014, Block Group 1, Census Tract 88.01, Fulton County, Georgia,0,0,0,0,0,0,0,0
-1,131210088011026.000000000000000,Block 1026, Block Group 1, Census Tract 88.01, Fulton County, Georgia,0,0,0,0,0,0,0,0
-1,131210088011034.000000000000000,Block 1034, Block Group 1, Census Tract 88.01, Fulton County, Georgia,0,0,0,0,0,0,0,0
-1,131210088021000.000000000000000,Block 1000, Block Group 1, Census Tract 88.02, Fulton County, Georgia,0,0,0,0,0,0,0,0
-1,131210088021002.000000000000000,Block 1002, Block Group 1, Census Tract 88.02, Fulton County, Georgia,0,0,0,0,0,0,0,0
-1,131210088021006.000000000000000,Block 1006, Block Group 1, Census Tract 88.02, Fulton County, Georgia,0,0,0,0,0,0,0,0
-1,131210088021008.000000000000000,Block 1008, Block Group 1, Census Tract 88.02, Fulton County, Georgia,0,0,0,0,0,0,0,0
-1,131210088021013.000000000000000,Block 1013, Block Group 1, Census Tract 88.02, Fulton County, Georgia,0,0,0,0,0,0,0,0
-1,131210088021026.000000000000000,Block 1026, Block Group 1, Census Tract 88.02, Fulton County, Georgia,0,0,0,0,0,0,0,0
-1,131210088021034.000000000000000,Block 1034, Block Group 1, Census Tract 88.02, Fulton County, Georgia,0,0,0,0,0,0,0,0
-1,131210088022000.000000000000000,Block 2000, Block Group 2, Census Tract 88.02, Fulton County, Georgia,0,0,0,0,0,0,0,0
-1,131210088022011.000000000000000,Block 2011, Block Group 2, Census Tract 88.02, Fulton County, Georgia,0,0,0,0,0,0,0,0
-1,131210088022021.000000000000000,Block 2021, Block Group 2, Census Tract 88.02, Fulton County, Georgia,0,0,0,0,0,0,0,0
-1,131210088022022.000000000000000,Block 2022, Block Group 2, Census Tract 88.02, Fulton County, Georgia,0,0,0,0,0,0,0,0
-1,131210088022023.000000000000000,Block 2023, Block Group 2, Census Tract 88.02, Fulton County, Georgia,0,0,0,0,0,0,0,0
-1,131210088022024.000000000000000,Block 2024, Block Group 2, Census Tract 88.02, Fulton County, Georgia,0,0,0,0,0,0,0,0
-1,131210088022025.000000000000000,Block 2025, Block Group 2, Census Tract 88.02, Fulton County, Georgia,0,0,0,0,0,0,0,0
-1,131210088022026.000000000000000,Block 2026, Block Group 2, Census Tract 88.02, Fulton County, Georgia,0,0,0,0,0,0,0,0
-1,131210088022027.000000000000000,Block 2027, Block Group 2, Census Tract 88.02, Fulton County, Georgia,0,0,0,0,0,0,0,0
-1,131210088022028.000000000000000,Block 2028, Block Group 2, Census Tract 88.02, Fulton County, Georgia,0,0,0,0,0,0,0,0
-1,131210089031000.000000000000000,Block 1000, Block Group 1, Census Tract 89.03, Fulton County, Georgia,0,0,0,0,0,0,0,0
-1,131210089031001.000000000000000,Block 1001, Block Group 1, Census Tract 89.03, Fulton County, Georgia,0,0,0,0,0,0,0,0
-1,131210089031002.000000000000000,Block 1002, Block Group 1, Census Tract 89.03, Fulton County, Georgia,0,0,0,0,0,0,0,0
-1,131210089031003.000000000000000,Block 1003, Block Group 1, Census Tract 89.03, Fulton County, Georgia,0,0,0,0,0,0,0,0
-1,131210089031004.000000000000000,Block 1004, Block Group 1, Census Tract 89.03, Fulton County, Georgia,0,0,0,0,0,0,0,0
-1,131210089031005.000000000000000,Block 1005, Block Group 1, Census Tract 89.03, Fulton County, Georgia,0,0,0,0,0,0,0,0
-1,131210089031006.000000000000000,Block 1006, Block Group 1, Census Tract 89.03, Fulton County, Georgia,0,0,0,0,0,0,0,0
-1,131210089031011.000000000000000,Block 1011, Block Group 1, Census Tract 89.03, Fulton County, Georgia,0,0,0,0,0,0,0,0
-1,131210089051000.000000000000000,Block 1000, Block Group 1, Census Tract 89.05, Fulton County, Georgia,0,0,0,0,0,0,0,0
-1,131210089052000.000000000000000,Block 2000, Block Group 2, Census Tract 89.05, Fulton County, Georgia,0,0,0,0,0,0,0,0
-1,131210089052003.000000000000000,Block 2003, Block Group 2, Census Tract 89.05, Fulton County, Georgia,0,0,0,0,0,0,0,0
-1,131210089052004.000000000000000,Block 2004, Block Group 2, Census Tract 89.05, Fulton County, Georgia,0,0,0,0,0,0,0,0
-1,131210089052005.000000000000000,Block 2005, Block Group 2, Census Tract 89.05, Fulton County, Georgia,0,0,0,0,0,0,0,0
-1,131210089052008.000000000000000,Block 2008, Block Group 2, Census Tract 89.05, Fulton County, Georgia,0,0,0,0,0,0,0,0
-1,131210089052016.000000000000000,Block 2016, Block Group 2, Census Tract 89.05, Fulton County, Georgia,0,0,0,0,0,0,0,0
-1,131210089052018.000000000000000,Block 2018, Block Group 2, Census Tract 89.05, Fulton County, Georgia,0,0,0,0,0,0,0,0
-1,131210089052022.000000000000000,Block 2022, Block Group 2, Census Tract 89.05, Fulton County, Georgia,0,0,0,0,0,0,0,0
-1,131210089052023.000000000000000,Block 2023, Block Group 2, Census Tract 89.05, Fulton County, Georgia,0,0,0,0,0,0,0,0
-1,131210089053009.000000000000000,Block 3009, Block Group 3, Census Tract 89.05, Fulton County, Georgia,0,0,0,0,0,0,0,0
-1,131210089053013.000000000000000,Block 3013, Block Group 3, Census Tract 89.05, Fulton County, Georgia,0,0,0,0,0,0,0,0
-1,131210089053015.000000000000000,Block 3015, Block Group 3, Census Tract 89.05, Fulton County, Georgia,0,0,0,0,0,0,0,0
-1,131210089053016.000000000000000,Block 3016, Block Group 3, Census Tract 89.05, Fulton County, Georgia,0,0,0,0,0,0,0,0
-1,131210089053017.000000000000000,Block 3017, Block Group 3, Census Tract 89.05, Fulton County, Georgia,0,0,0,0,0,0,0,0
-1,131210089054005.000000000000000,Block 4005, Block Group 4, Census Tract 89.05, Fulton County, Georgia,0,0,0,0,0,0,0,0
-1,131210089054006.000000000000000,Block 4006, Block Group 4, Census Tract 89.05, Fulton County, Georgia,0,0,0,0,0,0,0,0
-1,131210089054008.000000000000000,Block 4008, Block Group 4, Census Tract 89.05, Fulton County, Georgia,0,0,0,0,0,0,0,0
-1,131210089054009.000000000000000,Block 4009, Block Group 4, Census Tract 89.05, Fulton County, Georgia,0,0,0,0,0,0,0,0
-1,131210089054010.000000000000000,Block 4010, Block Group 4, Census Tract 89.05, Fulton County, Georgia,0,0,0,0,0,0,0,0
-1,131210089054011.000000000000000,Block 4011, Block Group 4, Census Tract 89.05, Fulton County, Georgia,0,0,0,0,0,0,0,0
-1,131210089054014.000000000000000,Block 4014, Block Group 4, Census Tract 89.05, Fulton County, Georgia,0,0,0,0,0,0,0,0
-1,131210089054015.000000000000000,Block 4015, Block Group 4, Census Tract 89.05, Fulton County, Georgia,0,0,0,0,0,0,0,0
-1,131210089054017.000000000000000,Block 4017, Block Group 4, Census Tract 89.05, Fulton County, Georgia,0,0,0,0,0,0,0,0
-1,131210089054020.000000000000000,Block 4020, Block Group 4, Census Tract 89.05, Fulton County, Georgia,0,0,0,0,0,0,0,0
-1,131210089054021.000000000000000,Block 4021, Block Group 4, Census Tract 89.05, Fulton County, Georgia,0,0,0,0,0,0,0,0
-1,131210089061000.000000000000000,Block 1000, Block Group 1, Census Tract 89.06, Fulton County, Georgia,0,0,0,0,0,0,0,0
-1,131210089062000.000000000000000,Block 2000, Block Group 2, Census Tract 89.06, Fulton County, Georgia,0,0,0,0,0,0,0,0
-1,131210089062005.000000000000000,Block 2005, Block Group 2, Census Tract 89.06, Fulton County, Georgia,0,0,0,0,0,0,0,0
-1,131210089062006.000000000000000,Block 2006, Block Group 2, Census Tract 89.06, Fulton County, Georgia,0,0,0,0,0,0,0,0
-1,131210089071010.000000000000000,Block 1010, Block Group 1, Census Tract 89.07, Fulton County, Georgia,0,0,0,0,0,0,0,0
-1,131210089072000.000000000000000,Block 2000, Block Group 2, Census Tract 89.07, Fulton County, Georgia,0,0,0,0,0,0,0,0
-1,131210089073000.000000000000000,Block 3000, Block Group 3, Census Tract 89.07, Fulton County, Georgia,0,0,0,0,0,0,0,0
-1,131210089082007.000000000000000,Block 2007, Block Group 2, Census Tract 89.08, Fulton County, Georgia,0,0,0,0,0,0,0,0
-1,131210090011000.000000000000000,Block 1000, Block Group 1, Census Tract 90.01, Fulton County, Georgia,0,0,0,0,0,0,0,0
-1,131210090011009.000000000000000,Block 1009, Block Group 1, Census Tract 90.01, Fulton County, Georgia,0,0,0,0,0,0,0,0
-1,131210090011011.000000000000000,Block 1011, Block Group 1, Census Tract 90.01, Fulton County, Georgia,0,0,0,0,0,0,0,0
-1,131210090021000.000000000000000,Block 1000, Block Group 1, Census Tract 90.02, Fulton County, Georgia,0,0,0,0,0,0,0,0
-1,131210090021001.000000000000000,Block 1001, Block Group 1, Census Tract 90.02, Fulton County, Georgia,0,0,0,0,0,0,0,0
-1,131210090021011.000000000000000,Block 1011, Block Group 1, Census Tract 90.02, Fulton County, Georgia,0,0,0,0,0,0,0,0
-1,131210090021012.000000000000000,Block 1012, Block Group 1, Census Tract 90.02, Fulton County, Georgia,0,0,0,0,0,0,0,0
-1,131210090021013.000000000000000,Block 1013, Block Group 1, Census Tract 90.02, Fulton County, Georgia,0,0,0,0,0,0,0,0
-1,131210090022012.000000000000000,Block 2012, Block Group 2, Census Tract 90.02, Fulton County, Georgia,0,0,0,0,0,0,0,0
-1,131210091031003.000000000000000,Block 1003, Block Group 1, Census Tract 91.03, Fulton County, Georgia,0,0,0,0,0,0,0,0
-1,131210091031008.000000000000000,Block 1008, Block Group 1, Census Tract 91.03, Fulton County, Georgia,0,0,0,0,0,0,0,0
-1,131210091032004.000000000000000,Block 2004, Block Group 2, Census Tract 91.03, Fulton County, Georgia,0,0,0,0,0,0,0,0
-1,131210091033002.000000000000000,Block 3002, Block Group 3, Census Tract 91.03, Fulton County, Georgia,0,0,0,0,0,0,0,0
-1,131210091033004.000000000000000,Block 3004, Block Group 3, Census Tract 91.03, Fulton County, Georgia,0,0,0,0,0,0,0,0
-1,131210091041000.000000000000000,Block 1000, Block Group 1, Census Tract 91.04, Fulton County, Georgia,0,0,0,0,0,0,0,0
-1,131210091042000.000000000000000,Block 2000, Block Group 2, Census Tract 91.04, Fulton County, Georgia,0,0,0,0,0,0,0,0
-1,131210091042004.000000000000000,Block 2004, Block Group 2, Census Tract 91.04, Fulton County, Georgia,0,0,0,0,0,0,0,0
-1,131210091043000.000000000000000,Block 3000, Block Group 3, Census Tract 91.04, Fulton County, Georgia,0,0,0,0,0,0,0,0
-1,131210091043001.000000000000000,Block 3001, Block Group 3, Census Tract 91.04, Fulton County, Georgia,0,0,0,0,0,0,0,0
-1,131210091052000.000000000000000,Block 2000, Block Group 2, Census Tract 91.05, Fulton County, Georgia,0,0,0,0,0,0,0,0
-1,131210091061000.000000000000000,Block 1000, Block Group 1, Census Tract 91.06, Fulton County, Georgia,0,0,0,0,0,0,0,0
-1,131210091061001.000000000000000,Block 1001, Block Group 1, Census Tract 91.06, Fulton County, Georgia,0,0,0,0,0,0,0,0
-1,131210091061002.000000000000000,Block 1002, Block Group 1, Census Tract 91.06, Fulton County, Georgia,0,0,0,0,0,0,0,0
-1,131210091061005.000000000000000,Block 1005, Block Group 1, Census Tract 91.06, Fulton County, Georgia,0,0,0,0,0,0,0,0
-1,131210091061006.000000000000000,Block 1006, Block Group 1, Census Tract 91.06, Fulton County, Georgia,0,0,0,0,0,0,0,0
-1,131210091061007.000000000000000,Block 1007, Block Group 1, Census Tract 91.06, Fulton County, Georgia,0,0,0,0,0,0,0,0
-1,131210091062000.000000000000000,Block 2000, Block Group 2, Census Tract 91.06, Fulton County, Georgia,0,0,0,0,0,0,0,0
-1,131210092011002.000000000000000,Block 1002, Block Group 1, Census Tract 92.01, Fulton County, Georgia,0,0,0,0,0,0,0,0
-1,131210092012000.000000000000000,Block 2000, Block Group 2, Census Tract 92.01, Fulton County, Georgia,0,0,0,0,0,0,0,0
-1,131210092022000.000000000000000,Block 2000, Block Group 2, Census Tract 92.02, Fulton County, Georgia,0,0,0,0,0,0,0,0
-1,131210092022001.000000000000000,Block 2001, Block Group 2, Census Tract 92.02, Fulton County, Georgia,0,0,0,0,0,0,0,0
-1,131210092022002.000000000000000,Block 2002, Block Group 2, Census Tract 92.02, Fulton County, Georgia,0,0,0,0,0,0,0,0
-1,131210092022003.000000000000000,Block 2003, Block Group 2, Census Tract 92.02, Fulton County, Georgia,0,0,0,0,0,0,0,0
-1,131210092022005.000000000000000,Block 2005, Block Group 2, Census Tract 92.02, Fulton County, Georgia,0,0,0,0,0,0,0,0
-1,131210092022006.000000000000000,Block 2006, Block Group 2, Census Tract 92.02, Fulton County, Georgia,0,0,0,0,0,0,0,0
-1,131210092022007.000000000000000,Block 2007, Block Group 2, Census Tract 92.02, Fulton County, Georgia,0,0,0,0,0,0,0,0
-1,131210092022008.000000000000000,Block 2008, Block Group 2, Census Tract 92.02, Fulton County, Georgia,0,0,0,0,0,0,0,0
-1,131210092022009.000000000000000,Block 2009, Block Group 2, Census Tract 92.02, Fulton County, Georgia,0,0,0,0,0,0,0,0
-1,131210092022010.000000000000000,Block 2010, Block Group 2, Census Tract 92.02, Fulton County, Georgia,0,0,0,0,0,0,0,0
-1,131210092022011.000000000000000,Block 2011, Block Group 2, Census Tract 92.02, Fulton County, Georgia,0,0,0,0,0,0,0,0
-1,131210092022012.000000000000000,Block 2012, Block Group 2, Census Tract 92.02, Fulton County, Georgia,0,0,0,0,0,0,0,0
-1,131210092022014.000000000000000,Block 2014, Block Group 2, Census Tract 92.02, Fulton County, Georgia,0,0,0,0,0,0,0,0
-1,131210092022015.000000000000000,Block 2015, Block Group 2, Census Tract 92.02, Fulton County, Georgia,0,0,0,0,0,0,0,0
-1,131210092022016.000000000000000,Block 2016, Block Group 2, Census Tract 92.02, Fulton County, Georgia,0,0,0,0,0,0,0,0
-1,131210092022018.000000000000000,Block 2018, Block Group 2, Census Tract 92.02, Fulton County, Georgia,0,0,0,0,0,0,0,0
-1,131210092022019.000000000000000,Block 2019, Block Group 2, Census Tract 92.02, Fulton County, Georgia,0,0,0,0,0,0,0,0
-1,131210092031003.000000000000000,Block 1003, Block Group 1, Census Tract 92.03, Fulton County, Georgia,0,0,0,0,0,0,0,0
-1,131210092031004.000000000000000,Block 1004, Block Group 1, Census Tract 92.03, Fulton County, Georgia,0,0,0,0,0,0,0,0
-1,131210092031005.000000000000000,Block 1005, Block Group 1, Census Tract 92.03, Fulton County, Georgia,0,0,0,0,0,0,0,0
-1,131210092031010.000000000000000,Block 1010, Block Group 1, Census Tract 92.03, Fulton County, Georgia,0,0,0,0,0,0,0,0
-1,131210092032003.000000000000000,Block 2003, Block Group 2, Census Tract 92.03, Fulton County, Georgia,0,0,0,0,0,0,0,0
-1,131210092032007.000000000000000,Block 2007, Block Group 2, Census Tract 92.03, Fulton County, Georgia,0,0,0,0,0,0,0,0
-1,131210092032008.000000000000000,Block 2008, Block Group 2, Census Tract 92.03, Fulton County, Georgia,0,0,0,0,0,0,0,0
-1,131210092032009.000000000000000,Block 2009, Block Group 2, Census Tract 92.03, Fulton County, Georgia,0,0,0,0,0,0,0,0
-1,131210092032010.000000000000000,Block 2010, Block Group 2, Census Tract 92.03, Fulton County, Georgia,0,0,0,0,0,0,0,0
-1,131210092032011.000000000000000,Block 2011, Block Group 2, Census Tract 92.03, Fulton County, Georgia,0,0,0,0,0,0,0,0
-1,131210092032012.000000000000000,Block 2012, Block Group 2, Census Tract 92.03, Fulton County, Georgia,0,0,0,0,0,0,0,0
-1,131210092032013.000000000000000,Block 2013, Block Group 2, Census Tract 92.03, Fulton County, Georgia,0,0,0,0,0,0,0,0
-1,131210092032017.000000000000000,Block 2017, Block Group 2, Census Tract 92.03, Fulton County, Georgia,0,0,0,0,0,0,0,0
-1,131210092032018.000000000000000,Block 2018, Block Group 2, Census Tract 92.03, Fulton County, Georgia,0,0,0,0,0,0,0,0
-1,131210093011017.000000000000000,Block 1017, Block Group 1, Census Tract 93.01, Fulton County, Georgia,0,0,0,0,0,0,0,0
-1,131210093012006.000000000000000,Block 2006, Block Group 2, Census Tract 93.01, Fulton County, Georgia,0,0,0,0,0,0,0,0
-1,131210093022007.000000000000000,Block 2007, Block Group 2, Census Tract 93.02, Fulton County, Georgia,0,0,0,0,0,0,0,0
-1,131210094051000.000000000000000,Block 1000, Block Group 1, Census Tract 94.05, Fulton County, Georgia,0,0,0,0,0,0,0,0
-1,131210094051001.000000000000000,Block 1001, Block Group 1, Census Tract 94.05, Fulton County, Georgia,0,0,0,0,0,0,0,0
-1,131210094051006.000000000000000,Block 1006, Block Group 1, Census Tract 94.05, Fulton County, Georgia,0,0,0,0,0,0,0,0
-1,131210094051008.000000000000000,Block 1008, Block Group 1, Census Tract 94.05, Fulton County, Georgia,0,0,0,0,0,0,0,0
-1,131210094052003.000000000000000,Block 2003, Block Group 2, Census Tract 94.05, Fulton County, Georgia,0,0,0,0,0,0,0,0
-1,131210094052005.000000000000000,Block 2005, Block Group 2, Census Tract 94.05, Fulton County, Georgia,0,0,0,0,0,0,0,0
-1,131210094052006.000000000000000,Block 2006, Block Group 2, Census Tract 94.05, Fulton County, Georgia,0,0,0,0,0,0,0,0
-1,131210094053003.000000000000000,Block 3003, Block Group 3, Census Tract 94.05, Fulton County, Georgia,0,0,0,0,0,0,0,0
-1,131210094053004.000000000000000,Block 3004, Block Group 3, Census Tract 94.05, Fulton County, Georgia,0,0,0,0,0,0,0,0
-1,131210094061002.000000000000000,Block 1002, Block Group 1, Census Tract 94.06, Fulton County, Georgia,0,0,0,0,0,0,0,0
-1,131210094062000.000000000000000,Block 2000, Block Group 2, Census Tract 94.06, Fulton County, Georgia,0,0,0,0,0,0,0,0
-1,131210094062001.000000000000000,Block 2001, Block Group 2, Census Tract 94.06, Fulton County, Georgia,0,0,0,0,0,0,0,0
-1,131210094062002.000000000000000,Block 2002, Block Group 2, Census Tract 94.06, Fulton County, Georgia,0,0,0,0,0,0,0,0
-1,131210094062004.000000000000000,Block 2004, Block Group 2, Census Tract 94.06, Fulton County, Georgia,0,0,0,0,0,0,0,0
-1,131210094062005.000000000000000,Block 2005, Block Group 2, Census Tract 94.06, Fulton County, Georgia,0,0,0,0,0,0,0,0
-1,131210094062006.000000000000000,Block 2006, Block Group 2, Census Tract 94.06, Fulton County, Georgia,0,0,0,0,0,0,0,0
-1,131210094062007.000000000000000,Block 2007, Block Group 2, Census Tract 94.06, Fulton County, Georgia,0,0,0,0,0,0,0,0
-1,131210094062008.000000000000000,Block 2008, Block Group 2, Census Tract 94.06, Fulton County, Georgia,0,0,0,0,0,0,0,0
-1,131210094062012.000000000000000,Block 2012, Block Group 2, Census Tract 94.06, Fulton County, Georgia,0,0,0,0,0,0,0,0
-1,131210094062013.000000000000000,Block 2013, Block Group 2, Census Tract 94.06, Fulton County, Georgia,0,0,0,0,0,0,0,0
-1,131210094062014.000000000000000,Block 2014, Block Group 2, Census Tract 94.06, Fulton County, Georgia,0,0,0,0,0,0,0,0
-1,131210094062015.000000000000000,Block 2015, Block Group 2, Census Tract 94.06, Fulton County, Georgia,0,0,0,0,0,0,0,0
-1,131210094062016.000000000000000,Block 2016, Block Group 2, Census Tract 94.06, Fulton County, Georgia,0,0,0,0,0,0,0,0
-1,131210094062017.000000000000000,Block 2017, Block Group 2, Census Tract 94.06, Fulton County, Georgia,0,0,0,0,0,0,0,0
-1,131210094071001.000000000000000,Block 1001, Block Group 1, Census Tract 94.07, Fulton County, Georgia,0,0,0,0,0,0,0,0
-1,131210094071002.000000000000000,Block 1002, Block Group 1, Census Tract 94.07, Fulton County, Georgia,0,0,0,0,0,0,0,0
-1,131210094082000.000000000000000,Block 2000, Block Group 2, Census Tract 94.08, Fulton County, Georgia,0,0,0,0,0,0,0,0
-1,131210094082001.000000000000000,Block 2001, Block Group 2, Census Tract 94.08, Fulton County, Georgia,0,0,0,0,0,0,0,0
-1,131210094082002.000000000000000,Block 2002, Block Group 2, Census Tract 94.08, Fulton County, Georgia,0,0,0,0,0,0,0,0
-1,131210094082003.000000000000000,Block 2003, Block Group 2, Census Tract 94.08, Fulton County, Georgia,0,0,0,0,0,0,0,0
-1,131210094082004.000000000000000,Block 2004, Block Group 2, Census Tract 94.08, Fulton County, Georgia,0,0,0,0,0,0,0,0
-1,131210094082007.000000000000000,Block 2007, Block Group 2, Census Tract 94.08, Fulton County, Georgia,0,0,0,0,0,0,0,0
-1,131210094092000.000000000000000,Block 2000, Block Group 2, Census Tract 94.09, Fulton County, Georgia,0,0,0,0,0,0,0,0
-1,131210094092001.000000000000000,Block 2001, Block Group 2, Census Tract 94.09, Fulton County, Georgia,0,0,0,0,0,0,0,0
-1,131210094092004.000000000000000,Block 2004, Block Group 2, Census Tract 94.09, Fulton County, Georgia,0,0,0,0,0,0,0,0
-1,131210094092005.000000000000000,Block 2005, Block Group 2, Census Tract 94.09, Fulton County, Georgia,0,0,0,0,0,0,0,0
-1,131210094092006.000000000000000,Block 2006, Block Group 2, Census Tract 94.09, Fulton County, Georgia,0,0,0,0,0,0,0,0
-1,131210094092007.000000000000000,Block 2007, Block Group 2, Census Tract 94.09, Fulton County, Georgia,0,0,0,0,0,0,0,0
-1,131210094092008.000000000000000,Block 2008, Block Group 2, Census Tract 94.09, Fulton County, Georgia,0,0,0,0,0,0,0,0
-1,131210094101003.000000000000000,Block 1003, Block Group 1, Census Tract 94.10, Fulton County, Georgia,0,0,0,0,0,0,0,0
-1,131210094102000.000000000000000,Block 2000, Block Group 2, Census Tract 94.10, Fulton County, Georgia,0,0,0,0,0,0,0,0
-1,131210094102004.000000000000000,Block 2004, Block Group 2, Census Tract 94.10, Fulton County, Georgia,0,0,0,0,0,0,0,0
-1,131210094111007.000000000000000,Block 1007, Block Group 1, Census Tract 94.11, Fulton County, Georgia,0,0,0,0,0,0,0,0
-1,131210095011000.000000000000000,Block 1000, Block Group 1, Census Tract 95.01, Fulton County, Georgia,0,0,0,0,0,0,0,0
-1,131210095011001.000000000000000,Block 1001, Block Group 1, Census Tract 95.01, Fulton County, Georgia,0,0,0,0,0,0,0,0
-1,131210095011002.000000000000000,Block 1002, Block Group 1, Census Tract 95.01, Fulton County, Georgia,0,0,0,0,0,0,0,0
-1,131210095011003.000000000000000,Block 1003, Block Group 1, Census Tract 95.01, Fulton County, Georgia,0,0,0,0,0,0,0,0
-1,131210095011004.000000000000000,Block 1004, Block Group 1, Census Tract 95.01, Fulton County, Georgia,0,0,0,0,0,0,0,0
-1,131210095011020.000000000000000,Block 1020, Block Group 1, Census Tract 95.01, Fulton County, Georgia,0,0,0,0,0,0,0,0
-1,131210095012015.000000000000000,Block 2015, Block Group 2, Census Tract 95.01, Fulton County, Georgia,0,0,0,0,0,0,0,0
-1,131210095013010.000000000000000,Block 3010, Block Group 3, Census Tract 95.01, Fulton County, Georgia,0,0,0,0,0,0,0,0
-1,131210095014000.000000000000000,Block 4000, Block Group 4, Census Tract 95.01, Fulton County, Georgia,0,0,0,0,0,0,0,0
-1,131210095014004.000000000000000,Block 4004, Block Group 4, Census Tract 95.01, Fulton County, Georgia,0,0,0,0,0,0,0,0
-1,131210095031000.000000000000000,Block 1000, Block Group 1, Census Tract 95.03, Fulton County, Georgia,0,0,0,0,0,0,0,0
-1,131210095032001.000000000000000,Block 2001, Block Group 2, Census Tract 95.03, Fulton County, Georgia,0,0,0,0,0,0,0,0
-1,131210095041015.000000000000000,Block 1015, Block Group 1, Census Tract 95.04, Fulton County, Georgia,0,0,0,0,0,0,0,0
-1,131210095041016.000000000000000,Block 1016, Block Group 1, Census Tract 95.04, Fulton County, Georgia,0,0,0,0,0,0,0,0
-1,131210095042003.000000000000000,Block 2003, Block Group 2, Census Tract 95.04, Fulton County, Georgia,0,0,0,0,0,0,0,0
-1,131210096011003.000000000000000,Block 1003, Block Group 1, Census Tract 96.01, Fulton County, Georgia,0,0,0,0,0,0,0,0
-1,131210096011004.000000000000000,Block 1004, Block Group 1, Census Tract 96.01, Fulton County, Georgia,0,0,0,0,0,0,0,0
-1,131210096011005.000000000000000,Block 1005, Block Group 1, Census Tract 96.01, Fulton County, Georgia,0,0,0,0,0,0,0,0
-1,131210096043003.000000000000000,Block 3003, Block Group 3, Census Tract 96.04, Fulton County, Georgia,0,0,0,0,0,0,0,0
-1,131210096044003.000000000000000,Block 4003, Block Group 4, Census Tract 96.04, Fulton County, Georgia,0,0,0,0,0,0,0,0
-1,131210096051002.000000000000000,Block 1002, Block Group 1, Census Tract 96.05, Fulton County, Georgia,0,0,0,0,0,0,0,0
-1,131210096051003.000000000000000,Block 1003, Block Group 1, Census Tract 96.05, Fulton County, Georgia,0,0,0,0,0,0,0,0
-1,131210096051004.000000000000000,Block 1004, Block Group 1, Census Tract 96.05, Fulton County, Georgia,0,0,0,0,0,0,0,0
-1,131210096051006.000000000000000,Block 1006, Block Group 1, Census Tract 96.05, Fulton County, Georgia,0,0,0,0,0,0,0,0
-1,131210096052002.000000000000000,Block 2002, Block Group 2, Census Tract 96.05, Fulton County, Georgia,0,0,0,0,0,0,0,0
-1,131210096053001.000000000000000,Block 3001, Block Group 3, Census Tract 96.05, Fulton County, Georgia,0,0,0,0,0,0,0,0
-1,131210096053003.000000000000000,Block 3003, Block Group 3, Census Tract 96.05, Fulton County, Georgia,0,0,0,0,0,0,0,0
-1,131210096053004.000000000000000,Block 3004, Block Group 3, Census Tract 96.05, Fulton County, Georgia,0,0,0,0,0,0,0,0
-1,131210096061000.000000000000000,Block 1000, Block Group 1, Census Tract 96.06, Fulton County, Georgia,0,0,0,0,0,0,0,0
-1,131210096061001.000000000000000,Block 1001, Block Group 1, Census Tract 96.06, Fulton County, Georgia,0,0,0,0,0,0,0,0
-1,131210096061003.000000000000000,Block 1003, Block Group 1, Census Tract 96.06, Fulton County, Georgia,0,0,0,0,0,0,0,0
-1,131210096061004.000000000000000,Block 1004, Block Group 1, Census Tract 96.06, Fulton County, Georgia,0,0,0,0,0,0,0,0
-1,131210096061005.000000000000000,Block 1005, Block Group 1, Census Tract 96.06, Fulton County, Georgia,0,0,0,0,0,0,0,0
-1,131210096061007.000000000000000,Block 1007, Block Group 1, Census Tract 96.06, Fulton County, Georgia,0,0,0,0,0,0,0,0
-1,131210096061008.000000000000000,Block 1008, Block Group 1, Census Tract 96.06, Fulton County, Georgia,0,0,0,0,0,0,0,0
-1,131210097001003.000000000000000,Block 1003, Block Group 1, Census Tract 97, Fulton County, Georgia,0,0,0,0,0,0,0,0
-1,131210097001005.000000000000000,Block 1005, Block Group 1, Census Tract 97, Fulton County, Georgia,0,0,0,0,0,0,0,0
-1,131210097001006.000000000000000,Block 1006, Block Group 1, Census Tract 97, Fulton County, Georgia,0,0,0,0,0,0,0,0
-1,131210097001014.000000000000000,Block 1014, Block Group 1, Census Tract 97, Fulton County, Georgia,0,0,0,0,0,0,0,0
-1,131210097001015.000000000000000,Block 1015, Block Group 1, Census Tract 97, Fulton County, Georgia,0,0,0,0,0,0,0,0
-1,131210097002003.000000000000000,Block 2003, Block Group 2, Census Tract 97, Fulton County, Georgia,0,0,0,0,0,0,0,0
-1,131210097002006.000000000000000,Block 2006, Block Group 2, Census Tract 97, Fulton County, Georgia,0,0,0,0,0,0,0,0
-1,131210097002007.000000000000000,Block 2007, Block Group 2, Census Tract 97, Fulton County, Georgia,0,0,0,0,0,0,0,0
-1,131210097002014.000000000000000,Block 2014, Block Group 2, Census Tract 97, Fulton County, Georgia,0,0,0,0,0,0,0,0
-1,131210097003002.000000000000000,Block 3002, Block Group 3, Census Tract 97, Fulton County, Georgia,0,0,0,0,0,0,0,0
-1,131210097003004.000000000000000,Block 3004, Block Group 3, Census Tract 97, Fulton County, Georgia,0,0,0,0,0,0,0,0
-1,131210097003008.000000000000000,Block 3008, Block Group 3, Census Tract 97, Fulton County, Georgia,0,0,0,0,0,0,0,0
-1,131210097003013.000000000000000,Block 3013, Block Group 3, Census Tract 97, Fulton County, Georgia,0,0,0,0,0,0,0,0
-1,131210097003022.000000000000000,Block 3022, Block Group 3, Census Tract 97, Fulton County, Georgia,0,0,0,0,0,0,0,0
-1,131210097003023.000000000000000,Block 3023, Block Group 3, Census Tract 97, Fulton County, Georgia,0,0,0,0,0,0,0,0
-1,131210098021007.000000000000000,Block 1007, Block Group 1, Census Tract 98.02, Fulton County, Georgia,0,0,0,0,0,0,0,0
-1,131210098021008.000000000000000,Block 1008, Block Group 1, Census Tract 98.02, Fulton County, Georgia,0,0,0,0,0,0,0,0
-1,131210098021012.000000000000000,Block 1012, Block Group 1, Census Tract 98.02, Fulton County, Georgia,0,0,0,0,0,0,0,0
-1,131210098021013.000000000000000,Block 1013, Block Group 1, Census Tract 98.02, Fulton County, Georgia,0,0,0,0,0,0,0,0
-1,131210098022001.000000000000000,Block 2001, Block Group 2, Census Tract 98.02, Fulton County, Georgia,0,0,0,0,0,0,0,0
-1,131210098022002.000000000000000,Block 2002, Block Group 2, Census Tract 98.02, Fulton County, Georgia,0,0,0,0,0,0,0,0
-1,131210098022008.000000000000000,Block 2008, Block Group 2, Census Tract 98.02, Fulton County, Georgia,0,0,0,0,0,0,0,0
-1,131210098022013.000000000000000,Block 2013, Block Group 2, Census Tract 98.02, Fulton County, Georgia,0,0,0,0,0,0,0,0
-1,131210098022014.000000000000000,Block 2014, Block Group 2, Census Tract 98.02, Fulton County, Georgia,0,0,0,0,0,0,0,0
-1,131210098032000.000000000000000,Block 2000, Block Group 2, Census Tract 98.03, Fulton County, Georgia,0,0,0,0,0,0,0,0
-1,131210098041019.000000000000000,Block 1019, Block Group 1, Census Tract 98.04, Fulton County, Georgia,0,0,0,0,0,0,0,0
-1,131210098041020.000000000000000,Block 1020, Block Group 1, Census Tract 98.04, Fulton County, Georgia,0,0,0,0,0,0,0,0
-1,131210098041021.000000000000000,Block 1021, Block Group 1, Census Tract 98.04, Fulton County, Georgia,0,0,0,0,0,0,0,0
-1,131210099002013.000000000000000,Block 2013, Block Group 2, Census Tract 99, Fulton County, Georgia,0,0,0,0,0,0,0,0
-1,131210099003010.000000000000000,Block 3010, Block Group 3, Census Tract 99, Fulton County, Georgia,0,0,0,0,0,0,0,0
-1,131210099005000.000000000000000,Block 5000, Block Group 5, Census Tract 99, Fulton County, Georgia,0,0,0,0,0,0,0,0
-1,131210099005001.000000000000000,Block 5001, Block Group 5, Census Tract 99, Fulton County, Georgia,0,0,0,0,0,0,0,0
-1,131210099005002.000000000000000,Block 5002, Block Group 5, Census Tract 99, Fulton County, Georgia,0,0,0,0,0,0,0,0
-1,131210099005003.000000000000000,Block 5003, Block Group 5, Census Tract 99, Fulton County, Georgia,0,0,0,0,0,0,0,0
-1,131210099005005.000000000000000,Block 5005, Block Group 5, Census Tract 99, Fulton County, Georgia,0,0,0,0,0,0,0,0
-1,131210100032001.000000000000000,Block 2001, Block Group 2, Census Tract 100.03, Fulton County, Georgia,0,0,0,0,0,0,0,0
-1,131210100032003.000000000000000,Block 2003, Block Group 2, Census Tract 100.03, Fulton County, Georgia,0,0,0,0,0,0,0,0
-1,131210100033003.000000000000000,Block 3003, Block Group 3, Census Tract 100.03, Fulton County, Georgia,0,0,0,0,0,0,0,0
-1,131210100041005.000000000000000,Block 1005, Block Group 1, Census Tract 100.04, Fulton County, Georgia,0,0,0,0,0,0,0,0
-1,131210100041007.000000000000000,Block 1007, Block Group 1, Census Tract 100.04, Fulton County, Georgia,0,0,0,0,0,0,0,0
-1,131210100041008.000000000000000,Block 1008, Block Group 1, Census Tract 100.04, Fulton County, Georgia,0,0,0,0,0,0,0,0
-1,131210100042000.000000000000000,Block 2000, Block Group 2, Census Tract 100.04, Fulton County, Georgia,0,0,0,0,0,0,0,0
-1,131210100051004.000000000000000,Block 1004, Block Group 1, Census Tract 100.05, Fulton County, Georgia,0,0,0,0,0,0,0,0
-1,131210100051010.000000000000000,Block 1010, Block Group 1, Census Tract 100.05, Fulton County, Georgia,0,0,0,0,0,0,0,0
-1,131210100051019.000000000000000,Block 1019, Block Group 1, Census Tract 100.05, Fulton County, Georgia,0,0,0,0,0,0,0,0
-1,131210100052002.000000000000000,Block 2002, Block Group 2, Census Tract 100.05, Fulton County, Georgia,0,0,0,0,0,0,0,0
-1,131210100052003.000000000000000,Block 2003, Block Group 2, Census Tract 100.05, Fulton County, Georgia,0,0,0,0,0,0,0,0
-1,131210100052004.000000000000000,Block 2004, Block Group 2, Census Tract 100.05, Fulton County, Georgia,0,0,0,0,0,0,0,0
-1,131210100052006.000000000000000,Block 2006, Block Group 2, Census Tract 100.05, Fulton County, Georgia,0,0,0,0,0,0,0,0
-1,131210100052012.000000000000000,Block 2012, Block Group 2, Census Tract 100.05, Fulton County, Georgia,0,0,0,0,0,0,0,0
-1,131210100052013.000000000000000,Block 2013, Block Group 2, Census Tract 100.05, Fulton County, Georgia,0,0,0,0,0,0,0,0
-1,131210100052021.000000000000000,Block 2021, Block Group 2, Census Tract 100.05, Fulton County, Georgia,0,0,0,0,0,0,0,0
-1,131210100061003.000000000000000,Block 1003, Block Group 1, Census Tract 100.06, Fulton County, Georgia,0,0,0,0,0,0,0,0
-1,131210100061004.000000000000000,Block 1004, Block Group 1, Census Tract 100.06, Fulton County, Georgia,0,0,0,0,0,0,0,0
-1,131210100061005.000000000000000,Block 1005, Block Group 1, Census Tract 100.06, Fulton County, Georgia,0,0,0,0,0,0,0,0
-1,131210100062002.000000000000000,Block 2002, Block Group 2, Census Tract 100.06, Fulton County, Georgia,0,0,0,0,0,0,0,0
-1,131210100062003.000000000000000,Block 2003, Block Group 2, Census Tract 100.06, Fulton County, Georgia,0,0,0,0,0,0,0,0
-1,131210100062006.000000000000000,Block 2006, Block Group 2, Census Tract 100.06, Fulton County, Georgia,0,0,0,0,0,0,0,0
-1,131210100062007.000000000000000,Block 2007, Block Group 2, Census Tract 100.06, Fulton County, Georgia,0,0,0,0,0,0,0,0
-1,131210100071005.000000000000000,Block 1005, Block Group 1, Census Tract 100.07, Fulton County, Georgia,0,0,0,0,0,0,0,0
-1,131210100071011.000000000000000,Block 1011, Block Group 1, Census Tract 100.07, Fulton County, Georgia,0,0,0,0,0,0,0,0
-1,131210100072005.000000000000000,Block 2005, Block Group 2, Census Tract 100.07, Fulton County, Georgia,0,0,0,0,0,0,0,0
-1,131210100072007.000000000000000,Block 2007, Block Group 2, Census Tract 100.07, Fulton County, Georgia,0,0,0,0,0,0,0,0
-1,131210101061001.000000000000000,Block 1001, Block Group 1, Census Tract 101.06, Fulton County, Georgia,0,0,0,0,0,0,0,0
-1,131210101063005.000000000000000,Block 3005, Block Group 3, Census Tract 101.06, Fulton County, Georgia,0,0,0,0,0,0,0,0
-1,131210101064000.000000000000000,Block 4000, Block Group 4, Census Tract 101.06, Fulton County, Georgia,0,0,0,0,0,0,0,0
-1,131210101064001.000000000000000,Block 4001, Block Group 4, Census Tract 101.06, Fulton County, Georgia,0,0,0,0,0,0,0,0
-1,131210101064002.000000000000000,Block 4002, Block Group 4, Census Tract 101.06, Fulton County, Georgia,0,0,0,0,0,0,0,0
-1,131210101064005.000000000000000,Block 4005, Block Group 4, Census Tract 101.06, Fulton County, Georgia,0,0,0,0,0,0,0,0
-1,131210101151001.000000000000000,Block 1001, Block Group 1, Census Tract 101.15, Fulton County, Georgia,0,0,0,0,0,0,0,0
-1,131210101151002.000000000000000,Block 1002, Block Group 1, Census Tract 101.15, Fulton County, Georgia,0,0,0,0,0,0,0,0
-1,131210101151003.000000000000000,Block 1003, Block Group 1, Census Tract 101.15, Fulton County, Georgia,0,0,0,0,0,0,0,0
-1,131210101151004.000000000000000,Block 1004, Block Group 1, Census Tract 101.15, Fulton County, Georgia,0,0,0,0,0,0,0,0
-1,131210101151006.000000000000000,Block 1006, Block Group 1, Census Tract 101.15, Fulton County, Georgia,0,0,0,0,0,0,0,0
-1,131210101151010.000000000000000,Block 1010, Block Group 1, Census Tract 101.15, Fulton County, Georgia,0,0,0,0,0,0,0,0
-1,131210101151011.000000000000000,Block 1011, Block Group 1, Census Tract 101.15, Fulton County, Georgia,0,0,0,0,0,0,0,0
-1,131210101152000.000000000000000,Block 2000, Block Group 2, Census Tract 101.15, Fulton County, Georgia,0,0,0,0,0,0,0,0
-1,131210101152001.000000000000000,Block 2001, Block Group 2, Census Tract 101.15, Fulton County, Georgia,0,0,0,0,0,0,0,0
-1,131210101152002.000000000000000,Block 2002, Block Group 2, Census Tract 101.15, Fulton County, Georgia,0,0,0,0,0,0,0,0
-1,131210101152003.000000000000000,Block 2003, Block Group 2, Census Tract 101.15, Fulton County, Georgia,0,0,0,0,0,0,0,0
-1,131210101152006.000000000000000,Block 2006, Block Group 2, Census Tract 101.15, Fulton County, Georgia,0,0,0,0,0,0,0,0
-1,131210101152008.000000000000000,Block 2008, Block Group 2, Census Tract 101.15, Fulton County, Georgia,0,0,0,0,0,0,0,0
-1,131210101152009.000000000000000,Block 2009, Block Group 2, Census Tract 101.15, Fulton County, Georgia,0,0,0,0,0,0,0,0
-1,131210101152010.000000000000000,Block 2010, Block Group 2, Census Tract 101.15, Fulton County, Georgia,0,0,0,0,0,0,0,0
-1,131210101152011.000000000000000,Block 2011, Block Group 2, Census Tract 101.15, Fulton County, Georgia,0,0,0,0,0,0,0,0
-1,131210101171004.000000000000000,Block 1004, Block Group 1, Census Tract 101.17, Fulton County, Georgia,0,0,0,0,0,0,0,0
-1,131210101172000.000000000000000,Block 2000, Block Group 2, Census Tract 101.17, Fulton County, Georgia,0,0,0,0,0,0,0,0
-1,131210101172002.000000000000000,Block 2002, Block Group 2, Census Tract 101.17, Fulton County, Georgia,0,0,0,0,0,0,0,0
-1,131210101202004.000000000000000,Block 2004, Block Group 2, Census Tract 101.20, Fulton County, Georgia,0,0,0,0,0,0,0,0
-1,131210101202005.000000000000000,Block 2005, Block Group 2, Census Tract 101.20, Fulton County, Georgia,0,0,0,0,0,0,0,0
-1,131210101252006.000000000000000,Block 2006, Block Group 2, Census Tract 101.25, Fulton County, Georgia,0,0,0,0,0,0,0,0
-1,131210101252007.000000000000000,Block 2007, Block Group 2, Census Tract 101.25, Fulton County, Georgia,0,0,0,0,0,0,0,0
-1,131210101261004.000000000000000,Block 1004, Block Group 1, Census Tract 101.26, Fulton County, Georgia,0,0,0,0,0,0,0,0
-1,131210101262001.000000000000000,Block 2001, Block Group 2, Census Tract 101.26, Fulton County, Georgia,0,0,0,0,0,0,0,0
-1,131210101262003.000000000000000,Block 2003, Block Group 2, Census Tract 101.26, Fulton County, Georgia,0,0,0,0,0,0,0,0
-1,131210101274001.000000000000000,Block 4001, Block Group 4, Census Tract 101.27, Fulton County, Georgia,0,0,0,0,0,0,0,0
-1,131210101293001.000000000000000,Block 3001, Block Group 3, Census Tract 101.29, Fulton County, Georgia,0,0,0,0,0,0,0,0
-1,131210101293002.000000000000000,Block 3002, Block Group 3, Census Tract 101.29, Fulton County, Georgia,0,0,0,0,0,0,0,0
-1,131210101293003.000000000000000,Block 3003, Block Group 3, Census Tract 101.29, Fulton County, Georgia,0,0,0,0,0,0,0,0
-1,131210101293004.000000000000000,Block 3004, Block Group 3, Census Tract 101.29, Fulton County, Georgia,0,0,0,0,0,0,0,0
-1,131210101301001.000000000000000,Block 1001, Block Group 1, Census Tract 101.30, Fulton County, Georgia,0,0,0,0,0,0,0,0
-1,131210101302003.000000000000000,Block 2003, Block Group 2, Census Tract 101.30, Fulton County, Georgia,0,0,0,0,0,0,0,0
-1,131210101304004.000000000000000,Block 4004, Block Group 4, Census Tract 101.30, Fulton County, Georgia,0,0,0,0,0,0,0,0
-1,131210101304005.000000000000000,Block 4005, Block Group 4, Census Tract 101.30, Fulton County, Georgia,0,0,0,0,0,0,0,0
-1,131210101304006.000000000000000,Block 4006, Block Group 4, Census Tract 101.30, Fulton County, Georgia,0,0,0,0,0,0,0,0
-1,131210101304007.000000000000000,Block 4007, Block Group 4, Census Tract 101.30, Fulton County, Georgia,0,0,0,0,0,0,0,0
-1,131210101304008.000000000000000,Block 4008, Block Group 4, Census Tract 101.30, Fulton County, Georgia,0,0,0,0,0,0,0,0
-1,131210101305002.000000000000000,Block 5002, Block Group 5, Census Tract 101.30, Fulton County, Georgia,0,0,0,0,0,0,0,0
-1,131210101311006.000000000000000,Block 1006, Block Group 1, Census Tract 101.31, Fulton County, Georgia,0,0,0,0,0,0,0,0
-1,131210101312004.000000000000000,Block 2004, Block Group 2, Census Tract 101.31, Fulton County, Georgia,0,0,0,0,0,0,0,0
-1,131210101321012.000000000000000,Block 1012, Block Group 1, Census Tract 101.32, Fulton County, Georgia,0,0,0,0,0,0,0,0
-1,131210101321013.000000000000000,Block 1013, Block Group 1, Census Tract 101.32, Fulton County, Georgia,0,0,0,0,0,0,0,0
-1,131210101322001.000000000000000,Block 2001, Block Group 2, Census Tract 101.32, Fulton County, Georgia,0,0,0,0,0,0,0,0
-1,131210101322002.000000000000000,Block 2002, Block Group 2, Census Tract 101.32, Fulton County, Georgia,0,0,0,0,0,0,0,0
-1,131210101323001.000000000000000,Block 3001, Block Group 3, Census Tract 101.32, Fulton County, Georgia,0,0,0,0,0,0,0,0
-1,131210101323008.000000000000000,Block 3008, Block Group 3, Census Tract 101.32, Fulton County, Georgia,0,0,0,0,0,0,0,0
-1,131210101323009.000000000000000,Block 3009, Block Group 3, Census Tract 101.32, Fulton County, Georgia,0,0,0,0,0,0,0,0
-1,131210101331000.000000000000000,Block 1000, Block Group 1, Census Tract 101.33, Fulton County, Georgia,0,0,0,0,0,0,0,0
-1,131210101331008.000000000000000,Block 1008, Block Group 1, Census Tract 101.33, Fulton County, Georgia,0,0,0,0,0,0,0,0
-1,131210101332012.000000000000000,Block 2012, Block Group 2, Census Tract 101.33, Fulton County, Georgia,0,0,0,0,0,0,0,0
-1,131210101333001.000000000000000,Block 3001, Block Group 3, Census Tract 101.33, Fulton County, Georgia,0,0,0,0,0,0,0,0
-1,131210101333003.000000000000000,Block 3003, Block Group 3, Census Tract 101.33, Fulton County, Georgia,0,0,0,0,0,0,0,0
-1,131210101333004.000000000000000,Block 3004, Block Group 3, Census Tract 101.33, Fulton County, Georgia,0,0,0,0,0,0,0,0
-1,131210101333008.000000000000000,Block 3008, Block Group 3, Census Tract 101.33, Fulton County, Georgia,0,0,0,0,0,0,0,0
-1,131210101333009.000000000000000,Block 3009, Block Group 3, Census Tract 101.33, Fulton County, Georgia,0,0,0,0,0,0,0,0
-1,131210101333010.000000000000000,Block 3010, Block Group 3, Census Tract 101.33, Fulton County, Georgia,0,0,0,0,0,0,0,0
-1,131210101333011.000000000000000,Block 3011, Block Group 3, Census Tract 101.33, Fulton County, Georgia,0,0,0,0,0,0,0,0
-1,131210101333012.000000000000000,Block 3012, Block Group 3, Census Tract 101.33, Fulton County, Georgia,0,0,0,0,0,0,0,0
-1,131210101333013.000000000000000,Block 3013, Block Group 3, Census Tract 101.33, Fulton County, Georgia,0,0,0,0,0,0,0,0
-1,131210101333014.000000000000000,Block 3014, Block Group 3, Census Tract 101.33, Fulton County, Georgia,0,0,0,0,0,0,0,0
-1,131210101333015.000000000000000,Block 3015, Block Group 3, Census Tract 101.33, Fulton County, Georgia,0,0,0,0,0,0,0,0
-1,131210101343003.000000000000000,Block 3003, Block Group 3, Census Tract 101.34, Fulton County, Georgia,0,0,0,0,0,0,0,0
-1,131210101351003.000000000000000,Block 1003, Block Group 1, Census Tract 101.35, Fulton County, Georgia,0,0,0,0,0,0,0,0
-1,131210101361005.000000000000000,Block 1005, Block Group 1, Census Tract 101.36, Fulton County, Georgia,0,0,0,0,0,0,0,0
-1,131210101361010.000000000000000,Block 1010, Block Group 1, Census Tract 101.36, Fulton County, Georgia,0,0,0,0,0,0,0,0
-1,131210101362014.000000000000000,Block 2014, Block Group 2, Census Tract 101.36, Fulton County, Georgia,0,0,0,0,0,0,0,0
-1,131210102041002.000000000000000,Block 1002, Block Group 1, Census Tract 102.04, Fulton County, Georgia,0,0,0,0,0,0,0,0
-1,131210102042000.000000000000000,Block 2000, Block Group 2, Census Tract 102.04, Fulton County, Georgia,0,0,0,0,0,0,0,0
-1,131210102043007.000000000000000,Block 3007, Block Group 3, Census Tract 102.04, Fulton County, Georgia,0,0,0,0,0,0,0,0
-1,131210102043009.000000000000000,Block 3009, Block Group 3, Census Tract 102.04, Fulton County, Georgia,0,0,0,0,0,0,0,0
-1,131210102043010.000000000000000,Block 3010, Block Group 3, Census Tract 102.04, Fulton County, Georgia,0,0,0,0,0,0,0,0
-1,131210102043011.000000000000000,Block 3011, Block Group 3, Census Tract 102.04, Fulton County, Georgia,0,0,0,0,0,0,0,0
-1,131210102043012.000000000000000,Block 3012, Block Group 3, Census Tract 102.04, Fulton County, Georgia,0,0,0,0,0,0,0,0
-1,131210102043013.000000000000000,Block 3013, Block Group 3, Census Tract 102.04, Fulton County, Georgia,0,0,0,0,0,0,0,0
-1,131210102043014.000000000000000,Block 3014, Block Group 3, Census Tract 102.04, Fulton County, Georgia,0,0,0,0,0,0,0,0
-1,131210102043015.000000000000000,Block 3015, Block Group 3, Census Tract 102.04, Fulton County, Georgia,0,0,0,0,0,0,0,0
-1,131210102043016.000000000000000,Block 3016, Block Group 3, Census Tract 102.04, Fulton County, Georgia,0,0,0,0,0,0,0,0
-1,131210102043017.000000000000000,Block 3017, Block Group 3, Census Tract 102.04, Fulton County, Georgia,0,0,0,0,0,0,0,0
-1,131210102043018.000000000000000,Block 3018, Block Group 3, Census Tract 102.04, Fulton County, Georgia,0,0,0,0,0,0,0,0
-1,131210102043019.000000000000000,Block 3019, Block Group 3, Census Tract 102.04, Fulton County, Georgia,0,0,0,0,0,0,0,0
-1,131210102043020.000000000000000,Block 3020, Block Group 3, Census Tract 102.04, Fulton County, Georgia,0,0,0,0,0,0,0,0
-1,131210102112001.000000000000000,Block 2001, Block Group 2, Census Tract 102.11, Fulton County, Georgia,0,0,0,0,0,0,0,0
-1,131210102113006.000000000000000,Block 3006, Block Group 3, Census Tract 102.11, Fulton County, Georgia,0,0,0,0,0,0,0,0
-1,131210102114014.000000000000000,Block 4014, Block Group 4, Census Tract 102.11, Fulton County, Georgia,0,0,0,0,0,0,0,0
-1,131210102131001.000000000000000,Block 1001, Block Group 1, Census Tract 102.13, Fulton County, Georgia,0,0,0,0,0,0,0,0
-1,131210102131002.000000000000000,Block 1002, Block Group 1, Census Tract 102.13, Fulton County, Georgia,0,0,0,0,0,0,0,0
-1,131210102131004.000000000000000,Block 1004, Block Group 1, Census Tract 102.13, Fulton County, Georgia,0,0,0,0,0,0,0,0
-1,131210102131005.000000000000000,Block 1005, Block Group 1, Census Tract 102.13, Fulton County, Georgia,0,0,0,0,0,0,0,0
-1,131210102131006.000000000000000,Block 1006, Block Group 1, Census Tract 102.13, Fulton County, Georgia,0,0,0,0,0,0,0,0
-1,131210102131007.000000000000000,Block 1007, Block Group 1, Census Tract 102.13, Fulton County, Georgia,0,0,0,0,0,0,0,0
-1,131210102152002.000000000000000,Block 2002, Block Group 2, Census Tract 102.15, Fulton County, Georgia,0,0,0,0,0,0,0,0
-1,131210102152007.000000000000000,Block 2007, Block Group 2, Census Tract 102.15, Fulton County, Georgia,0,0,0,0,0,0,0,0
-1,131210102162003.000000000000000,Block 2003, Block Group 2, Census Tract 102.16, Fulton County, Georgia,0,0,0,0,0,0,0,0
-1,131210102171001.000000000000000,Block 1001, Block Group 1, Census Tract 102.17, Fulton County, Georgia,0,0,0,0,0,0,0,0
-1,131210102172001.000000000000000,Block 2001, Block Group 2, Census Tract 102.17, Fulton County, Georgia,0,0,0,0,0,0,0,0
-1,131210102172003.000000000000000,Block 2003, Block Group 2, Census Tract 102.17, Fulton County, Georgia,0,0,0,0,0,0,0,0
-1,131210102181004.000000000000000,Block 1004, Block Group 1, Census Tract 102.18, Fulton County, Georgia,0,0,0,0,0,0,0,0
-1,131210102182001.000000000000000,Block 2001, Block Group 2, Census Tract 102.18, Fulton County, Georgia,0,0,0,0,0,0,0,0
-1,131210102182002.000000000000000,Block 2002, Block Group 2, Census Tract 102.18, Fulton County, Georgia,0,0,0,0,0,0,0,0
-1,131210102193001.000000000000000,Block 3001, Block Group 3, Census Tract 102.19, Fulton County, Georgia,0,0,0,0,0,0,0,0
-1,131210102201000.000000000000000,Block 1000, Block Group 1, Census Tract 102.20, Fulton County, Georgia,0,0,0,0,0,0,0,0
-1,131210102201019.000000000000000,Block 1019, Block Group 1, Census Tract 102.20, Fulton County, Georgia,0,0,0,0,0,0,0,0
-1,131210102201021.000000000000000,Block 1021, Block Group 1, Census Tract 102.20, Fulton County, Georgia,0,0,0,0,0,0,0,0
-1,131210102202002.000000000000000,Block 2002, Block Group 2, Census Tract 102.20, Fulton County, Georgia,0,0,0,0,0,0,0,0
-1,131210102202007.000000000000000,Block 2007, Block Group 2, Census Tract 102.20, Fulton County, Georgia,0,0,0,0,0,0,0,0
-1,131210102203000.000000000000000,Block 3000, Block Group 3, Census Tract 102.20, Fulton County, Georgia,0,0,0,0,0,0,0,0
-1,131210102203001.000000000000000,Block 3001, Block Group 3, Census Tract 102.20, Fulton County, Georgia,0,0,0,0,0,0,0,0
-1,131210102203002.000000000000000,Block 3002, Block Group 3, Census Tract 102.20, Fulton County, Georgia,0,0,0,0,0,0,0,0
-1,131210102203003.000000000000000,Block 3003, Block Group 3, Census Tract 102.20, Fulton County, Georgia,0,0,0,0,0,0,0,0
-1,131210102203007.000000000000000,Block 3007, Block Group 3, Census Tract 102.20, Fulton County, Georgia,0,0,0,0,0,0,0,0
-1,131210102203008.000000000000000,Block 3008, Block Group 3, Census Tract 102.20, Fulton County, Georgia,0,0,0,0,0,0,0,0
-1,131210102203014.000000000000000,Block 3014, Block Group 3, Census Tract 102.20, Fulton County, Georgia,0,0,0,0,0,0,0,0
-1,131210102203015.000000000000000,Block 3015, Block Group 3, Census Tract 102.20, Fulton County, Georgia,0,0,0,0,0,0,0,0
-1,131210102213005.000000000000000,Block 3005, Block Group 3, Census Tract 102.21, Fulton County, Georgia,0,0,0,0,0,0,0,0
-1,131210102231000.000000000000000,Block 1000, Block Group 1, Census Tract 102.23, Fulton County, Georgia,0,0,0,0,0,0,0,0
-1,131210102231010.000000000000000,Block 1010, Block Group 1, Census Tract 102.23, Fulton County, Georgia,0,0,0,0,0,0,0,0
-1,131210102231011.000000000000000,Block 1011, Block Group 1, Census Tract 102.23, Fulton County, Georgia,0,0,0,0,0,0,0,0
-1,131210102232000.000000000000000,Block 2000, Block Group 2, Census Tract 102.23, Fulton County, Georgia,0,0,0,0,0,0,0,0
-1,131210102232001.000000000000000,Block 2001, Block Group 2, Census Tract 102.23, Fulton County, Georgia,0,0,0,0,0,0,0,0
-1,131210102232002.000000000000000,Block 2002, Block Group 2, Census Tract 102.23, Fulton County, Georgia,0,0,0,0,0,0,0,0
-1,131210102233003.000000000000000,Block 3003, Block Group 3, Census Tract 102.23, Fulton County, Georgia,0,0,0,0,0,0,0,0
-1,131210102233011.000000000000000,Block 3011, Block Group 3, Census Tract 102.23, Fulton County, Georgia,0,0,0,0,0,0,0,0
-1,131210103051028.000000000000000,Block 1028, Block Group 1, Census Tract 103.05, Fulton County, Georgia,0,0,0,0,0,0,0,0
-1,131210103052005.000000000000000,Block 2005, Block Group 2, Census Tract 103.05, Fulton County, Georgia,0,0,0,0,0,0,0,0
-1,131210103052009.000000000000000,Block 2009, Block Group 2, Census Tract 103.05, Fulton County, Georgia,0,0,0,0,0,0,0,0
-1,131210103053002.000000000000000,Block 3002, Block Group 3, Census Tract 103.05, Fulton County, Georgia,0,0,0,0,0,0,0,0
-1,131210103063000.000000000000000,Block 3000, Block Group 3, Census Tract 103.06, Fulton County, Georgia,0,0,0,0,0,0,0,0
-1,131210103063001.000000000000000,Block 3001, Block Group 3, Census Tract 103.06, Fulton County, Georgia,0,0,0,0,0,0,0,0
-1,131210103063002.000000000000000,Block 3002, Block Group 3, Census Tract 103.06, Fulton County, Georgia,0,0,0,0,0,0,0,0
-1,131210103063006.000000000000000,Block 3006, Block Group 3, Census Tract 103.06, Fulton County, Georgia,0,0,0,0,0,0,0,0
-1,131210103063009.000000000000000,Block 3009, Block Group 3, Census Tract 103.06, Fulton County, Georgia,0,0,0,0,0,0,0,0
-1,131210103063010.000000000000000,Block 3010, Block Group 3, Census Tract 103.06, Fulton County, Georgia,0,0,0,0,0,0,0,0
-1,131210103063011.000000000000000,Block 3011, Block Group 3, Census Tract 103.06, Fulton County, Georgia,0,0,0,0,0,0,0,0
-1,131210103063017.000000000000000,Block 3017, Block Group 3, Census Tract 103.06, Fulton County, Georgia,0,0,0,0,0,0,0,0
-1,131210103063019.000000000000000,Block 3019, Block Group 3, Census Tract 103.06, Fulton County, Georgia,0,0,0,0,0,0,0,0
-1,131210103063020.000000000000000,Block 3020, Block Group 3, Census Tract 103.06, Fulton County, Georgia,0,0,0,0,0,0,0,0
-1,131210103072000.000000000000000,Block 2000, Block Group 2, Census Tract 103.07, Fulton County, Georgia,0,0,0,0,0,0,0,0
-1,131210103072002.000000000000000,Block 2002, Block Group 2, Census Tract 103.07, Fulton County, Georgia,0,0,0,0,0,0,0,0
-1,131210103072007.000000000000000,Block 2007, Block Group 2, Census Tract 103.07, Fulton County, Georgia,0,0,0,0,0,0,0,0
-1,131210103072010.000000000000000,Block 2010, Block Group 2, Census Tract 103.07, Fulton County, Georgia,0,0,0,0,0,0,0,0
-1,131210103072014.000000000000000,Block 2014, Block Group 2, Census Tract 103.07, Fulton County, Georgia,0,0,0,0,0,0,0,0
-1,131210103072020.000000000000000,Block 2020, Block Group 2, Census Tract 103.07, Fulton County, Georgia,0,0,0,0,0,0,0,0
-1,131210103072021.000000000000000,Block 2021, Block Group 2, Census Tract 103.07, Fulton County, Georgia,0,0,0,0,0,0,0,0
-1,131210103074007.000000000000000,Block 4007, Block Group 4, Census Tract 103.07, Fulton County, Georgia,0,0,0,0,0,0,0,0
-1,131210103074014.000000000000000,Block 4014, Block Group 4, Census Tract 103.07, Fulton County, Georgia,0,0,0,0,0,0,0,0
-1,131210103082005.000000000000000,Block 2005, Block Group 2, Census Tract 103.08, Fulton County, Georgia,0,0,0,0,0,0,0,0
-1,131210103082008.000000000000000,Block 2008, Block Group 2, Census Tract 103.08, Fulton County, Georgia,0,0,0,0,0,0,0,0
-1,131210103082012.000000000000000,Block 2012, Block Group 2, Census Tract 103.08, Fulton County, Georgia,0,0,0,0,0,0,0,0
-1,131210103082013.000000000000000,Block 2013, Block Group 2, Census Tract 103.08, Fulton County, Georgia,0,0,0,0,0,0,0,0
-1,131210103082016.000000000000000,Block 2016, Block Group 2, Census Tract 103.08, Fulton County, Georgia,0,0,0,0,0,0,0,0
-1,131210103082017.000000000000000,Block 2017, Block Group 2, Census Tract 103.08, Fulton County, Georgia,0,0,0,0,0,0,0,0
-1,131210103082018.000000000000000,Block 2018, Block Group 2, Census Tract 103.08, Fulton County, Georgia,0,0,0,0,0,0,0,0
-1,131210103082019.000000000000000,Block 2019, Block Group 2, Census Tract 103.08, Fulton County, Georgia,0,0,0,0,0,0,0,0
-1,131210103082020.000000000000000,Block 2020, Block Group 2, Census Tract 103.08, Fulton County, Georgia,0,0,0,0,0,0,0,0
-1,131210103082023.000000000000000,Block 2023, Block Group 2, Census Tract 103.08, Fulton County, Georgia,0,0,0,0,0,0,0,0
-1,131210103082026.000000000000000,Block 2026, Block Group 2, Census Tract 103.08, Fulton County, Georgia,0,0,0,0,0,0,0,0
-1,131210103083010.000000000000000,Block 3010, Block Group 3, Census Tract 103.08, Fulton County, Georgia,0,0,0,0,0,0,0,0
-1,131210103083017.000000000000000,Block 3017, Block Group 3, Census Tract 103.08, Fulton County, Georgia,0,0,0,0,0,0,0,0
-1,131210103091000.000000000000000,Block 1000, Block Group 1, Census Tract 103.09, Fulton County, Georgia,0,0,0,0,0,0,0,0
-1,131210103091003.000000000000000,Block 1003, Block Group 1, Census Tract 103.09, Fulton County, Georgia,0,0,0,0,0,0,0,0
-1,131210103091016.000000000000000,Block 1016, Block Group 1, Census Tract 103.09, Fulton County, Georgia,0,0,0,0,0,0,0,0
-1,131210103091020.000000000000000,Block 1020, Block Group 1, Census Tract 103.09, Fulton County, Georgia,0,0,0,0,0,0,0,0
-1,131210103091021.000000000000000,Block 1021, Block Group 1, Census Tract 103.09, Fulton County, Georgia,0,0,0,0,0,0,0,0
-1,131210103091022.000000000000000,Block 1022, Block Group 1, Census Tract 103.09, Fulton County, Georgia,0,0,0,0,0,0,0,0
-1,131210103091023.000000000000000,Block 1023, Block Group 1, Census Tract 103.09, Fulton County, Georgia,0,0,0,0,0,0,0,0
-1,131210103091028.000000000000000,Block 1028, Block Group 1, Census Tract 103.09, Fulton County, Georgia,0,0,0,0,0,0,0,0
-1,131210103091029.000000000000000,Block 1029, Block Group 1, Census Tract 103.09, Fulton County, Georgia,0,0,0,0,0,0,0,0
-1,131210103091030.000000000000000,Block 1030, Block Group 1, Census Tract 103.09, Fulton County, Georgia,0,0,0,0,0,0,0,0
-1,131210103091031.000000000000000,Block 1031, Block Group 1, Census Tract 103.09, Fulton County, Georgia,0,0,0,0,0,0,0,0
-1,131210103092001.000000000000000,Block 2001, Block Group 2, Census Tract 103.09, Fulton County, Georgia,0,0,0,0,0,0,0,0
-1,131210103092002.000000000000000,Block 2002, Block Group 2, Census Tract 103.09, Fulton County, Georgia,0,0,0,0,0,0,0,0
-1,131210103092003.000000000000000,Block 2003, Block Group 2, Census Tract 103.09, Fulton County, Georgia,0,0,0,0,0,0,0,0
-1,131210103092004.000000000000000,Block 2004, Block Group 2, Census Tract 103.09, Fulton County, Georgia,0,0,0,0,0,0,0,0
-1,131210103092005.000000000000000,Block 2005, Block Group 2, Census Tract 103.09, Fulton County, Georgia,0,0,0,0,0,0,0,0
-1,131210103092007.000000000000000,Block 2007, Block Group 2, Census Tract 103.09, Fulton County, Georgia,0,0,0,0,0,0,0,0
-1,131210103092009.000000000000000,Block 2009, Block Group 2, Census Tract 103.09, Fulton County, Georgia,0,0,0,0,0,0,0,0
-1,131210103092010.000000000000000,Block 2010, Block Group 2, Census Tract 103.09, Fulton County, Georgia,0,0,0,0,0,0,0,0
-1,131210103092012.000000000000000,Block 2012, Block Group 2, Census Tract 103.09, Fulton County, Georgia,0,0,0,0,0,0,0,0
-1,131210103092015.000000000000000,Block 2015, Block Group 2, Census Tract 103.09, Fulton County, Georgia,0,0,0,0,0,0,0,0
-1,131210103092027.000000000000000,Block 2027, Block Group 2, Census Tract 103.09, Fulton County, Georgia,0,0,0,0,0,0,0,0
-1,131210103092028.000000000000000,Block 2028, Block Group 2, Census Tract 103.09, Fulton County, Georgia,0,0,0,0,0,0,0,0
-1,131210103092029.000000000000000,Block 2029, Block Group 2, Census Tract 103.09, Fulton County, Georgia,0,0,0,0,0,0,0,0
-1,131210103092030.000000000000000,Block 2030, Block Group 2, Census Tract 103.09, Fulton County, Georgia,0,0,0,0,0,0,0,0
-1,131210103093002.000000000000000,Block 3002, Block Group 3, Census Tract 103.09, Fulton County, Georgia,0,0,0,0,0,0,0,0
-1,131210103093006.000000000000000,Block 3006, Block Group 3, Census Tract 103.09, Fulton County, Georgia,0,0,0,0,0,0,0,0
-1,131210103101007.000000000000000,Block 1007, Block Group 1, Census Tract 103.10, Fulton County, Georgia,0,0,0,0,0,0,0,0
-1,131210103102001.000000000000000,Block 2001, Block Group 2, Census Tract 103.10, Fulton County, Georgia,0,0,0,0,0,0,0,0
-1,131210103103012.000000000000000,Block 3012, Block Group 3, Census Tract 103.10, Fulton County, Georgia,0,0,0,0,0,0,0,0
-1,131210103111004.000000000000000,Block 1004, Block Group 1, Census Tract 103.11, Fulton County, Georgia,0,0,0,0,0,0,0,0
-1,131210103111008.000000000000000,Block 1008, Block Group 1, Census Tract 103.11, Fulton County, Georgia,0,0,0,0,0,0,0,0
-1,131210103111009.000000000000000,Block 1009, Block Group 1, Census Tract 103.11, Fulton County, Georgia,0,0,0,0,0,0,0,0
-1,131210103111010.000000000000000,Block 1010, Block Group 1, Census Tract 103.11, Fulton County, Georgia,0,0,0,0,0,0,0,0
-1,131210103111011.000000000000000,Block 1011, Block Group 1, Census Tract 103.11, Fulton County, Georgia,0,0,0,0,0,0,0,0
-1,131210103111017.000000000000000,Block 1017, Block Group 1, Census Tract 103.11, Fulton County, Georgia,0,0,0,0,0,0,0,0
-1,131210103111018.000000000000000,Block 1018, Block Group 1, Census Tract 103.11, Fulton County, Georgia,0,0,0,0,0,0,0,0
-1,131210103111019.000000000000000,Block 1019, Block Group 1, Census Tract 103.11, Fulton County, Georgia,0,0,0,0,0,0,0,0
-1,131210103111025.000000000000000,Block 1025, Block Group 1, Census Tract 103.11, Fulton County, Georgia,0,0,0,0,0,0,0,0
-1,131210103111026.000000000000000,Block 1026, Block Group 1, Census Tract 103.11, Fulton County, Georgia,0,0,0,0,0,0,0,0
-1,131210103112001.000000000000000,Block 2001, Block Group 2, Census Tract 103.11, Fulton County, Georgia,0,0,0,0,0,0,0,0
-1,131210103112002.000000000000000,Block 2002, Block Group 2, Census Tract 103.11, Fulton County, Georgia,0,0,0,0,0,0,0,0
-1,131210103112004.000000000000000,Block 2004, Block Group 2, Census Tract 103.11, Fulton County, Georgia,0,0,0,0,0,0,0,0
-1,131210103112012.000000000000000,Block 2012, Block Group 2, Census Tract 103.11, Fulton County, Georgia,0,0,0,0,0,0,0,0
-1,131210103121004.000000000000000,Block 1004, Block Group 1, Census Tract 103.12, Fulton County, Georgia,0,0,0,0,0,0,0,0
-1,131210103122000.000000000000000,Block 2000, Block Group 2, Census Tract 103.12, Fulton County, Georgia,0,0,0,0,0,0,0,0
-1,131210103122002.000000000000000,Block 2002, Block Group 2, Census Tract 103.12, Fulton County, Georgia,0,0,0,0,0,0,0,0
-1,131210103122003.000000000000000,Block 2003, Block Group 2, Census Tract 103.12, Fulton County, Georgia,0,0,0,0,0,0,0,0
-1,131210103122004.000000000000000,Block 2004, Block Group 2, Census Tract 103.12, Fulton County, Georgia,0,0,0,0,0,0,0,0
-1,131210103122005.000000000000000,Block 2005, Block Group 2, Census Tract 103.12, Fulton County, Georgia,0,0,0,0,0,0,0,0
-1,131210103122006.000000000000000,Block 2006, Block Group 2, Census Tract 103.12, Fulton County, Georgia,0,0,0,0,0,0,0,0
-1,131210103122007.000000000000000,Block 2007, Block Group 2, Census Tract 103.12, Fulton County, Georgia,0,0,0,0,0,0,0,0
-1,131210103122008.000000000000000,Block 2008, Block Group 2, Census Tract 103.12, Fulton County, Georgia,0,0,0,0,0,0,0,0
-1,131210103122009.000000000000000,Block 2009, Block Group 2, Census Tract 103.12, Fulton County, Georgia,0,0,0,0,0,0,0,0
-1,131210103122010.000000000000000,Block 2010, Block Group 2, Census Tract 103.12, Fulton County, Georgia,0,0,0,0,0,0,0,0
-1,131210103122011.000000000000000,Block 2011, Block Group 2, Census Tract 103.12, Fulton County, Georgia,0,0,0,0,0,0,0,0
-1,131210103122012.000000000000000,Block 2012, Block Group 2, Census Tract 103.12, Fulton County, Georgia,0,0,0,0,0,0,0,0
-1,131210103122013.000000000000000,Block 2013, Block Group 2, Census Tract 103.12, Fulton County, Georgia,0,0,0,0,0,0,0,0
-1,131210103122014.000000000000000,Block 2014, Block Group 2, Census Tract 103.12, Fulton County, Georgia,0,0,0,0,0,0,0,0
-1,131210103122015.000000000000000,Block 2015, Block Group 2, Census Tract 103.12, Fulton County, Georgia,0,0,0,0,0,0,0,0
-1,131210103122016.000000000000000,Block 2016, Block Group 2, Census Tract 103.12, Fulton County, Georgia,0,0,0,0,0,0,0,0
-1,131210103122023.000000000000000,Block 2023, Block Group 2, Census Tract 103.12, Fulton County, Georgia,0,0,0,0,0,0,0,0
-1,131210103122024.000000000000000,Block 2024, Block Group 2, Census Tract 103.12, Fulton County, Georgia,0,0,0,0,0,0,0,0
-1,131210103122025.000000000000000,Block 2025, Block Group 2, Census Tract 103.12, Fulton County, Georgia,0,0,0,0,0,0,0,0
-1,131210103122029.000000000000000,Block 2029, Block Group 2, Census Tract 103.12, Fulton County, Georgia,0,0,0,0,0,0,0,0
-1,131210103122030.000000000000000,Block 2030, Block Group 2, Census Tract 103.12, Fulton County, Georgia,0,0,0,0,0,0,0,0
-1,131210103122031.000000000000000,Block 2031, Block Group 2, Census Tract 103.12, Fulton County, Georgia,0,0,0,0,0,0,0,0
-1,131210103122032.000000000000000,Block 2032, Block Group 2, Census Tract 103.12, Fulton County, Georgia,0,0,0,0,0,0,0,0
-1,131210103122033.000000000000000,Block 2033, Block Group 2, Census Tract 103.12, Fulton County, Georgia,0,0,0,0,0,0,0,0
-1,131210103122036.000000000000000,Block 2036, Block Group 2, Census Tract 103.12, Fulton County, Georgia,0,0,0,0,0,0,0,0
-1,131210103122037.000000000000000,Block 2037, Block Group 2, Census Tract 103.12, Fulton County, Georgia,0,0,0,0,0,0,0,0
-1,131210103122038.000000000000000,Block 2038, Block Group 2, Census Tract 103.12, Fulton County, Georgia,0,0,0,0,0,0,0,0
-1,131210103131009.000000000000000,Block 1009, Block Group 1, Census Tract 103.13, Fulton County, Georgia,0,0,0,0,0,0,0,0
-1,131210103131015.000000000000000,Block 1015, Block Group 1, Census Tract 103.13, Fulton County, Georgia,0,0,0,0,0,0,0,0
-1,131210103131016.000000000000000,Block 1016, Block Group 1, Census Tract 103.13, Fulton County, Georgia,0,0,0,0,0,0,0,0
-1,131210103131017.000000000000000,Block 1017, Block Group 1, Census Tract 103.13, Fulton County, Georgia,0,0,0,0,0,0,0,0
-1,131210103131018.000000000000000,Block 1018, Block Group 1, Census Tract 103.13, Fulton County, Georgia,0,0,0,0,0,0,0,0
-1,131210103131020.000000000000000,Block 1020, Block Group 1, Census Tract 103.13, Fulton County, Georgia,0,0,0,0,0,0,0,0
-1,131210103131023.000000000000000,Block 1023, Block Group 1, Census Tract 103.13, Fulton County, Georgia,0,0,0,0,0,0,0,0
-1,131210103131024.000000000000000,Block 1024, Block Group 1, Census Tract 103.13, Fulton County, Georgia,0,0,0,0,0,0,0,0
-1,131210103132003.000000000000000,Block 2003, Block Group 2, Census Tract 103.13, Fulton County, Georgia,0,0,0,0,0,0,0,0
-1,131210103133000.000000000000000,Block 3000, Block Group 3, Census Tract 103.13, Fulton County, Georgia,0,0,0,0,0,0,0,0
-1,131210103133001.000000000000000,Block 3001, Block Group 3, Census Tract 103.13, Fulton County, Georgia,0,0,0,0,0,0,0,0
-1,131210103133002.000000000000000,Block 3002, Block Group 3, Census Tract 103.13, Fulton County, Georgia,0,0,0,0,0,0,0,0
-1,131210103133003.000000000000000,Block 3003, Block Group 3, Census Tract 103.13, Fulton County, Georgia,0,0,0,0,0,0,0,0
-1,131210103133004.000000000000000,Block 3004, Block Group 3, Census Tract 103.13, Fulton County, Georgia,0,0,0,0,0,0,0,0
-1,131210103133005.000000000000000,Block 3005, Block Group 3, Census Tract 103.13, Fulton County, Georgia,0,0,0,0,0,0,0,0
-1,131210103133006.000000000000000,Block 3006, Block Group 3, Census Tract 103.13, Fulton County, Georgia,0,0,0,0,0,0,0,0
-1,131210103133007.000000000000000,Block 3007, Block Group 3, Census Tract 103.13, Fulton County, Georgia,0,0,0,0,0,0,0,0
-1,131210103133008.000000000000000,Block 3008, Block Group 3, Census Tract 103.13, Fulton County, Georgia,0,0,0,0,0,0,0,0
-1,131210103133009.000000000000000,Block 3009, Block Group 3, Census Tract 103.13, Fulton County, Georgia,0,0,0,0,0,0,0,0
-1,131210103133010.000000000000000,Block 3010, Block Group 3, Census Tract 103.13, Fulton County, Georgia,0,0,0,0,0,0,0,0
-1,131210103133011.000000000000000,Block 3011, Block Group 3, Census Tract 103.13, Fulton County, Georgia,0,0,0,0,0,0,0,0
-1,131210103133012.000000000000000,Block 3012, Block Group 3, Census Tract 103.13, Fulton County, Georgia,0,0,0,0,0,0,0,0
-1,131210103133014.000000000000000,Block 3014, Block Group 3, Census Tract 103.13, Fulton County, Georgia,0,0,0,0,0,0,0,0
-1,131210103133015.000000000000000,Block 3015, Block Group 3, Census Tract 103.13, Fulton County, Georgia,0,0,0,0,0,0,0,0
-1,131210103133016.000000000000000,Block 3016, Block Group 3, Census Tract 103.13, Fulton County, Georgia,0,0,0,0,0,0,0,0
-1,131210103133017.000000000000000,Block 3017, Block Group 3, Census Tract 103.13, Fulton County, Georgia,0,0,0,0,0,0,0,0
-1,131210103133022.000000000000000,Block 3022, Block Group 3, Census Tract 103.13, Fulton County, Georgia,0,0,0,0,0,0,0,0
-1,131210103133023.000000000000000,Block 3023, Block Group 3, Census Tract 103.13, Fulton County, Georgia,0,0,0,0,0,0,0,0
-1,131210103133024.000000000000000,Block 3024, Block Group 3, Census Tract 103.13, Fulton County, Georgia,0,0,0,0,0,0,0,0
-1,131210103133025.000000000000000,Block 3025, Block Group 3, Census Tract 103.13, Fulton County, Georgia,0,0,0,0,0,0,0,0
-1,131210103133026.000000000000000,Block 3026, Block Group 3, Census Tract 103.13, Fulton County, Georgia,0,0,0,0,0,0,0,0
-1,131210103133027.000000000000000,Block 3027, Block Group 3, Census Tract 103.13, Fulton County, Georgia,0,0,0,0,0,0,0,0
-1,131210103133028.000000000000000,Block 3028, Block Group 3, Census Tract 103.13, Fulton County, Georgia,0,0,0,0,0,0,0,0
-1,131210103133029.000000000000000,Block 3029, Block Group 3, Census Tract 103.13, Fulton County, Georgia,0,0,0,0,0,0,0,0
-1,131210103142005.000000000000000,Block 2005, Block Group 2, Census Tract 103.14, Fulton County, Georgia,0,0,0,0,0,0,0,0
-1,131210103152009.000000000000000,Block 2009, Block Group 2, Census Tract 103.15, Fulton County, Georgia,0,0,0,0,0,0,0,0
-1,131210103152010.000000000000000,Block 2010, Block Group 2, Census Tract 103.15, Fulton County, Georgia,0,0,0,0,0,0,0,0
-1,131210103152011.000000000000000,Block 2011, Block Group 2, Census Tract 103.15, Fulton County, Georgia,0,0,0,0,0,0,0,0
-1,131210103152012.000000000000000,Block 2012, Block Group 2, Census Tract 103.15, Fulton County, Georgia,0,0,0,0,0,0,0,0
-1,131210103152013.000000000000000,Block 2013, Block Group 2, Census Tract 103.15, Fulton County, Georgia,0,0,0,0,0,0,0,0
-1,131210103152014.000000000000000,Block 2014, Block Group 2, Census Tract 103.15, Fulton County, Georgia,0,0,0,0,0,0,0,0
-1,131210103152015.000000000000000,Block 2015, Block Group 2, Census Tract 103.15, Fulton County, Georgia,0,0,0,0,0,0,0,0
-1,131210103152016.000000000000000,Block 2016, Block Group 2, Census Tract 103.15, Fulton County, Georgia,0,0,0,0,0,0,0,0
-1,131210103152017.000000000000000,Block 2017, Block Group 2, Census Tract 103.15, Fulton County, Georgia,0,0,0,0,0,0,0,0
-1,131210103152018.000000000000000,Block 2018, Block Group 2, Census Tract 103.15, Fulton County, Georgia,0,0,0,0,0,0,0,0
-1,131210103152019.000000000000000,Block 2019, Block Group 2, Census Tract 103.15, Fulton County, Georgia,0,0,0,0,0,0,0,0
-1,131210103152020.000000000000000,Block 2020, Block Group 2, Census Tract 103.15, Fulton County, Georgia,0,0,0,0,0,0,0,0
-1,131210103152021.000000000000000,Block 2021, Block Group 2, Census Tract 103.15, Fulton County, Georgia,0,0,0,0,0,0,0,0
-1,131210103153007.000000000000000,Block 3007, Block Group 3, Census Tract 103.15, Fulton County, Georgia,0,0,0,0,0,0,0,0
-1,131210104011000.000000000000000,Block 1000, Block Group 1, Census Tract 104.01, Fulton County, Georgia,0,0,0,0,0,0,0,0
-1,131210104011001.000000000000000,Block 1001, Block Group 1, Census Tract 104.01, Fulton County, Georgia,0,0,0,0,0,0,0,0
-1,131210104011003.000000000000000,Block 1003, Block Group 1, Census Tract 104.01, Fulton County, Georgia,0,0,0,0,0,0,0,0
-1,131210104011006.000000000000000,Block 1006, Block Group 1, Census Tract 104.01, Fulton County, Georgia,0,0,0,0,0,0,0,0
-1,131210104011007.000000000000000,Block 1007, Block Group 1, Census Tract 104.01, Fulton County, Georgia,0,0,0,0,0,0,0,0
-1,131210104011008.000000000000000,Block 1008, Block Group 1, Census Tract 104.01, Fulton County, Georgia,0,0,0,0,0,0,0,0
-1,131210104011009.000000000000000,Block 1009, Block Group 1, Census Tract 104.01, Fulton County, Georgia,0,0,0,0,0,0,0,0
-1,131210104011011.000000000000000,Block 1011, Block Group 1, Census Tract 104.01, Fulton County, Georgia,0,0,0,0,0,0,0,0
-1,131210104011013.000000000000000,Block 1013, Block Group 1, Census Tract 104.01, Fulton County, Georgia,0,0,0,0,0,0,0,0
-1,131210104011015.000000000000000,Block 1015, Block Group 1, Census Tract 104.01, Fulton County, Georgia,0,0,0,0,0,0,0,0
-1,131210104011016.000000000000000,Block 1016, Block Group 1, Census Tract 104.01, Fulton County, Georgia,0,0,0,0,0,0,0,0
-1,131210104011017.000000000000000,Block 1017, Block Group 1, Census Tract 104.01, Fulton County, Georgia,0,0,0,0,0,0,0,0
-1,131210104011018.000000000000000,Block 1018, Block Group 1, Census Tract 104.01, Fulton County, Georgia,0,0,0,0,0,0,0,0
-1,131210104011023.000000000000000,Block 1023, Block Group 1, Census Tract 104.01, Fulton County, Georgia,0,0,0,0,0,0,0,0
-1,131210104011026.000000000000000,Block 1026, Block Group 1, Census Tract 104.01, Fulton County, Georgia,0,0,0,0,0,0,0,0
-1,131210104011034.000000000000000,Block 1034, Block Group 1, Census Tract 104.01, Fulton County, Georgia,0,0,0,0,0,0,0,0
-1,131210104011035.000000000000000,Block 1035, Block Group 1, Census Tract 104.01, Fulton County, Georgia,0,0,0,0,0,0,0,0
-1,131210104011036.000000000000000,Block 1036, Block Group 1, Census Tract 104.01, Fulton County, Georgia,0,0,0,0,0,0,0,0
-1,131210104011043.000000000000000,Block 1043, Block Group 1, Census Tract 104.01, Fulton County, Georgia,0,0,0,0,0,0,0,0
-1,131210104012002.000000000000000,Block 2002, Block Group 2, Census Tract 104.01, Fulton County, Georgia,0,0,0,0,0,0,0,0
-1,131210104012003.000000000000000,Block 2003, Block Group 2, Census Tract 104.01, Fulton County, Georgia,0,0,0,0,0,0,0,0
-1,131210104012007.000000000000000,Block 2007, Block Group 2, Census Tract 104.01, Fulton County, Georgia,0,0,0,0,0,0,0,0
-1,131210104013010.000000000000000,Block 3010, Block Group 3, Census Tract 104.01, Fulton County, Georgia,0,0,0,0,0,0,0,0
-1,131210104013014.000000000000000,Block 3014, Block Group 3, Census Tract 104.01, Fulton County, Georgia,0,0,0,0,0,0,0,0
-1,131210104013015.000000000000000,Block 3015, Block Group 3, Census Tract 104.01, Fulton County, Georgia,0,0,0,0,0,0,0,0
-1,131210104013023.000000000000000,Block 3023, Block Group 3, Census Tract 104.01, Fulton County, Georgia,0,0,0,0,0,0,0,0
-1,131210104013024.000000000000000,Block 3024, Block Group 3, Census Tract 104.01, Fulton County, Georgia,0,0,0,0,0,0,0,0
-1,131210104013025.000000000000000,Block 3025, Block Group 3, Census Tract 104.01, Fulton County, Georgia,0,0,0,0,0,0,0,0
-1,131210104013026.000000000000000,Block 3026, Block Group 3, Census Tract 104.01, Fulton County, Georgia,0,0,0,0,0,0,0,0
-1,131210104013027.000000000000000,Block 3027, Block Group 3, Census Tract 104.01, Fulton County, Georgia,0,0,0,0,0,0,0,0
-1,131210104013028.000000000000000,Block 3028, Block Group 3, Census Tract 104.01, Fulton County, Georgia,0,0,0,0,0,0,0,0
-1,131210104013042.000000000000000,Block 3042, Block Group 3, Census Tract 104.01, Fulton County, Georgia,0,0,0,0,0,0,0,0
-1,131210104013043.000000000000000,Block 3043, Block Group 3, Census Tract 104.01, Fulton County, Georgia,0,0,0,0,0,0,0,0
-1,131210104021001.000000000000000,Block 1001, Block Group 1, Census Tract 104.02, Fulton County, Georgia,0,0,0,0,0,0,0,0
-1,131210104021002.000000000000000,Block 1002, Block Group 1, Census Tract 104.02, Fulton County, Georgia,0,0,0,0,0,0,0,0
-1,131210104021007.000000000000000,Block 1007, Block Group 1, Census Tract 104.02, Fulton County, Georgia,0,0,0,0,0,0,0,0
-1,131210104021017.000000000000000,Block 1017, Block Group 1, Census Tract 104.02, Fulton County, Georgia,0,0,0,0,0,0,0,0
-1,131210104021027.000000000000000,Block 1027, Block Group 1, Census Tract 104.02, Fulton County, Georgia,0,0,0,0,0,0,0,0
-1,131210104021028.000000000000000,Block 1028, Block Group 1, Census Tract 104.02, Fulton County, Georgia,0,0,0,0,0,0,0,0
-1,131210104021035.000000000000000,Block 1035, Block Group 1, Census Tract 104.02, Fulton County, Georgia,0,0,0,0,0,0,0,0
-1,131210104021037.000000000000000,Block 1037, Block Group 1, Census Tract 104.02, Fulton County, Georgia,0,0,0,0,0,0,0,0
-1,131210104021039.000000000000000,Block 1039, Block Group 1, Census Tract 104.02, Fulton County, Georgia,0,0,0,0,0,0,0,0
-1,131210104021042.000000000000000,Block 1042, Block Group 1, Census Tract 104.02, Fulton County, Georgia,0,0,0,0,0,0,0,0
-1,131210104021046.000000000000000,Block 1046, Block Group 1, Census Tract 104.02, Fulton County, Georgia,0,0,0,0,0,0,0,0
-1,131210104021047.000000000000000,Block 1047, Block Group 1, Census Tract 104.02, Fulton County, Georgia,0,0,0,0,0,0,0,0
-1,131210104021048.000000000000000,Block 1048, Block Group 1, Census Tract 104.02, Fulton County, Georgia,0,0,0,0,0,0,0,0
-1,131210104021050.000000000000000,Block 1050, Block Group 1, Census Tract 104.02, Fulton County, Georgia,0,0,0,0,0,0,0,0
-1,131210104021053.000000000000000,Block 1053, Block Group 1, Census Tract 104.02, Fulton County, Georgia,0,0,0,0,0,0,0,0
-1,131210104022003.000000000000000,Block 2003, Block Group 2, Census Tract 104.02, Fulton County, Georgia,0,0,0,0,0,0,0,0
-1,131210104022005.000000000000000,Block 2005, Block Group 2, Census Tract 104.02, Fulton County, Georgia,0,0,0,0,0,0,0,0
-1,131210104022006.000000000000000,Block 2006, Block Group 2, Census Tract 104.02, Fulton County, Georgia,0,0,0,0,0,0,0,0
-1,131210104022007.000000000000000,Block 2007, Block Group 2, Census Tract 104.02, Fulton County, Georgia,0,0,0,0,0,0,0,0
-1,131210104022012.000000000000000,Block 2012, Block Group 2, Census Tract 104.02, Fulton County, Georgia,0,0,0,0,0,0,0,0
-1,131210104022013.000000000000000,Block 2013, Block Group 2, Census Tract 104.02, Fulton County, Georgia,0,0,0,0,0,0,0,0
-1,131210104022015.000000000000000,Block 2015, Block Group 2, Census Tract 104.02, Fulton County, Georgia,0,0,0,0,0,0,0,0
-1,131210104022016.000000000000000,Block 2016, Block Group 2, Census Tract 104.02, Fulton County, Georgia,0,0,0,0,0,0,0,0
-1,131210104022023.000000000000000,Block 2023, Block Group 2, Census Tract 104.02, Fulton County, Georgia,0,0,0,0,0,0,0,0
-1,131210104022024.000000000000000,Block 2024, Block Group 2, Census Tract 104.02, Fulton County, Georgia,0,0,0,0,0,0,0,0
-1,131210104022025.000000000000000,Block 2025, Block Group 2, Census Tract 104.02, Fulton County, Georgia,0,0,0,0,0,0,0,0
-1,131210104022026.000000000000000,Block 2026, Block Group 2, Census Tract 104.02, Fulton County, Georgia,0,0,0,0,0,0,0,0
-1,131210104022028.000000000000000,Block 2028, Block Group 2, Census Tract 104.02, Fulton County, Georgia,0,0,0,0,0,0,0,0
-1,131210104022029.000000000000000,Block 2029, Block Group 2, Census Tract 104.02, Fulton County, Georgia,0,0,0,0,0,0,0,0
-1,131210104022031.000000000000000,Block 2031, Block Group 2, Census Tract 104.02, Fulton County, Georgia,0,0,0,0,0,0,0,0
-1,131210104022032.000000000000000,Block 2032, Block Group 2, Census Tract 104.02, Fulton County, Georgia,0,0,0,0,0,0,0,0
-1,131210104022033.000000000000000,Block 2033, Block Group 2, Census Tract 104.02, Fulton County, Georgia,0,0,0,0,0,0,0,0
-1,131210104022034.000000000000000,Block 2034, Block Group 2, Census Tract 104.02, Fulton County, Georgia,0,0,0,0,0,0,0,0
-1,131210104022035.000000000000000,Block 2035, Block Group 2, Census Tract 104.02, Fulton County, Georgia,0,0,0,0,0,0,0,0
-1,131210104022039.000000000000000,Block 2039, Block Group 2, Census Tract 104.02, Fulton County, Georgia,0,0,0,0,0,0,0,0
-1,131210104022040.000000000000000,Block 2040, Block Group 2, Census Tract 104.02, Fulton County, Georgia,0,0,0,0,0,0,0,0
-1,131210104022046.000000000000000,Block 2046, Block Group 2, Census Tract 104.02, Fulton County, Georgia,0,0,0,0,0,0,0,0
-1,131210104022047.000000000000000,Block 2047, Block Group 2, Census Tract 104.02, Fulton County, Georgia,0,0,0,0,0,0,0,0
-1,131210104022048.000000000000000,Block 2048, Block Group 2, Census Tract 104.02, Fulton County, Georgia,0,0,0,0,0,0,0,0
-1,131210104022052.000000000000000,Block 2052, Block Group 2, Census Tract 104.02, Fulton County, Georgia,0,0,0,0,0,0,0,0
-1,131210104022056.000000000000000,Block 2056, Block Group 2, Census Tract 104.02, Fulton County, Georgia,0,0,0,0,0,0,0,0
-1,131210104022057.000000000000000,Block 2057, Block Group 2, Census Tract 104.02, Fulton County, Georgia,0,0,0,0,0,0,0,0
-1,131210104022058.000000000000000,Block 2058, Block Group 2, Census Tract 104.02, Fulton County, Georgia,0,0,0,0,0,0,0,0
-1,131210104022061.000000000000000,Block 2061, Block Group 2, Census Tract 104.02, Fulton County, Georgia,0,0,0,0,0,0,0,0
-1,131210104022062.000000000000000,Block 2062, Block Group 2, Census Tract 104.02, Fulton County, Georgia,0,0,0,0,0,0,0,0
-1,131210104022063.000000000000000,Block 2063, Block Group 2, Census Tract 104.02, Fulton County, Georgia,0,0,0,0,0,0,0,0
-1,131210104022064.000000000000000,Block 2064, Block Group 2, Census Tract 104.02, Fulton County, Georgia,0,0,0,0,0,0,0,0
-1,131210104022068.000000000000000,Block 2068, Block Group 2, Census Tract 104.02, Fulton County, Georgia,0,0,0,0,0,0,0,0
-1,131210104023001.000000000000000,Block 3001, Block Group 3, Census Tract 104.02, Fulton County, Georgia,0,0,0,0,0,0,0,0
-1,131210104023002.000000000000000,Block 3002, Block Group 3, Census Tract 104.02, Fulton County, Georgia,0,0,0,0,0,0,0,0
-1,131210104023008.000000000000000,Block 3008, Block Group 3, Census Tract 104.02, Fulton County, Georgia,0,0,0,0,0,0,0,0
-1,131210104023015.000000000000000,Block 3015, Block Group 3, Census Tract 104.02, Fulton County, Georgia,0,0,0,0,0,0,0,0
-1,131210104023017.000000000000000,Block 3017, Block Group 3, Census Tract 104.02, Fulton County, Georgia,0,0,0,0,0,0,0,0
-1,131210104023018.000000000000000,Block 3018, Block Group 3, Census Tract 104.02, Fulton County, Georgia,0,0,0,0,0,0,0,0
-1,131210104023025.000000000000000,Block 3025, Block Group 3, Census Tract 104.02, Fulton County, Georgia,0,0,0,0,0,0,0,0
-1,131210104023026.000000000000000,Block 3026, Block Group 3, Census Tract 104.02, Fulton County, Georgia,0,0,0,0,0,0,0,0
-1,131210104023028.000000000000000,Block 3028, Block Group 3, Census Tract 104.02, Fulton County, Georgia,0,0,0,0,0,0,0,0
-1,131210104023029.000000000000000,Block 3029, Block Group 3, Census Tract 104.02, Fulton County, Georgia,0,0,0,0,0,0,0,0
-1,131210104023030.000000000000000,Block 3030, Block Group 3, Census Tract 104.02, Fulton County, Georgia,0,0,0,0,0,0,0,0
-1,131210104023031.000000000000000,Block 3031, Block Group 3, Census Tract 104.02, Fulton County, Georgia,0,0,0,0,0,0,0,0
-1,131210104023034.000000000000000,Block 3034, Block Group 3, Census Tract 104.02, Fulton County, Georgia,0,0,0,0,0,0,0,0
-1,131210104023036.000000000000000,Block 3036, Block Group 3, Census Tract 104.02, Fulton County, Georgia,0,0,0,0,0,0,0,0
-1,131210104023037.000000000000000,Block 3037, Block Group 3, Census Tract 104.02, Fulton County, Georgia,0,0,0,0,0,0,0,0
-1,131210104023038.000000000000000,Block 3038, Block Group 3, Census Tract 104.02, Fulton County, Georgia,0,0,0,0,0,0,0,0
-1,131210104023040.000000000000000,Block 3040, Block Group 3, Census Tract 104.02, Fulton County, Georgia,0,0,0,0,0,0,0,0
-1,131210104023041.000000000000000,Block 3041, Block Group 3, Census Tract 104.02, Fulton County, Georgia,0,0,0,0,0,0,0,0
-1,131210104023042.000000000000000,Block 3042, Block Group 3, Census Tract 104.02, Fulton County, Georgia,0,0,0,0,0,0,0,0
-1,131210104023043.000000000000000,Block 3043, Block Group 3, Census Tract 104.02, Fulton County, Georgia,0,0,0,0,0,0,0,0
-1,131210104023044.000000000000000,Block 3044, Block Group 3, Census Tract 104.02, Fulton County, Georgia,0,0,0,0,0,0,0,0
-1,131210104023045.000000000000000,Block 3045, Block Group 3, Census Tract 104.02, Fulton County, Georgia,0,0,0,0,0,0,0,0
-1,131210104023046.000000000000000,Block 3046, Block Group 3, Census Tract 104.02, Fulton County, Georgia,0,0,0,0,0,0,0,0
-1,131210104023047.000000000000000,Block 3047, Block Group 3, Census Tract 104.02, Fulton County, Georgia,0,0,0,0,0,0,0,0
-1,131210104023049.000000000000000,Block 3049, Block Group 3, Census Tract 104.02, Fulton County, Georgia,0,0,0,0,0,0,0,0
-1,131210104023050.000000000000000,Block 3050, Block Group 3, Census Tract 104.02, Fulton County, Georgia,0,0,0,0,0,0,0,0
-1,131210104023056.000000000000000,Block 3056, Block Group 3, Census Tract 104.02, Fulton County, Georgia,0,0,0,0,0,0,0,0
-1,131210104023057.000000000000000,Block 3057, Block Group 3, Census Tract 104.02, Fulton County, Georgia,0,0,0,0,0,0,0,0
-1,131210104023058.000000000000000,Block 3058, Block Group 3, Census Tract 104.02, Fulton County, Georgia,0,0,0,0,0,0,0,0
-1,131210104023059.000000000000000,Block 3059, Block Group 3, Census Tract 104.02, Fulton County, Georgia,0,0,0,0,0,0,0,0
-1,131210104023065.000000000000000,Block 3065, Block Group 3, Census Tract 104.02, Fulton County, Georgia,0,0,0,0,0,0,0,0
-1,131210104023068.000000000000000,Block 3068, Block Group 3, Census Tract 104.02, Fulton County, Georgia,0,0,0,0,0,0,0,0
-1,131210105191006.000000000000000,Block 1006, Block Group 1, Census Tract 105.19, Fulton County, Georgia,0,0,0,0,0,0,0,0
-1,131210105191009.000000000000000,Block 1009, Block Group 1, Census Tract 105.19, Fulton County, Georgia,0,0,0,0,0,0,0,0
-1,131210105191010.000000000000000,Block 1010, Block Group 1, Census Tract 105.19, Fulton County, Georgia,0,0,0,0,0,0,0,0
-1,131210105191014.000000000000000,Block 1014, Block Group 1, Census Tract 105.19, Fulton County, Georgia,0,0,0,0,0,0,0,0
-1,131210105191018.000000000000000,Block 1018, Block Group 1, Census Tract 105.19, Fulton County, Georgia,0,0,0,0,0,0,0,0
-1,131210105191020.000000000000000,Block 1020, Block Group 1, Census Tract 105.19, Fulton County, Georgia,0,0,0,0,0,0,0,0
-1,131210105191021.000000000000000,Block 1021, Block Group 1, Census Tract 105.19, Fulton County, Georgia,0,0,0,0,0,0,0,0
-1,131210105191024.000000000000000,Block 1024, Block Group 1, Census Tract 105.19, Fulton County, Georgia,0,0,0,0,0,0,0,0
-1,131210105191025.000000000000000,Block 1025, Block Group 1, Census Tract 105.19, Fulton County, Georgia,0,0,0,0,0,0,0,0
-1,131210105191026.000000000000000,Block 1026, Block Group 1, Census Tract 105.19, Fulton County, Georgia,0,0,0,0,0,0,0,0
-1,131210105191029.000000000000000,Block 1029, Block Group 1, Census Tract 105.19, Fulton County, Georgia,0,0,0,0,0,0,0,0
-1,131210105191030.000000000000000,Block 1030, Block Group 1, Census Tract 105.19, Fulton County, Georgia,0,0,0,0,0,0,0,0
-1,131210105191031.000000000000000,Block 1031, Block Group 1, Census Tract 105.19, Fulton County, Georgia,0,0,0,0,0,0,0,0
-1,131210105191032.000000000000000,Block 1032, Block Group 1, Census Tract 105.19, Fulton County, Georgia,0,0,0,0,0,0,0,0
-1,131210105191034.000000000000000,Block 1034, Block Group 1, Census Tract 105.19, Fulton County, Georgia,0,0,0,0,0,0,0,0
-1,131210105191041.000000000000000,Block 1041, Block Group 1, Census Tract 105.19, Fulton County, Georgia,0,0,0,0,0,0,0,0
-1,131210105191047.000000000000000,Block 1047, Block Group 1, Census Tract 105.19, Fulton County, Georgia,0,0,0,0,0,0,0,0
-1,131210105191048.000000000000000,Block 1048, Block Group 1, Census Tract 105.19, Fulton County, Georgia,0,0,0,0,0,0,0,0
-1,131210105191049.000000000000000,Block 1049, Block Group 1, Census Tract 105.19, Fulton County, Georgia,0,0,0,0,0,0,0,0
-1,131210105191051.000000000000000,Block 1051, Block Group 1, Census Tract 105.19, Fulton County, Georgia,0,0,0,0,0,0,0,0
-1,131210105191052.000000000000000,Block 1052, Block Group 1, Census Tract 105.19, Fulton County, Georgia,0,0,0,0,0,0,0,0
-1,131210105191053.000000000000000,Block 1053, Block Group 1, Census Tract 105.19, Fulton County, Georgia,0,0,0,0,0,0,0,0
-1,131210105191054.000000000000000,Block 1054, Block Group 1, Census Tract 105.19, Fulton County, Georgia,0,0,0,0,0,0,0,0
-1,131210105191056.000000000000000,Block 1056, Block Group 1, Census Tract 105.19, Fulton County, Georgia,0,0,0,0,0,0,0,0
-1,131210105191057.000000000000000,Block 1057, Block Group 1, Census Tract 105.19, Fulton County, Georgia,0,0,0,0,0,0,0,0
-1,131210105191058.000000000000000,Block 1058, Block Group 1, Census Tract 105.19, Fulton County, Georgia,0,0,0,0,0,0,0,0
-1,131210105192006.000000000000000,Block 2006, Block Group 2, Census Tract 105.19, Fulton County, Georgia,0,0,0,0,0,0,0,0
-1,131210105201003.000000000000000,Block 1003, Block Group 1, Census Tract 105.20, Fulton County, Georgia,0,0,0,0,0,0,0,0
-1,131210105201004.000000000000000,Block 1004, Block Group 1, Census Tract 105.20, Fulton County, Georgia,0,0,0,0,0,0,0,0
-1,131210105201012.000000000000000,Block 1012, Block Group 1, Census Tract 105.20, Fulton County, Georgia,0,0,0,0,0,0,0,0
-1,131210105201017.000000000000000,Block 1017, Block Group 1, Census Tract 105.20, Fulton County, Georgia,0,0,0,0,0,0,0,0
-1,131210105201018.000000000000000,Block 1018, Block Group 1, Census Tract 105.20, Fulton County, Georgia,0,0,0,0,0,0,0,0
-1,131210105201019.000000000000000,Block 1019, Block Group 1, Census Tract 105.20, Fulton County, Georgia,0,0,0,0,0,0,0,0
-1,131210105201020.000000000000000,Block 1020, Block Group 1, Census Tract 105.20, Fulton County, Georgia,0,0,0,0,0,0,0,0
-1,131210105202010.000000000000000,Block 2010, Block Group 2, Census Tract 105.20, Fulton County, Georgia,0,0,0,0,0,0,0,0
-1,131210105202017.000000000000000,Block 2017, Block Group 2, Census Tract 105.20, Fulton County, Georgia,0,0,0,0,0,0,0,0
-1,131210105202020.000000000000000,Block 2020, Block Group 2, Census Tract 105.20, Fulton County, Georgia,0,0,0,0,0,0,0,0
-1,131210105203015.000000000000000,Block 3015, Block Group 3, Census Tract 105.20, Fulton County, Georgia,0,0,0,0,0,0,0,0
-1,131210105203020.000000000000000,Block 3020, Block Group 3, Census Tract 105.20, Fulton County, Georgia,0,0,0,0,0,0,0,0
-1,131210105203024.000000000000000,Block 3024, Block Group 3, Census Tract 105.20, Fulton County, Georgia,0,0,0,0,0,0,0,0
-1,131210105203025.000000000000000,Block 3025, Block Group 3, Census Tract 105.20, Fulton County, Georgia,0,0,0,0,0,0,0,0
-1,131210105203026.000000000000000,Block 3026, Block Group 3, Census Tract 105.20, Fulton County, Georgia,0,0,0,0,0,0,0,0
-1,131210105203027.000000000000000,Block 3027, Block Group 3, Census Tract 105.20, Fulton County, Georgia,0,0,0,0,0,0,0,0
-1,131210105203028.000000000000000,Block 3028, Block Group 3, Census Tract 105.20, Fulton County, Georgia,0,0,0,0,0,0,0,0
-1,131210105203029.000000000000000,Block 3029, Block Group 3, Census Tract 105.20, Fulton County, Georgia,0,0,0,0,0,0,0,0
-1,131210105203030.000000000000000,Block 3030, Block Group 3, Census Tract 105.20, Fulton County, Georgia,0,0,0,0,0,0,0,0
-1,131210105203031.000000000000000,Block 3031, Block Group 3, Census Tract 105.20, Fulton County, Georgia,0,0,0,0,0,0,0,0
-1,131210105203032.000000000000000,Block 3032, Block Group 3, Census Tract 105.20, Fulton County, Georgia,0,0,0,0,0,0,0,0
-1,131210105203034.000000000000000,Block 3034, Block Group 3, Census Tract 105.20, Fulton County, Georgia,0,0,0,0,0,0,0,0
-1,131210105203036.000000000000000,Block 3036, Block Group 3, Census Tract 105.20, Fulton County, Georgia,0,0,0,0,0,0,0,0
-1,131210105203037.000000000000000,Block 3037, Block Group 3, Census Tract 105.20, Fulton County, Georgia,0,0,0,0,0,0,0,0
-1,131210105203038.000000000000000,Block 3038, Block Group 3, Census Tract 105.20, Fulton County, Georgia,0,0,0,0,0,0,0,0
-1,131210105203039.000000000000000,Block 3039, Block Group 3, Census Tract 105.20, Fulton County, Georgia,0,0,0,0,0,0,0,0
-1,131210105203042.000000000000000,Block 3042, Block Group 3, Census Tract 105.20, Fulton County, Georgia,0,0,0,0,0,0,0,0
-1,131210105203043.000000000000000,Block 3043, Block Group 3, Census Tract 105.20, Fulton County, Georgia,0,0,0,0,0,0,0,0
-1,131210105203044.000000000000000,Block 3044, Block Group 3, Census Tract 105.20, Fulton County, Georgia,0,0,0,0,0,0,0,0
-1,131210105203045.000000000000000,Block 3045, Block Group 3, Census Tract 105.20, Fulton County, Georgia,0,0,0,0,0,0,0,0
-1,131210105203046.000000000000000,Block 3046, Block Group 3, Census Tract 105.20, Fulton County, Georgia,0,0,0,0,0,0,0,0
-1,131210105203047.000000000000000,Block 3047, Block Group 3, Census Tract 105.20, Fulton County, Georgia,0,0,0,0,0,0,0,0
-1,131210105203048.000000000000000,Block 3048, Block Group 3, Census Tract 105.20, Fulton County, Georgia,0,0,0,0,0,0,0,0
-1,131210105203049.000000000000000,Block 3049, Block Group 3, Census Tract 105.20, Fulton County, Georgia,0,0,0,0,0,0,0,0
-1,131210105203050.000000000000000,Block 3050, Block Group 3, Census Tract 105.20, Fulton County, Georgia,0,0,0,0,0,0,0,0
-1,131210105203052.000000000000000,Block 3052, Block Group 3, Census Tract 105.20, Fulton County, Georgia,0,0,0,0,0,0,0,0
-1,131210105203053.000000000000000,Block 3053, Block Group 3, Census Tract 105.20, Fulton County, Georgia,0,0,0,0,0,0,0,0
-1,131210105203054.000000000000000,Block 3054, Block Group 3, Census Tract 105.20, Fulton County, Georgia,0,0,0,0,0,0,0,0
-1,131210105203055.000000000000000,Block 3055, Block Group 3, Census Tract 105.20, Fulton County, Georgia,0,0,0,0,0,0,0,0
-1,131210105212006.000000000000000,Block 2006, Block Group 2, Census Tract 105.21, Fulton County, Georgia,0,0,0,0,0,0,0,0
-1,131210105212008.000000000000000,Block 2008, Block Group 2, Census Tract 105.21, Fulton County, Georgia,0,0,0,0,0,0,0,0
-1,131210105212009.000000000000000,Block 2009, Block Group 2, Census Tract 105.21, Fulton County, Georgia,0,0,0,0,0,0,0,0
-1,131210105212010.000000000000000,Block 2010, Block Group 2, Census Tract 105.21, Fulton County, Georgia,0,0,0,0,0,0,0,0
-1,131210105212016.000000000000000,Block 2016, Block Group 2, Census Tract 105.21, Fulton County, Georgia,0,0,0,0,0,0,0,0
-1,131210105212018.000000000000000,Block 2018, Block Group 2, Census Tract 105.21, Fulton County, Georgia,0,0,0,0,0,0,0,0
-1,131210105221000.000000000000000,Block 1000, Block Group 1, Census Tract 105.22, Fulton County, Georgia,0,0,0,0,0,0,0,0
-1,131210105221002.000000000000000,Block 1002, Block Group 1, Census Tract 105.22, Fulton County, Georgia,0,0,0,0,0,0,0,0
-1,131210105222000.000000000000000,Block 2000, Block Group 2, Census Tract 105.22, Fulton County, Georgia,0,0,0,0,0,0,0,0
-1,131210105222001.000000000000000,Block 2001, Block Group 2, Census Tract 105.22, Fulton County, Georgia,0,0,0,0,0,0,0,0
-1,131210105222002.000000000000000,Block 2002, Block Group 2, Census Tract 105.22, Fulton County, Georgia,0,0,0,0,0,0,0,0
-1,131210105222004.000000000000000,Block 2004, Block Group 2, Census Tract 105.22, Fulton County, Georgia,0,0,0,0,0,0,0,0
-1,131210105222006.000000000000000,Block 2006, Block Group 2, Census Tract 105.22, Fulton County, Georgia,0,0,0,0,0,0,0,0
-1,131210105222007.000000000000000,Block 2007, Block Group 2, Census Tract 105.22, Fulton County, Georgia,0,0,0,0,0,0,0,0
-1,131210105222008.000000000000000,Block 2008, Block Group 2, Census Tract 105.22, Fulton County, Georgia,0,0,0,0,0,0,0,0
-1,131210105222009.000000000000000,Block 2009, Block Group 2, Census Tract 105.22, Fulton County, Georgia,0,0,0,0,0,0,0,0
-1,131210105222010.000000000000000,Block 2010, Block Group 2, Census Tract 105.22, Fulton County, Georgia,0,0,0,0,0,0,0,0
-1,131210105222011.000000000000000,Block 2011, Block Group 2, Census Tract 105.22, Fulton County, Georgia,0,0,0,0,0,0,0,0
-1,131210105222012.000000000000000,Block 2012, Block Group 2, Census Tract 105.22, Fulton County, Georgia,0,0,0,0,0,0,0,0
-1,131210105222013.000000000000000,Block 2013, Block Group 2, Census Tract 105.22, Fulton County, Georgia,0,0,0,0,0,0,0,0
-1,131210105222014.000000000000000,Block 2014, Block Group 2, Census Tract 105.22, Fulton County, Georgia,0,0,0,0,0,0,0,0
-1,131210105222016.000000000000000,Block 2016, Block Group 2, Census Tract 105.22, Fulton County, Georgia,0,0,0,0,0,0,0,0
-1,131210105222017.000000000000000,Block 2017, Block Group 2, Census Tract 105.22, Fulton County, Georgia,0,0,0,0,0,0,0,0
-1,131210105222018.000000000000000,Block 2018, Block Group 2, Census Tract 105.22, Fulton County, Georgia,0,0,0,0,0,0,0,0
-1,131210105222019.000000000000000,Block 2019, Block Group 2, Census Tract 105.22, Fulton County, Georgia,0,0,0,0,0,0,0,0
-1,131210105222020.000000000000000,Block 2020, Block Group 2, Census Tract 105.22, Fulton County, Georgia,0,0,0,0,0,0,0,0
-1,131210105222021.000000000000000,Block 2021, Block Group 2, Census Tract 105.22, Fulton County, Georgia,0,0,0,0,0,0,0,0
-1,131210105222022.000000000000000,Block 2022, Block Group 2, Census Tract 105.22, Fulton County, Georgia,0,0,0,0,0,0,0,0
-1,131210105222023.000000000000000,Block 2023, Block Group 2, Census Tract 105.22, Fulton County, Georgia,0,0,0,0,0,0,0,0
-1,131210105222026.000000000000000,Block 2026, Block Group 2, Census Tract 105.22, Fulton County, Georgia,0,0,0,0,0,0,0,0
-1,131210105222029.000000000000000,Block 2029, Block Group 2, Census Tract 105.22, Fulton County, Georgia,0,0,0,0,0,0,0,0
-1,131210105222031.000000000000000,Block 2031, Block Group 2, Census Tract 105.22, Fulton County, Georgia,0,0,0,0,0,0,0,0
-1,131210105222035.000000000000000,Block 2035, Block Group 2, Census Tract 105.22, Fulton County, Georgia,0,0,0,0,0,0,0,0
-1,131210105222036.000000000000000,Block 2036, Block Group 2, Census Tract 105.22, Fulton County, Georgia,0,0,0,0,0,0,0,0
-1,131210105222037.000000000000000,Block 2037, Block Group 2, Census Tract 105.22, Fulton County, Georgia,0,0,0,0,0,0,0,0
-1,131210105222038.000000000000000,Block 2038, Block Group 2, Census Tract 105.22, Fulton County, Georgia,0,0,0,0,0,0,0,0
-1,131210105222039.000000000000000,Block 2039, Block Group 2, Census Tract 105.22, Fulton County, Georgia,0,0,0,0,0,0,0,0
-1,131210105222040.000000000000000,Block 2040, Block Group 2, Census Tract 105.22, Fulton County, Georgia,0,0,0,0,0,0,0,0
-1,131210105222041.000000000000000,Block 2041, Block Group 2, Census Tract 105.22, Fulton County, Georgia,0,0,0,0,0,0,0,0
-1,131210105222042.000000000000000,Block 2042, Block Group 2, Census Tract 105.22, Fulton County, Georgia,0,0,0,0,0,0,0,0
-1,131210105231000.000000000000000,Block 1000, Block Group 1, Census Tract 105.23, Fulton County, Georgia,0,0,0,0,0,0,0,0
-1,131210105231001.000000000000000,Block 1001, Block Group 1, Census Tract 105.23, Fulton County, Georgia,0,0,0,0,0,0,0,0
-1,131210105231002.000000000000000,Block 1002, Block Group 1, Census Tract 105.23, Fulton County, Georgia,0,0,0,0,0,0,0,0
-1,131210105231003.000000000000000,Block 1003, Block Group 1, Census Tract 105.23, Fulton County, Georgia,0,0,0,0,0,0,0,0
-1,131210105231004.000000000000000,Block 1004, Block Group 1, Census Tract 105.23, Fulton County, Georgia,0,0,0,0,0,0,0,0
-1,131210105231005.000000000000000,Block 1005, Block Group 1, Census Tract 105.23, Fulton County, Georgia,0,0,0,0,0,0,0,0
-1,131210105231006.000000000000000,Block 1006, Block Group 1, Census Tract 105.23, Fulton County, Georgia,0,0,0,0,0,0,0,0
-1,131210105231007.000000000000000,Block 1007, Block Group 1, Census Tract 105.23, Fulton County, Georgia,0,0,0,0,0,0,0,0
-1,131210105231008.000000000000000,Block 1008, Block Group 1, Census Tract 105.23, Fulton County, Georgia,0,0,0,0,0,0,0,0
-1,131210105231009.000000000000000,Block 1009, Block Group 1, Census Tract 105.23, Fulton County, Georgia,0,0,0,0,0,0,0,0
-1,131210105231010.000000000000000,Block 1010, Block Group 1, Census Tract 105.23, Fulton County, Georgia,0,0,0,0,0,0,0,0
-1,131210105231011.000000000000000,Block 1011, Block Group 1, Census Tract 105.23, Fulton County, Georgia,0,0,0,0,0,0,0,0
-1,131210105231012.000000000000000,Block 1012, Block Group 1, Census Tract 105.23, Fulton County, Georgia,0,0,0,0,0,0,0,0
-1,131210105231014.000000000000000,Block 1014, Block Group 1, Census Tract 105.23, Fulton County, Georgia,0,0,0,0,0,0,0,0
-1,131210105231015.000000000000000,Block 1015, Block Group 1, Census Tract 105.23, Fulton County, Georgia,0,0,0,0,0,0,0,0
-1,131210105231021.000000000000000,Block 1021, Block Group 1, Census Tract 105.23, Fulton County, Georgia,0,0,0,0,0,0,0,0
-1,131210105231028.000000000000000,Block 1028, Block Group 1, Census Tract 105.23, Fulton County, Georgia,0,0,0,0,0,0,0,0
-1,131210105231030.000000000000000,Block 1030, Block Group 1, Census Tract 105.23, Fulton County, Georgia,0,0,0,0,0,0,0,0
-1,131210105241000.000000000000000,Block 1000, Block Group 1, Census Tract 105.24, Fulton County, Georgia,0,0,0,0,0,0,0,0
-1,131210105241004.000000000000000,Block 1004, Block Group 1, Census Tract 105.24, Fulton County, Georgia,0,0,0,0,0,0,0,0
-1,131210105241008.000000000000000,Block 1008, Block Group 1, Census Tract 105.24, Fulton County, Georgia,0,0,0,0,0,0,0,0
-1,131210105241009.000000000000000,Block 1009, Block Group 1, Census Tract 105.24, Fulton County, Georgia,0,0,0,0,0,0,0,0
-1,131210105241010.000000000000000,Block 1010, Block Group 1, Census Tract 105.24, Fulton County, Georgia,0,0,0,0,0,0,0,0
-1,131210105241012.000000000000000,Block 1012, Block Group 1, Census Tract 105.24, Fulton County, Georgia,0,0,0,0,0,0,0,0
-1,131210105241013.000000000000000,Block 1013, Block Group 1, Census Tract 105.24, Fulton County, Georgia,0,0,0,0,0,0,0,0
-1,131210105241015.000000000000000,Block 1015, Block Group 1, Census Tract 105.24, Fulton County, Georgia,0,0,0,0,0,0,0,0
-1,131210105241016.000000000000000,Block 1016, Block Group 1, Census Tract 105.24, Fulton County, Georgia,0,0,0,0,0,0,0,0
-1,131210105251001.000000000000000,Block 1001, Block Group 1, Census Tract 105.25, Fulton County, Georgia,0,0,0,0,0,0,0,0
-1,131210105251008.000000000000000,Block 1008, Block Group 1, Census Tract 105.25, Fulton County, Georgia,0,0,0,0,0,0,0,0
-1,131210105251009.000000000000000,Block 1009, Block Group 1, Census Tract 105.25, Fulton County, Georgia,0,0,0,0,0,0,0,0
-1,131210105251010.000000000000000,Block 1010, Block Group 1, Census Tract 105.25, Fulton County, Georgia,0,0,0,0,0,0,0,0
-1,131210105253004.000000000000000,Block 3004, Block Group 3, Census Tract 105.25, Fulton County, Georgia,0,0,0,0,0,0,0,0
-1,131210105253005.000000000000000,Block 3005, Block Group 3, Census Tract 105.25, Fulton County, Georgia,0,0,0,0,0,0,0,0
-1,131210105253007.000000000000000,Block 3007, Block Group 3, Census Tract 105.25, Fulton County, Georgia,0,0,0,0,0,0,0,0
-1,131210105253008.000000000000000,Block 3008, Block Group 3, Census Tract 105.25, Fulton County, Georgia,0,0,0,0,0,0,0,0
-1,131210105253009.000000000000000,Block 3009, Block Group 3, Census Tract 105.25, Fulton County, Georgia,0,0,0,0,0,0,0,0
-1,131210105253010.000000000000000,Block 3010, Block Group 3, Census Tract 105.25, Fulton County, Georgia,0,0,0,0,0,0,0,0
-1,131210105253013.000000000000000,Block 3013, Block Group 3, Census Tract 105.25, Fulton County, Georgia,0,0,0,0,0,0,0,0
-1,131210105261000.000000000000000,Block 1000, Block Group 1, Census Tract 105.26, Fulton County, Georgia,0,0,0,0,0,0,0,0
-1,131210105261004.000000000000000,Block 1004, Block Group 1, Census Tract 105.26, Fulton County, Georgia,0,0,0,0,0,0,0,0
-1,131210105261008.000000000000000,Block 1008, Block Group 1, Census Tract 105.26, Fulton County, Georgia,0,0,0,0,0,0,0,0
-1,131210105261009.000000000000000,Block 1009, Block Group 1, Census Tract 105.26, Fulton County, Georgia,0,0,0,0,0,0,0,0
-1,131210105261010.000000000000000,Block 1010, Block Group 1, Census Tract 105.26, Fulton County, Georgia,0,0,0,0,0,0,0,0
-1,131210105261012.000000000000000,Block 1012, Block Group 1, Census Tract 105.26, Fulton County, Georgia,0,0,0,0,0,0,0,0
-1,131210105261014.000000000000000,Block 1014, Block Group 1, Census Tract 105.26, Fulton County, Georgia,0,0,0,0,0,0,0,0
-1,131210105261015.000000000000000,Block 1015, Block Group 1, Census Tract 105.26, Fulton County, Georgia,0,0,0,0,0,0,0,0
-1,131210105261017.000000000000000,Block 1017, Block Group 1, Census Tract 105.26, Fulton County, Georgia,0,0,0,0,0,0,0,0
-1,131210105261019.000000000000000,Block 1019, Block Group 1, Census Tract 105.26, Fulton County, Georgia,0,0,0,0,0,0,0,0
-1,131210105261020.000000000000000,Block 1020, Block Group 1, Census Tract 105.26, Fulton County, Georgia,0,0,0,0,0,0,0,0
-1,131210105261022.000000000000000,Block 1022, Block Group 1, Census Tract 105.26, Fulton County, Georgia,0,0,0,0,0,0,0,0
-1,131210105261023.000000000000000,Block 1023, Block Group 1, Census Tract 105.26, Fulton County, Georgia,0,0,0,0,0,0,0,0
-1,131210105261024.000000000000000,Block 1024, Block Group 1, Census Tract 105.26, Fulton County, Georgia,0,0,0,0,0,0,0,0
-1,131210105261025.000000000000000,Block 1025, Block Group 1, Census Tract 105.26, Fulton County, Georgia,0,0,0,0,0,0,0,0
-1,131210105261032.000000000000000,Block 1032, Block Group 1, Census Tract 105.26, Fulton County, Georgia,0,0,0,0,0,0,0,0
-1,131210105261036.000000000000000,Block 1036, Block Group 1, Census Tract 105.26, Fulton County, Georgia,0,0,0,0,0,0,0,0
-1,131210105261039.000000000000000,Block 1039, Block Group 1, Census Tract 105.26, Fulton County, Georgia,0,0,0,0,0,0,0,0
-1,131210105261040.000000000000000,Block 1040, Block Group 1, Census Tract 105.26, Fulton County, Georgia,0,0,0,0,0,0,0,0
-1,131210105261042.000000000000000,Block 1042, Block Group 1, Census Tract 105.26, Fulton County, Georgia,0,0,0,0,0,0,0,0
-1,131210105261043.000000000000000,Block 1043, Block Group 1, Census Tract 105.26, Fulton County, Georgia,0,0,0,0,0,0,0,0
-1,131210105261044.000000000000000,Block 1044, Block Group 1, Census Tract 105.26, Fulton County, Georgia,0,0,0,0,0,0,0,0
-1,131210105261045.000000000000000,Block 1045, Block Group 1, Census Tract 105.26, Fulton County, Georgia,0,0,0,0,0,0,0,0
-1,131210105261046.000000000000000,Block 1046, Block Group 1, Census Tract 105.26, Fulton County, Georgia,0,0,0,0,0,0,0,0
-1,131210105261047.000000000000000,Block 1047, Block Group 1, Census Tract 105.26, Fulton County, Georgia,0,0,0,0,0,0,0,0
-1,131210105261048.000000000000000,Block 1048, Block Group 1, Census Tract 105.26, Fulton County, Georgia,0,0,0,0,0,0,0,0
-1,131210105261049.000000000000000,Block 1049, Block Group 1, Census Tract 105.26, Fulton County, Georgia,0,0,0,0,0,0,0,0
-1,131210105261050.000000000000000,Block 1050, Block Group 1, Census Tract 105.26, Fulton County, Georgia,0,0,0,0,0,0,0,0
-1,131210105261051.000000000000000,Block 1051, Block Group 1, Census Tract 105.26, Fulton County, Georgia,0,0,0,0,0,0,0,0
-1,131210105261052.000000000000000,Block 1052, Block Group 1, Census Tract 105.26, Fulton County, Georgia,0,0,0,0,0,0,0,0
-1,131210105261053.000000000000000,Block 1053, Block Group 1, Census Tract 105.26, Fulton County, Georgia,0,0,0,0,0,0,0,0
-1,131210105261054.000000000000000,Block 1054, Block Group 1, Census Tract 105.26, Fulton County, Georgia,0,0,0,0,0,0,0,0
-1,131210105261056.000000000000000,Block 1056, Block Group 1, Census Tract 105.26, Fulton County, Georgia,0,0,0,0,0,0,0,0
-1,131210105261057.000000000000000,Block 1057, Block Group 1, Census Tract 105.26, Fulton County, Georgia,0,0,0,0,0,0,0,0
-1,131210105261058.000000000000000,Block 1058, Block Group 1, Census Tract 105.26, Fulton County, Georgia,0,0,0,0,0,0,0,0
-1,131210105261059.000000000000000,Block 1059, Block Group 1, Census Tract 105.26, Fulton County, Georgia,0,0,0,0,0,0,0,0
-1,131210105261060.000000000000000,Block 1060, Block Group 1, Census Tract 105.26, Fulton County, Georgia,0,0,0,0,0,0,0,0
-1,131210105261061.000000000000000,Block 1061, Block Group 1, Census Tract 105.26, Fulton County, Georgia,0,0,0,0,0,0,0,0
-1,131210105261062.000000000000000,Block 1062, Block Group 1, Census Tract 105.26, Fulton County, Georgia,0,0,0,0,0,0,0,0
-1,131210105261063.000000000000000,Block 1063, Block Group 1, Census Tract 105.26, Fulton County, Georgia,0,0,0,0,0,0,0,0
-1,131210105262003.000000000000000,Block 2003, Block Group 2, Census Tract 105.26, Fulton County, Georgia,0,0,0,0,0,0,0,0
-1,131210105262016.000000000000000,Block 2016, Block Group 2, Census Tract 105.26, Fulton County, Georgia,0,0,0,0,0,0,0,0
-1,131210105263000.000000000000000,Block 3000, Block Group 3, Census Tract 105.26, Fulton County, Georgia,0,0,0,0,0,0,0,0
-1,131210105263010.000000000000000,Block 3010, Block Group 3, Census Tract 105.26, Fulton County, Georgia,0,0,0,0,0,0,0,0
-1,131210105263014.000000000000000,Block 3014, Block Group 3, Census Tract 105.26, Fulton County, Georgia,0,0,0,0,0,0,0,0
-1,131210105263015.000000000000000,Block 3015, Block Group 3, Census Tract 105.26, Fulton County, Georgia,0,0,0,0,0,0,0,0
-1,131210105264014.000000000000000,Block 4014, Block Group 4, Census Tract 105.26, Fulton County, Georgia,0,0,0,0,0,0,0,0
-1,131210105264016.000000000000000,Block 4016, Block Group 4, Census Tract 105.26, Fulton County, Georgia,0,0,0,0,0,0,0,0
-1,131210105264018.000000000000000,Block 4018, Block Group 4, Census Tract 105.26, Fulton County, Georgia,0,0,0,0,0,0,0,0
-1,131210105271003.000000000000000,Block 1003, Block Group 1, Census Tract 105.27, Fulton County, Georgia,0,0,0,0,0,0,0,0
-1,131210105271009.000000000000000,Block 1009, Block Group 1, Census Tract 105.27, Fulton County, Georgia,0,0,0,0,0,0,0,0
-1,131210105271016.000000000000000,Block 1016, Block Group 1, Census Tract 105.27, Fulton County, Georgia,0,0,0,0,0,0,0,0
-1,131210105271018.000000000000000,Block 1018, Block Group 1, Census Tract 105.27, Fulton County, Georgia,0,0,0,0,0,0,0,0
-1,131210105273000.000000000000000,Block 3000, Block Group 3, Census Tract 105.27, Fulton County, Georgia,0,0,0,0,0,0,0,0
-1,131210105273003.000000000000000,Block 3003, Block Group 3, Census Tract 105.27, Fulton County, Georgia,0,0,0,0,0,0,0,0
-1,131210105273021.000000000000000,Block 3021, Block Group 3, Census Tract 105.27, Fulton County, Georgia,0,0,0,0,0,0,0,0
-1,131210105274005.000000000000000,Block 4005, Block Group 4, Census Tract 105.27, Fulton County, Georgia,0,0,0,0,0,0,0,0
-1,131210105274008.000000000000000,Block 4008, Block Group 4, Census Tract 105.27, Fulton County, Georgia,0,0,0,0,0,0,0,0
-1,131210105274009.000000000000000,Block 4009, Block Group 4, Census Tract 105.27, Fulton County, Georgia,0,0,0,0,0,0,0,0
-1,131210105281000.000000000000000,Block 1000, Block Group 1, Census Tract 105.28, Fulton County, Georgia,0,0,0,0,0,0,0,0
-1,131210105281001.000000000000000,Block 1001, Block Group 1, Census Tract 105.28, Fulton County, Georgia,0,0,0,0,0,0,0,0
-1,131210105281003.000000000000000,Block 1003, Block Group 1, Census Tract 105.28, Fulton County, Georgia,0,0,0,0,0,0,0,0
-1,131210105281010.000000000000000,Block 1010, Block Group 1, Census Tract 105.28, Fulton County, Georgia,0,0,0,0,0,0,0,0
-1,131210105281016.000000000000000,Block 1016, Block Group 1, Census Tract 105.28, Fulton County, Georgia,0,0,0,0,0,0,0,0
-1,131210105281017.000000000000000,Block 1017, Block Group 1, Census Tract 105.28, Fulton County, Georgia,0,0,0,0,0,0,0,0
-1,131210105281019.000000000000000,Block 1019, Block Group 1, Census Tract 105.28, Fulton County, Georgia,0,0,0,0,0,0,0,0
-1,131210105282001.000000000000000,Block 2001, Block Group 2, Census Tract 105.28, Fulton County, Georgia,0,0,0,0,0,0,0,0
-1,131210105282007.000000000000000,Block 2007, Block Group 2, Census Tract 105.28, Fulton County, Georgia,0,0,0,0,0,0,0,0
-1,131210105282008.000000000000000,Block 2008, Block Group 2, Census Tract 105.28, Fulton County, Georgia,0,0,0,0,0,0,0,0
-1,131210105282009.000000000000000,Block 2009, Block Group 2, Census Tract 105.28, Fulton County, Georgia,0,0,0,0,0,0,0,0
-1,131210105282010.000000000000000,Block 2010, Block Group 2, Census Tract 105.28, Fulton County, Georgia,0,0,0,0,0,0,0,0
-1,131210105282012.000000000000000,Block 2012, Block Group 2, Census Tract 105.28, Fulton County, Georgia,0,0,0,0,0,0,0,0
-1,131210105282013.000000000000000,Block 2013, Block Group 2, Census Tract 105.28, Fulton County, Georgia,0,0,0,0,0,0,0,0
-1,131210105282014.000000000000000,Block 2014, Block Group 2, Census Tract 105.28, Fulton County, Georgia,0,0,0,0,0,0,0,0
-1,131210105282015.000000000000000,Block 2015, Block Group 2, Census Tract 105.28, Fulton County, Georgia,0,0,0,0,0,0,0,0
-1,131210105283000.000000000000000,Block 3000, Block Group 3, Census Tract 105.28, Fulton County, Georgia,0,0,0,0,0,0,0,0
-1,131210105283001.000000000000000,Block 3001, Block Group 3, Census Tract 105.28, Fulton County, Georgia,0,0,0,0,0,0,0,0
-1,131210105283009.000000000000000,Block 3009, Block Group 3, Census Tract 105.28, Fulton County, Georgia,0,0,0,0,0,0,0,0
-1,131210105283010.000000000000000,Block 3010, Block Group 3, Census Tract 105.28, Fulton County, Georgia,0,0,0,0,0,0,0,0
-1,131210105283011.000000000000000,Block 3011, Block Group 3, Census Tract 105.28, Fulton County, Georgia,0,0,0,0,0,0,0,0
-1,131210105283012.000000000000000,Block 3012, Block Group 3, Census Tract 105.28, Fulton County, Georgia,0,0,0,0,0,0,0,0
-1,131210105291000.000000000000000,Block 1000, Block Group 1, Census Tract 105.29, Fulton County, Georgia,0,0,0,0,0,0,0,0
-1,131210105291001.000000000000000,Block 1001, Block Group 1, Census Tract 105.29, Fulton County, Georgia,0,0,0,0,0,0,0,0
-1,131210105291002.000000000000000,Block 1002, Block Group 1, Census Tract 105.29, Fulton County, Georgia,0,0,0,0,0,0,0,0
-1,131210105291003.000000000000000,Block 1003, Block Group 1, Census Tract 105.29, Fulton County, Georgia,0,0,0,0,0,0,0,0
-1,131210105291004.000000000000000,Block 1004, Block Group 1, Census Tract 105.29, Fulton County, Georgia,0,0,0,0,0,0,0,0
-1,131210105291010.000000000000000,Block 1010, Block Group 1, Census Tract 105.29, Fulton County, Georgia,0,0,0,0,0,0,0,0
-1,131210105291011.000000000000000,Block 1011, Block Group 1, Census Tract 105.29, Fulton County, Georgia,0,0,0,0,0,0,0,0
-1,131210105291012.000000000000000,Block 1012, Block Group 1, Census Tract 105.29, Fulton County, Georgia,0,0,0,0,0,0,0,0
-1,131210105291019.000000000000000,Block 1019, Block Group 1, Census Tract 105.29, Fulton County, Georgia,0,0,0,0,0,0,0,0
-1,131210105291021.000000000000000,Block 1021, Block Group 1, Census Tract 105.29, Fulton County, Georgia,0,0,0,0,0,0,0,0
-1,131210105292000.000000000000000,Block 2000, Block Group 2, Census Tract 105.29, Fulton County, Georgia,0,0,0,0,0,0,0,0
-1,131210105292001.000000000000000,Block 2001, Block Group 2, Census Tract 105.29, Fulton County, Georgia,0,0,0,0,0,0,0,0
-1,131210105292010.000000000000000,Block 2010, Block Group 2, Census Tract 105.29, Fulton County, Georgia,0,0,0,0,0,0,0,0
-1,131210105292011.000000000000000,Block 2011, Block Group 2, Census Tract 105.29, Fulton County, Georgia,0,0,0,0,0,0,0,0
-1,131210105292012.000000000000000,Block 2012, Block Group 2, Census Tract 105.29, Fulton County, Georgia,0,0,0,0,0,0,0,0
-1,131210105292013.000000000000000,Block 2013, Block Group 2, Census Tract 105.29, Fulton County, Georgia,0,0,0,0,0,0,0,0
-1,131210105292014.000000000000000,Block 2014, Block Group 2, Census Tract 105.29, Fulton County, Georgia,0,0,0,0,0,0,0,0
-1,131210105292018.000000000000000,Block 2018, Block Group 2, Census Tract 105.29, Fulton County, Georgia,0,0,0,0,0,0,0,0
-1,131210105292022.000000000000000,Block 2022, Block Group 2, Census Tract 105.29, Fulton County, Georgia,0,0,0,0,0,0,0,0
-1,131210105293001.000000000000000,Block 3001, Block Group 3, Census Tract 105.29, Fulton County, Georgia,0,0,0,0,0,0,0,0
-1,131210105293002.000000000000000,Block 3002, Block Group 3, Census Tract 105.29, Fulton County, Georgia,0,0,0,0,0,0,0,0
-1,131210105293003.000000000000000,Block 3003, Block Group 3, Census Tract 105.29, Fulton County, Georgia,0,0,0,0,0,0,0,0
-1,131210105293004.000000000000000,Block 3004, Block Group 3, Census Tract 105.29, Fulton County, Georgia,0,0,0,0,0,0,0,0
-1,131210105293009.000000000000000,Block 3009, Block Group 3, Census Tract 105.29, Fulton County, Georgia,0,0,0,0,0,0,0,0
-1,131210105293010.000000000000000,Block 3010, Block Group 3, Census Tract 105.29, Fulton County, Georgia,0,0,0,0,0,0,0,0
-1,131210105293011.000000000000000,Block 3011, Block Group 3, Census Tract 105.29, Fulton County, Georgia,0,0,0,0,0,0,0,0
-1,131210105293013.000000000000000,Block 3013, Block Group 3, Census Tract 105.29, Fulton County, Georgia,0,0,0,0,0,0,0,0
-1,131210105293029.000000000000000,Block 3029, Block Group 3, Census Tract 105.29, Fulton County, Georgia,0,0,0,0,0,0,0,0
-1,131210105293030.000000000000000,Block 3030, Block Group 3, Census Tract 105.29, Fulton County, Georgia,0,0,0,0,0,0,0,0
-1,131210105293031.000000000000000,Block 3031, Block Group 3, Census Tract 105.29, Fulton County, Georgia,0,0,0,0,0,0,0,0
-1,131210105293032.000000000000000,Block 3032, Block Group 3, Census Tract 105.29, Fulton County, Georgia,0,0,0,0,0,0,0,0
-1,131210105293033.000000000000000,Block 3033, Block Group 3, Census Tract 105.29, Fulton County, Georgia,0,0,0,0,0,0,0,0
-1,131210105293034.000000000000000,Block 3034, Block Group 3, Census Tract 105.29, Fulton County, Georgia,0,0,0,0,0,0,0,0
-1,131210105293035.000000000000000,Block 3035, Block Group 3, Census Tract 105.29, Fulton County, Georgia,0,0,0,0,0,0,0,0
-1,131210105301000.000000000000000,Block 1000, Block Group 1, Census Tract 105.30, Fulton County, Georgia,0,0,0,0,0,0,0,0
-1,131210105301001.000000000000000,Block 1001, Block Group 1, Census Tract 105.30, Fulton County, Georgia,0,0,0,0,0,0,0,0
-1,131210105302000.000000000000000,Block 2000, Block Group 2, Census Tract 105.30, Fulton County, Georgia,0,0,0,0,0,0,0,0
-1,131210105302001.000000000000000,Block 2001, Block Group 2, Census Tract 105.30, Fulton County, Georgia,0,0,0,0,0,0,0,0
-1,131210105302003.000000000000000,Block 2003, Block Group 2, Census Tract 105.30, Fulton County, Georgia,0,0,0,0,0,0,0,0
-1,131210105302004.000000000000000,Block 2004, Block Group 2, Census Tract 105.30, Fulton County, Georgia,0,0,0,0,0,0,0,0
-1,131210105302005.000000000000000,Block 2005, Block Group 2, Census Tract 105.30, Fulton County, Georgia,0,0,0,0,0,0,0,0
-1,131210105302006.000000000000000,Block 2006, Block Group 2, Census Tract 105.30, Fulton County, Georgia,0,0,0,0,0,0,0,0
-1,131210105302009.000000000000000,Block 2009, Block Group 2, Census Tract 105.30, Fulton County, Georgia,0,0,0,0,0,0,0,0
-1,131210105302011.000000000000000,Block 2011, Block Group 2, Census Tract 105.30, Fulton County, Georgia,0,0,0,0,0,0,0,0
-1,131210105302012.000000000000000,Block 2012, Block Group 2, Census Tract 105.30, Fulton County, Georgia,0,0,0,0,0,0,0,0
-1,131210105302013.000000000000000,Block 2013, Block Group 2, Census Tract 105.30, Fulton County, Georgia,0,0,0,0,0,0,0,0
-1,131210105302018.000000000000000,Block 2018, Block Group 2, Census Tract 105.30, Fulton County, Georgia,0,0,0,0,0,0,0,0
-1,131210105302019.000000000000000,Block 2019, Block Group 2, Census Tract 105.30, Fulton County, Georgia,0,0,0,0,0,0,0,0
-1,131210105302025.000000000000000,Block 2025, Block Group 2, Census Tract 105.30, Fulton County, Georgia,0,0,0,0,0,0,0,0
-1,131210105302026.000000000000000,Block 2026, Block Group 2, Census Tract 105.30, Fulton County, Georgia,0,0,0,0,0,0,0,0
-1,131210105302027.000000000000000,Block 2027, Block Group 2, Census Tract 105.30, Fulton County, Georgia,0,0,0,0,0,0,0,0
-1,131210105302029.000000000000000,Block 2029, Block Group 2, Census Tract 105.30, Fulton County, Georgia,0,0,0,0,0,0,0,0
-1,131210105302030.000000000000000,Block 2030, Block Group 2, Census Tract 105.30, Fulton County, Georgia,0,0,0,0,0,0,0,0
-1,131210105302031.000000000000000,Block 2031, Block Group 2, Census Tract 105.30, Fulton County, Georgia,0,0,0,0,0,0,0,0
-1,131210105302032.000000000000000,Block 2032, Block Group 2, Census Tract 105.30, Fulton County, Georgia,0,0,0,0,0,0,0,0
-1,131210105302033.000000000000000,Block 2033, Block Group 2, Census Tract 105.30, Fulton County, Georgia,0,0,0,0,0,0,0,0
-1,131210105302034.000000000000000,Block 2034, Block Group 2, Census Tract 105.30, Fulton County, Georgia,0,0,0,0,0,0,0,0
-1,131210105302037.000000000000000,Block 2037, Block Group 2, Census Tract 105.30, Fulton County, Georgia,0,0,0,0,0,0,0,0
-1,131210105302038.000000000000000,Block 2038, Block Group 2, Census Tract 105.30, Fulton County, Georgia,0,0,0,0,0,0,0,0
-1,131210105312000.000000000000000,Block 2000, Block Group 2, Census Tract 105.31, Fulton County, Georgia,0,0,0,0,0,0,0,0
-1,131210105312001.000000000000000,Block 2001, Block Group 2, Census Tract 105.31, Fulton County, Georgia,0,0,0,0,0,0,0,0
-1,131210105312002.000000000000000,Block 2002, Block Group 2, Census Tract 105.31, Fulton County, Georgia,0,0,0,0,0,0,0,0
-1,131210105312003.000000000000000,Block 2003, Block Group 2, Census Tract 105.31, Fulton County, Georgia,0,0,0,0,0,0,0,0
-1,131210105312004.000000000000000,Block 2004, Block Group 2, Census Tract 105.31, Fulton County, Georgia,0,0,0,0,0,0,0,0
-1,131210105312005.000000000000000,Block 2005, Block Group 2, Census Tract 105.31, Fulton County, Georgia,0,0,0,0,0,0,0,0
-1,131210105312014.000000000000000,Block 2014, Block Group 2, Census Tract 105.31, Fulton County, Georgia,0,0,0,0,0,0,0,0
-1,131210105322010.000000000000000,Block 2010, Block Group 2, Census Tract 105.32, Fulton County, Georgia,0,0,0,0,0,0,0,0
-1,131210105322011.000000000000000,Block 2011, Block Group 2, Census Tract 105.32, Fulton County, Georgia,0,0,0,0,0,0,0,0
-1,131210105322012.000000000000000,Block 2012, Block Group 2, Census Tract 105.32, Fulton County, Georgia,0,0,0,0,0,0,0,0
-1,131210105322013.000000000000000,Block 2013, Block Group 2, Census Tract 105.32, Fulton County, Georgia,0,0,0,0,0,0,0,0
-1,131210105322016.000000000000000,Block 2016, Block Group 2, Census Tract 105.32, Fulton County, Georgia,0,0,0,0,0,0,0,0
-1,131210105322017.000000000000000,Block 2017, Block Group 2, Census Tract 105.32, Fulton County, Georgia,0,0,0,0,0,0,0,0
-1,131210105323001.000000000000000,Block 3001, Block Group 3, Census Tract 105.32, Fulton County, Georgia,0,0,0,0,0,0,0,0
-1,131210105331000.000000000000000,Block 1000, Block Group 1, Census Tract 105.33, Fulton County, Georgia,0,0,0,0,0,0,0,0
-1,131210105331001.000000000000000,Block 1001, Block Group 1, Census Tract 105.33, Fulton County, Georgia,0,0,0,0,0,0,0,0
-1,131210105332000.000000000000000,Block 2000, Block Group 2, Census Tract 105.33, Fulton County, Georgia,0,0,0,0,0,0,0,0
-1,131210105332001.000000000000000,Block 2001, Block Group 2, Census Tract 105.33, Fulton County, Georgia,0,0,0,0,0,0,0,0
-1,131210105332002.000000000000000,Block 2002, Block Group 2, Census Tract 105.33, Fulton County, Georgia,0,0,0,0,0,0,0,0
-1,131210105332003.000000000000000,Block 2003, Block Group 2, Census Tract 105.33, Fulton County, Georgia,0,0,0,0,0,0,0,0
-1,131210105332004.000000000000000,Block 2004, Block Group 2, Census Tract 105.33, Fulton County, Georgia,0,0,0,0,0,0,0,0
-1,131210105341000.000000000000000,Block 1000, Block Group 1, Census Tract 105.34, Fulton County, Georgia,0,0,0,0,0,0,0,0
-1,131210105341002.000000000000000,Block 1002, Block Group 1, Census Tract 105.34, Fulton County, Georgia,0,0,0,0,0,0,0,0
-1,131210105341003.000000000000000,Block 1003, Block Group 1, Census Tract 105.34, Fulton County, Georgia,0,0,0,0,0,0,0,0
-1,131210105341004.000000000000000,Block 1004, Block Group 1, Census Tract 105.34, Fulton County, Georgia,0,0,0,0,0,0,0,0
-1,131210105342000.000000000000000,Block 2000, Block Group 2, Census Tract 105.34, Fulton County, Georgia,0,0,0,0,0,0,0,0
-1,131210105342001.000000000000000,Block 2001, Block Group 2, Census Tract 105.34, Fulton County, Georgia,0,0,0,0,0,0,0,0
-1,131210105342003.000000000000000,Block 2003, Block Group 2, Census Tract 105.34, Fulton County, Georgia,0,0,0,0,0,0,0,0
-1,131210105342013.000000000000000,Block 2013, Block Group 2, Census Tract 105.34, Fulton County, Georgia,0,0,0,0,0,0,0,0
-1,131210105342015.000000000000000,Block 2015, Block Group 2, Census Tract 105.34, Fulton County, Georgia,0,0,0,0,0,0,0,0
-1,131210105342016.000000000000000,Block 2016, Block Group 2, Census Tract 105.34, Fulton County, Georgia,0,0,0,0,0,0,0,0
-1,131210105342017.000000000000000,Block 2017, Block Group 2, Census Tract 105.34, Fulton County, Georgia,0,0,0,0,0,0,0,0
-1,131210105342019.000000000000000,Block 2019, Block Group 2, Census Tract 105.34, Fulton County, Georgia,0,0,0,0,0,0,0,0
-1,131210105342020.000000000000000,Block 2020, Block Group 2, Census Tract 105.34, Fulton County, Georgia,0,0,0,0,0,0,0,0
-1,131210105342021.000000000000000,Block 2021, Block Group 2, Census Tract 105.34, Fulton County, Georgia,0,0,0,0,0,0,0,0
-1,131210105342023.000000000000000,Block 2023, Block Group 2, Census Tract 105.34, Fulton County, Georgia,0,0,0,0,0,0,0,0
-1,131210105342024.000000000000000,Block 2024, Block Group 2, Census Tract 105.34, Fulton County, Georgia,0,0,0,0,0,0,0,0
-1,131210105342025.000000000000000,Block 2025, Block Group 2, Census Tract 105.34, Fulton County, Georgia,0,0,0,0,0,0,0,0
-1,131210105342026.000000000000000,Block 2026, Block Group 2, Census Tract 105.34, Fulton County, Georgia,0,0,0,0,0,0,0,0
-1,131210105343000.000000000000000,Block 3000, Block Group 3, Census Tract 105.34, Fulton County, Georgia,0,0,0,0,0,0,0,0
-1,131210105343004.000000000000000,Block 3004, Block Group 3, Census Tract 105.34, Fulton County, Georgia,0,0,0,0,0,0,0,0
-1,131210105343012.000000000000000,Block 3012, Block Group 3, Census Tract 105.34, Fulton County, Georgia,0,0,0,0,0,0,0,0
-1,131210105343013.000000000000000,Block 3013, Block Group 3, Census Tract 105.34, Fulton County, Georgia,0,0,0,0,0,0,0,0
-1,131210105343014.000000000000000,Block 3014, Block Group 3, Census Tract 105.34, Fulton County, Georgia,0,0,0,0,0,0,0,0
-1,131210105343015.000000000000000,Block 3015, Block Group 3, Census Tract 105.34, Fulton County, Georgia,0,0,0,0,0,0,0,0
-1,131210105343016.000000000000000,Block 3016, Block Group 3, Census Tract 105.34, Fulton County, Georgia,0,0,0,0,0,0,0,0
-1,131210105343017.000000000000000,Block 3017, Block Group 3, Census Tract 105.34, Fulton County, Georgia,0,0,0,0,0,0,0,0
-1,131210105343021.000000000000000,Block 3021, Block Group 3, Census Tract 105.34, Fulton County, Georgia,0,0,0,0,0,0,0,0
-1,131210105351000.000000000000000,Block 1000, Block Group 1, Census Tract 105.35, Fulton County, Georgia,0,0,0,0,0,0,0,0
-1,131210105352000.000000000000000,Block 2000, Block Group 2, Census Tract 105.35, Fulton County, Georgia,0,0,0,0,0,0,0,0
-1,131210105352009.000000000000000,Block 2009, Block Group 2, Census Tract 105.35, Fulton County, Georgia,0,0,0,0,0,0,0,0
-1,131210105361002.000000000000000,Block 1002, Block Group 1, Census Tract 105.36, Fulton County, Georgia,0,0,0,0,0,0,0,0
-1,131210105361008.000000000000000,Block 1008, Block Group 1, Census Tract 105.36, Fulton County, Georgia,0,0,0,0,0,0,0,0
-1,131210105361013.000000000000000,Block 1013, Block Group 1, Census Tract 105.36, Fulton County, Georgia,0,0,0,0,0,0,0,0
-1,131210105361017.000000000000000,Block 1017, Block Group 1, Census Tract 105.36, Fulton County, Georgia,0,0,0,0,0,0,0,0
-1,131210105361018.000000000000000,Block 1018, Block Group 1, Census Tract 105.36, Fulton County, Georgia,0,0,0,0,0,0,0,0
-1,131210105361019.000000000000000,Block 1019, Block Group 1, Census Tract 105.36, Fulton County, Georgia,0,0,0,0,0,0,0,0
-1,131210105361021.000000000000000,Block 1021, Block Group 1, Census Tract 105.36, Fulton County, Georgia,0,0,0,0,0,0,0,0
-1,131210105362000.000000000000000,Block 2000, Block Group 2, Census Tract 105.36, Fulton County, Georgia,0,0,0,0,0,0,0,0
-1,131210105362008.000000000000000,Block 2008, Block Group 2, Census Tract 105.36, Fulton County, Georgia,0,0,0,0,0,0,0,0
-1,131210105362011.000000000000000,Block 2011, Block Group 2, Census Tract 105.36, Fulton County, Georgia,0,0,0,0,0,0,0,0
-1,131210105362016.000000000000000,Block 2016, Block Group 2, Census Tract 105.36, Fulton County, Georgia,0,0,0,0,0,0,0,0
-1,131210105371003.000000000000000,Block 1003, Block Group 1, Census Tract 105.37, Fulton County, Georgia,0,0,0,0,0,0,0,0
-1,131210105371004.000000000000000,Block 1004, Block Group 1, Census Tract 105.37, Fulton County, Georgia,0,0,0,0,0,0,0,0
-1,131210105371005.000000000000000,Block 1005, Block Group 1, Census Tract 105.37, Fulton County, Georgia,0,0,0,0,0,0,0,0
-1,131210105371016.000000000000000,Block 1016, Block Group 1, Census Tract 105.37, Fulton County, Georgia,0,0,0,0,0,0,0,0
-1,131210105371019.000000000000000,Block 1019, Block Group 1, Census Tract 105.37, Fulton County, Georgia,0,0,0,0,0,0,0,0
-1,131210105372009.000000000000000,Block 2009, Block Group 2, Census Tract 105.37, Fulton County, Georgia,0,0,0,0,0,0,0,0
-1,131210105381006.000000000000000,Block 1006, Block Group 1, Census Tract 105.38, Fulton County, Georgia,0,0,0,0,0,0,0,0
-1,131210105382004.000000000000000,Block 2004, Block Group 2, Census Tract 105.38, Fulton County, Georgia,0,0,0,0,0,0,0,0
-1,131210105382005.000000000000000,Block 2005, Block Group 2, Census Tract 105.38, Fulton County, Georgia,0,0,0,0,0,0,0,0
-1,131210105382008.000000000000000,Block 2008, Block Group 2, Census Tract 105.38, Fulton County, Georgia,0,0,0,0,0,0,0,0
-1,131210105382009.000000000000000,Block 2009, Block Group 2, Census Tract 105.38, Fulton County, Georgia,0,0,0,0,0,0,0,0
-1,131210105382024.000000000000000,Block 2024, Block Group 2, Census Tract 105.38, Fulton County, Georgia,0,0,0,0,0,0,0,0
-1,131210105382027.000000000000000,Block 2027, Block Group 2, Census Tract 105.38, Fulton County, Georgia,0,0,0,0,0,0,0,0
-1,131210105391001.000000000000000,Block 1001, Block Group 1, Census Tract 105.39, Fulton County, Georgia,0,0,0,0,0,0,0,0
-1,131210105391010.000000000000000,Block 1010, Block Group 1, Census Tract 105.39, Fulton County, Georgia,0,0,0,0,0,0,0,0
-1,131210105391026.000000000000000,Block 1026, Block Group 1, Census Tract 105.39, Fulton County, Georgia,0,0,0,0,0,0,0,0
-1,131210105392000.000000000000000,Block 2000, Block Group 2, Census Tract 105.39, Fulton County, Georgia,0,0,0,0,0,0,0,0
-1,131210105392001.000000000000000,Block 2001, Block Group 2, Census Tract 105.39, Fulton County, Georgia,0,0,0,0,0,0,0,0
-1,131210105392002.000000000000000,Block 2002, Block Group 2, Census Tract 105.39, Fulton County, Georgia,0,0,0,0,0,0,0,0
-1,131210105392003.000000000000000,Block 2003, Block Group 2, Census Tract 105.39, Fulton County, Georgia,0,0,0,0,0,0,0,0
-1,131210105392005.000000000000000,Block 2005, Block Group 2, Census Tract 105.39, Fulton County, Georgia,0,0,0,0,0,0,0,0
-1,131210105392006.000000000000000,Block 2006, Block Group 2, Census Tract 105.39, Fulton County, Georgia,0,0,0,0,0,0,0,0
-1,131210105392010.000000000000000,Block 2010, Block Group 2, Census Tract 105.39, Fulton County, Georgia,0,0,0,0,0,0,0,0
-1,131210105392011.000000000000000,Block 2011, Block Group 2, Census Tract 105.39, Fulton County, Georgia,0,0,0,0,0,0,0,0
-1,131210105392012.000000000000000,Block 2012, Block Group 2, Census Tract 105.39, Fulton County, Georgia,0,0,0,0,0,0,0,0
-1,131210105392013.000000000000000,Block 2013, Block Group 2, Census Tract 105.39, Fulton County, Georgia,0,0,0,0,0,0,0,0
-1,131210105392014.000000000000000,Block 2014, Block Group 2, Census Tract 105.39, Fulton County, Georgia,0,0,0,0,0,0,0,0
-1,131210105392015.000000000000000,Block 2015, Block Group 2, Census Tract 105.39, Fulton County, Georgia,0,0,0,0,0,0,0,0
-1,131210105392018.000000000000000,Block 2018, Block Group 2, Census Tract 105.39, Fulton County, Georgia,0,0,0,0,0,0,0,0
-1,131210105401002.000000000000000,Block 1002, Block Group 1, Census Tract 105.40, Fulton County, Georgia,0,0,0,0,0,0,0,0
-1,131210105401003.000000000000000,Block 1003, Block Group 1, Census Tract 105.40, Fulton County, Georgia,0,0,0,0,0,0,0,0
-1,131210105401004.000000000000000,Block 1004, Block Group 1, Census Tract 105.40, Fulton County, Georgia,0,0,0,0,0,0,0,0
-1,131210105401006.000000000000000,Block 1006, Block Group 1, Census Tract 105.40, Fulton County, Georgia,0,0,0,0,0,0,0,0
-1,131210105401011.000000000000000,Block 1011, Block Group 1, Census Tract 105.40, Fulton County, Georgia,0,0,0,0,0,0,0,0
-1,131210105401013.000000000000000,Block 1013, Block Group 1, Census Tract 105.40, Fulton County, Georgia,0,0,0,0,0,0,0,0
-1,131210105401039.000000000000000,Block 1039, Block Group 1, Census Tract 105.40, Fulton County, Georgia,0,0,0,0,0,0,0,0
-1,131210105401042.000000000000000,Block 1042, Block Group 1, Census Tract 105.40, Fulton County, Georgia,0,0,0,0,0,0,0,0
-1,131210105401043.000000000000000,Block 1043, Block Group 1, Census Tract 105.40, Fulton County, Georgia,0,0,0,0,0,0,0,0
-1,131210105401044.000000000000000,Block 1044, Block Group 1, Census Tract 105.40, Fulton County, Georgia,0,0,0,0,0,0,0,0
-1,131210105402000.000000000000000,Block 2000, Block Group 2, Census Tract 105.40, Fulton County, Georgia,0,0,0,0,0,0,0,0
-1,131210105402001.000000000000000,Block 2001, Block Group 2, Census Tract 105.40, Fulton County, Georgia,0,0,0,0,0,0,0,0
-1,131210105402002.000000000000000,Block 2002, Block Group 2, Census Tract 105.40, Fulton County, Georgia,0,0,0,0,0,0,0,0
-1,131210105402003.000000000000000,Block 2003, Block Group 2, Census Tract 105.40, Fulton County, Georgia,0,0,0,0,0,0,0,0
-1,131210105402004.000000000000000,Block 2004, Block Group 2, Census Tract 105.40, Fulton County, Georgia,0,0,0,0,0,0,0,0
-1,131210105402005.000000000000000,Block 2005, Block Group 2, Census Tract 105.40, Fulton County, Georgia,0,0,0,0,0,0,0,0
-1,131210105402006.000000000000000,Block 2006, Block Group 2, Census Tract 105.40, Fulton County, Georgia,0,0,0,0,0,0,0,0
-1,131210105402007.000000000000000,Block 2007, Block Group 2, Census Tract 105.40, Fulton County, Georgia,0,0,0,0,0,0,0,0
-1,131210105402008.000000000000000,Block 2008, Block Group 2, Census Tract 105.40, Fulton County, Georgia,0,0,0,0,0,0,0,0
-1,131210105402010.000000000000000,Block 2010, Block Group 2, Census Tract 105.40, Fulton County, Georgia,0,0,0,0,0,0,0,0
-1,131210105402011.000000000000000,Block 2011, Block Group 2, Census Tract 105.40, Fulton County, Georgia,0,0,0,0,0,0,0,0
-1,131210105402013.000000000000000,Block 2013, Block Group 2, Census Tract 105.40, Fulton County, Georgia,0,0,0,0,0,0,0,0
-1,131210105402014.000000000000000,Block 2014, Block Group 2, Census Tract 105.40, Fulton County, Georgia,0,0,0,0,0,0,0,0
-1,131210105402017.000000000000000,Block 2017, Block Group 2, Census Tract 105.40, Fulton County, Georgia,0,0,0,0,0,0,0,0
-1,131210105402021.000000000000000,Block 2021, Block Group 2, Census Tract 105.40, Fulton County, Georgia,0,0,0,0,0,0,0,0
-1,131210105402022.000000000000000,Block 2022, Block Group 2, Census Tract 105.40, Fulton County, Georgia,0,0,0,0,0,0,0,0
-1,131210105402023.000000000000000,Block 2023, Block Group 2, Census Tract 105.40, Fulton County, Georgia,0,0,0,0,0,0,0,0
-1,131210105402030.000000000000000,Block 2030, Block Group 2, Census Tract 105.40, Fulton County, Georgia,0,0,0,0,0,0,0,0
-1,131210105402033.000000000000000,Block 2033, Block Group 2, Census Tract 105.40, Fulton County, Georgia,0,0,0,0,0,0,0,0
-1,131210105402034.000000000000000,Block 2034, Block Group 2, Census Tract 105.40, Fulton County, Georgia,0,0,0,0,0,0,0,0
-1,131210105402036.000000000000000,Block 2036, Block Group 2, Census Tract 105.40, Fulton County, Georgia,0,0,0,0,0,0,0,0
-1,131210106012004.000000000000000,Block 2004, Block Group 2, Census Tract 106.01, Fulton County, Georgia,0,0,0,0,0,0,0,0
-1,131210106012005.000000000000000,Block 2005, Block Group 2, Census Tract 106.01, Fulton County, Georgia,0,0,0,0,0,0,0,0
-1,131210106012008.000000000000000,Block 2008, Block Group 2, Census Tract 106.01, Fulton County, Georgia,0,0,0,0,0,0,0,0
-1,131210106012009.000000000000000,Block 2009, Block Group 2, Census Tract 106.01, Fulton County, Georgia,0,0,0,0,0,0,0,0
-1,131210106012011.000000000000000,Block 2011, Block Group 2, Census Tract 106.01, Fulton County, Georgia,0,0,0,0,0,0,0,0
-1,131210106013011.000000000000000,Block 3011, Block Group 3, Census Tract 106.01, Fulton County, Georgia,0,0,0,0,0,0,0,0
-1,131210106014017.000000000000000,Block 4017, Block Group 4, Census Tract 106.01, Fulton County, Georgia,0,0,0,0,0,0,0,0
-1,131210106031009.000000000000000,Block 1009, Block Group 1, Census Tract 106.03, Fulton County, Georgia,0,0,0,0,0,0,0,0
-1,131210106032002.000000000000000,Block 2002, Block Group 2, Census Tract 106.03, Fulton County, Georgia,0,0,0,0,0,0,0,0
-1,131210106032007.000000000000000,Block 2007, Block Group 2, Census Tract 106.03, Fulton County, Georgia,0,0,0,0,0,0,0,0
-1,131210106032008.000000000000000,Block 2008, Block Group 2, Census Tract 106.03, Fulton County, Georgia,0,0,0,0,0,0,0,0
-1,131210106032010.000000000000000,Block 2010, Block Group 2, Census Tract 106.03, Fulton County, Georgia,0,0,0,0,0,0,0,0
-1,131210106032011.000000000000000,Block 2011, Block Group 2, Census Tract 106.03, Fulton County, Georgia,0,0,0,0,0,0,0,0
-1,131210106033001.000000000000000,Block 3001, Block Group 3, Census Tract 106.03, Fulton County, Georgia,0,0,0,0,0,0,0,0
-1,131210106033002.000000000000000,Block 3002, Block Group 3, Census Tract 106.03, Fulton County, Georgia,0,0,0,0,0,0,0,0
-1,131210106033003.000000000000000,Block 3003, Block Group 3, Census Tract 106.03, Fulton County, Georgia,0,0,0,0,0,0,0,0
-1,131210106033004.000000000000000,Block 3004, Block Group 3, Census Tract 106.03, Fulton County, Georgia,0,0,0,0,0,0,0,0
-1,131210106033005.000000000000000,Block 3005, Block Group 3, Census Tract 106.03, Fulton County, Georgia,0,0,0,0,0,0,0,0
-1,131210106033007.000000000000000,Block 3007, Block Group 3, Census Tract 106.03, Fulton County, Georgia,0,0,0,0,0,0,0,0
-1,131210106033008.000000000000000,Block 3008, Block Group 3, Census Tract 106.03, Fulton County, Georgia,0,0,0,0,0,0,0,0
-1,131210106033009.000000000000000,Block 3009, Block Group 3, Census Tract 106.03, Fulton County, Georgia,0,0,0,0,0,0,0,0
-1,131210106033010.000000000000000,Block 3010, Block Group 3, Census Tract 106.03, Fulton County, Georgia,0,0,0,0,0,0,0,0
-1,131210106033011.000000000000000,Block 3011, Block Group 3, Census Tract 106.03, Fulton County, Georgia,0,0,0,0,0,0,0,0
-1,131210106034000.000000000000000,Block 4000, Block Group 4, Census Tract 106.03, Fulton County, Georgia,0,0,0,0,0,0,0,0
-1,131210106034002.000000000000000,Block 4002, Block Group 4, Census Tract 106.03, Fulton County, Georgia,0,0,0,0,0,0,0,0
-1,131210106034004.000000000000000,Block 4004, Block Group 4, Census Tract 106.03, Fulton County, Georgia,0,0,0,0,0,0,0,0
-1,131210106034005.000000000000000,Block 4005, Block Group 4, Census Tract 106.03, Fulton County, Georgia,0,0,0,0,0,0,0,0
-1,131210106034006.000000000000000,Block 4006, Block Group 4, Census Tract 106.03, Fulton County, Georgia,0,0,0,0,0,0,0,0
-1,131210106034008.000000000000000,Block 4008, Block Group 4, Census Tract 106.03, Fulton County, Georgia,0,0,0,0,0,0,0,0
-1,131210106034012.000000000000000,Block 4012, Block Group 4, Census Tract 106.03, Fulton County, Georgia,0,0,0,0,0,0,0,0
-1,131210106034013.000000000000000,Block 4013, Block Group 4, Census Tract 106.03, Fulton County, Georgia,0,0,0,0,0,0,0,0
-1,131210106034014.000000000000000,Block 4014, Block Group 4, Census Tract 106.03, Fulton County, Georgia,0,0,0,0,0,0,0,0
-1,131210106034015.000000000000000,Block 4015, Block Group 4, Census Tract 106.03, Fulton County, Georgia,0,0,0,0,0,0,0,0
-1,131210106034016.000000000000000,Block 4016, Block Group 4, Census Tract 106.03, Fulton County, Georgia,0,0,0,0,0,0,0,0
-1,131210106034017.000000000000000,Block 4017, Block Group 4, Census Tract 106.03, Fulton County, Georgia,0,0,0,0,0,0,0,0
-1,131210106034018.000000000000000,Block 4018, Block Group 4, Census Tract 106.03, Fulton County, Georgia,0,0,0,0,0,0,0,0
-1,131210106034019.000000000000000,Block 4019, Block Group 4, Census Tract 106.03, Fulton County, Georgia,0,0,0,0,0,0,0,0
-1,131210106034020.000000000000000,Block 4020, Block Group 4, Census Tract 106.03, Fulton County, Georgia,0,0,0,0,0,0,0,0
-1,131210106034022.000000000000000,Block 4022, Block Group 4, Census Tract 106.03, Fulton County, Georgia,0,0,0,0,0,0,0,0
-1,131210106034024.000000000000000,Block 4024, Block Group 4, Census Tract 106.03, Fulton County, Georgia,0,0,0,0,0,0,0,0
-1,131210106034025.000000000000000,Block 4025, Block Group 4, Census Tract 106.03, Fulton County, Georgia,0,0,0,0,0,0,0,0
-1,131210106034026.000000000000000,Block 4026, Block Group 4, Census Tract 106.03, Fulton County, Georgia,0,0,0,0,0,0,0,0
-1,131210106034027.000000000000000,Block 4027, Block Group 4, Census Tract 106.03, Fulton County, Georgia,0,0,0,0,0,0,0,0
-1,131210106034028.000000000000000,Block 4028, Block Group 4, Census Tract 106.03, Fulton County, Georgia,0,0,0,0,0,0,0,0
-1,131210106034029.000000000000000,Block 4029, Block Group 4, Census Tract 106.03, Fulton County, Georgia,0,0,0,0,0,0,0,0
-1,131210106034030.000000000000000,Block 4030, Block Group 4, Census Tract 106.03, Fulton County, Georgia,0,0,0,0,0,0,0,0
-1,131210106034032.000000000000000,Block 4032, Block Group 4, Census Tract 106.03, Fulton County, Georgia,0,0,0,0,0,0,0,0
-1,131210106034033.000000000000000,Block 4033, Block Group 4, Census Tract 106.03, Fulton County, Georgia,0,0,0,0,0,0,0,0
-1,131210106034034.000000000000000,Block 4034, Block Group 4, Census Tract 106.03, Fulton County, Georgia,0,0,0,0,0,0,0,0
-1,131210106034035.000000000000000,Block 4035, Block Group 4, Census Tract 106.03, Fulton County, Georgia,0,0,0,0,0,0,0,0
-1,131210106034036.000000000000000,Block 4036, Block Group 4, Census Tract 106.03, Fulton County, Georgia,0,0,0,0,0,0,0,0
-1,131210106034037.000000000000000,Block 4037, Block Group 4, Census Tract 106.03, Fulton County, Georgia,0,0,0,0,0,0,0,0
-1,131210106034038.000000000000000,Block 4038, Block Group 4, Census Tract 106.03, Fulton County, Georgia,0,0,0,0,0,0,0,0
-1,131210106034039.000000000000000,Block 4039, Block Group 4, Census Tract 106.03, Fulton County, Georgia,0,0,0,0,0,0,0,0
-1,131210106034040.000000000000000,Block 4040, Block Group 4, Census Tract 106.03, Fulton County, Georgia,0,0,0,0,0,0,0,0
-1,131210106041000.000000000000000,Block 1000, Block Group 1, Census Tract 106.04, Fulton County, Georgia,0,0,0,0,0,0,0,0
-1,131210106041001.000000000000000,Block 1001, Block Group 1, Census Tract 106.04, Fulton County, Georgia,0,0,0,0,0,0,0,0
-1,131210106041002.000000000000000,Block 1002, Block Group 1, Census Tract 106.04, Fulton County, Georgia,0,0,0,0,0,0,0,0
-1,131210106041003.000000000000000,Block 1003, Block Group 1, Census Tract 106.04, Fulton County, Georgia,0,0,0,0,0,0,0,0
-1,131210106041004.000000000000000,Block 1004, Block Group 1, Census Tract 106.04, Fulton County, Georgia,0,0,0,0,0,0,0,0
-1,131210106041005.000000000000000,Block 1005, Block Group 1, Census Tract 106.04, Fulton County, Georgia,0,0,0,0,0,0,0,0
-1,131210106041010.000000000000000,Block 1010, Block Group 1, Census Tract 106.04, Fulton County, Georgia,0,0,0,0,0,0,0,0
-1,131210106041011.000000000000000,Block 1011, Block Group 1, Census Tract 106.04, Fulton County, Georgia,0,0,0,0,0,0,0,0
-1,131210106041012.000000000000000,Block 1012, Block Group 1, Census Tract 106.04, Fulton County, Georgia,0,0,0,0,0,0,0,0
-1,131210106041013.000000000000000,Block 1013, Block Group 1, Census Tract 106.04, Fulton County, Georgia,0,0,0,0,0,0,0,0
-1,131210106041014.000000000000000,Block 1014, Block Group 1, Census Tract 106.04, Fulton County, Georgia,0,0,0,0,0,0,0,0
-1,131210106041015.000000000000000,Block 1015, Block Group 1, Census Tract 106.04, Fulton County, Georgia,0,0,0,0,0,0,0,0
-1,131210106041016.000000000000000,Block 1016, Block Group 1, Census Tract 106.04, Fulton County, Georgia,0,0,0,0,0,0,0,0
-1,131210106041017.000000000000000,Block 1017, Block Group 1, Census Tract 106.04, Fulton County, Georgia,0,0,0,0,0,0,0,0
-1,131210106041018.000000000000000,Block 1018, Block Group 1, Census Tract 106.04, Fulton County, Georgia,0,0,0,0,0,0,0,0
-1,131210106041019.000000000000000,Block 1019, Block Group 1, Census Tract 106.04, Fulton County, Georgia,0,0,0,0,0,0,0,0
-1,131210106042001.000000000000000,Block 2001, Block Group 2, Census Tract 106.04, Fulton County, Georgia,0,0,0,0,0,0,0,0
-1,131210106043008.000000000000000,Block 3008, Block Group 3, Census Tract 106.04, Fulton County, Georgia,0,0,0,0,0,0,0,0
-1,131210106043009.000000000000000,Block 3009, Block Group 3, Census Tract 106.04, Fulton County, Georgia,0,0,0,0,0,0,0,0
-1,131210106043019.000000000000000,Block 3019, Block Group 3, Census Tract 106.04, Fulton County, Georgia,0,0,0,0,0,0,0,0
-1,131210106043020.000000000000000,Block 3020, Block Group 3, Census Tract 106.04, Fulton County, Georgia,0,0,0,0,0,0,0,0
-1,131210106043021.000000000000000,Block 3021, Block Group 3, Census Tract 106.04, Fulton County, Georgia,0,0,0,0,0,0,0,0
-1,131210106043022.000000000000000,Block 3022, Block Group 3, Census Tract 106.04, Fulton County, Georgia,0,0,0,0,0,0,0,0
-1,131210108011000.000000000000000,Block 1000, Block Group 1, Census Tract 108.01, Fulton County, Georgia,0,0,0,0,0,0,0,0
-1,131210108011002.000000000000000,Block 1002, Block Group 1, Census Tract 108.01, Fulton County, Georgia,0,0,0,0,0,0,0,0
-1,131210108011003.000000000000000,Block 1003, Block Group 1, Census Tract 108.01, Fulton County, Georgia,0,0,0,0,0,0,0,0
-1,131210108011004.000000000000000,Block 1004, Block Group 1, Census Tract 108.01, Fulton County, Georgia,0,0,0,0,0,0,0,0
-1,131210108011005.000000000000000,Block 1005, Block Group 1, Census Tract 108.01, Fulton County, Georgia,0,0,0,0,0,0,0,0
-1,131210108011010.000000000000000,Block 1010, Block Group 1, Census Tract 108.01, Fulton County, Georgia,0,0,0,0,0,0,0,0
-1,131210108011011.000000000000000,Block 1011, Block Group 1, Census Tract 108.01, Fulton County, Georgia,0,0,0,0,0,0,0,0
-1,131210108011014.000000000000000,Block 1014, Block Group 1, Census Tract 108.01, Fulton County, Georgia,0,0,0,0,0,0,0,0
-1,131210108011015.000000000000000,Block 1015, Block Group 1, Census Tract 108.01, Fulton County, Georgia,0,0,0,0,0,0,0,0
-1,131210108011016.000000000000000,Block 1016, Block Group 1, Census Tract 108.01, Fulton County, Georgia,0,0,0,0,0,0,0,0
-1,131210108011021.000000000000000,Block 1021, Block Group 1, Census Tract 108.01, Fulton County, Georgia,0,0,0,0,0,0,0,0
-1,131210108011022.000000000000000,Block 1022, Block Group 1, Census Tract 108.01, Fulton County, Georgia,0,0,0,0,0,0,0,0
-1,131210108011023.000000000000000,Block 1023, Block Group 1, Census Tract 108.01, Fulton County, Georgia,0,0,0,0,0,0,0,0
-1,131210108011024.000000000000000,Block 1024, Block Group 1, Census Tract 108.01, Fulton County, Georgia,0,0,0,0,0,0,0,0
-1,131210108011025.000000000000000,Block 1025, Block Group 1, Census Tract 108.01, Fulton County, Georgia,0,0,0,0,0,0,0,0
-1,131210108011026.000000000000000,Block 1026, Block Group 1, Census Tract 108.01, Fulton County, Georgia,0,0,0,0,0,0,0,0
-1,131210108011028.000000000000000,Block 1028, Block Group 1, Census Tract 108.01, Fulton County, Georgia,0,0,0,0,0,0,0,0
-1,131210108012001.000000000000000,Block 2001, Block Group 2, Census Tract 108.01, Fulton County, Georgia,0,0,0,0,0,0,0,0
-1,131210108012005.000000000000000,Block 2005, Block Group 2, Census Tract 108.01, Fulton County, Georgia,0,0,0,0,0,0,0,0
-1,131210108012007.000000000000000,Block 2007, Block Group 2, Census Tract 108.01, Fulton County, Georgia,0,0,0,0,0,0,0,0
-1,131210108013001.000000000000000,Block 3001, Block Group 3, Census Tract 108.01, Fulton County, Georgia,0,0,0,0,0,0,0,0
-1,131210108013002.000000000000000,Block 3002, Block Group 3, Census Tract 108.01, Fulton County, Georgia,0,0,0,0,0,0,0,0
-1,131210108013003.000000000000000,Block 3003, Block Group 3, Census Tract 108.01, Fulton County, Georgia,0,0,0,0,0,0,0,0
-1,131210108013004.000000000000000,Block 3004, Block Group 3, Census Tract 108.01, Fulton County, Georgia,0,0,0,0,0,0,0,0
-1,131210108013006.000000000000000,Block 3006, Block Group 3, Census Tract 108.01, Fulton County, Georgia,0,0,0,0,0,0,0,0
-1,131210108013008.000000000000000,Block 3008, Block Group 3, Census Tract 108.01, Fulton County, Georgia,0,0,0,0,0,0,0,0
-1,131210108013009.000000000000000,Block 3009, Block Group 3, Census Tract 108.01, Fulton County, Georgia,0,0,0,0,0,0,0,0
-1,131210108013010.000000000000000,Block 3010, Block Group 3, Census Tract 108.01, Fulton County, Georgia,0,0,0,0,0,0,0,0
-1,131210108013012.000000000000000,Block 3012, Block Group 3, Census Tract 108.01, Fulton County, Georgia,0,0,0,0,0,0,0,0
-1,131210108013013.000000000000000,Block 3013, Block Group 3, Census Tract 108.01, Fulton County, Georgia,0,0,0,0,0,0,0,0
-1,131210108013019.000000000000000,Block 3019, Block Group 3, Census Tract 108.01, Fulton County, Georgia,0,0,0,0,0,0,0,0
-1,131210108013021.000000000000000,Block 3021, Block Group 3, Census Tract 108.01, Fulton County, Georgia,0,0,0,0,0,0,0,0
-1,131210108013022.000000000000000,Block 3022, Block Group 3, Census Tract 108.01, Fulton County, Georgia,0,0,0,0,0,0,0,0
-1,131210108013023.000000000000000,Block 3023, Block Group 3, Census Tract 108.01, Fulton County, Georgia,0,0,0,0,0,0,0,0
-1,131210108013024.000000000000000,Block 3024, Block Group 3, Census Tract 108.01, Fulton County, Georgia,0,0,0,0,0,0,0,0
-1,131210108013025.000000000000000,Block 3025, Block Group 3, Census Tract 108.01, Fulton County, Georgia,0,0,0,0,0,0,0,0
-1,131210108013026.000000000000000,Block 3026, Block Group 3, Census Tract 108.01, Fulton County, Georgia,0,0,0,0,0,0,0,0
-1,131210108013027.000000000000000,Block 3027, Block Group 3, Census Tract 108.01, Fulton County, Georgia,0,0,0,0,0,0,0,0
-1,131210108013028.000000000000000,Block 3028, Block Group 3, Census Tract 108.01, Fulton County, Georgia,0,0,0,0,0,0,0,0
-1,131210108013029.000000000000000,Block 3029, Block Group 3, Census Tract 108.01, Fulton County, Georgia,0,0,0,0,0,0,0,0
-1,131210108013030.000000000000000,Block 3030, Block Group 3, Census Tract 108.01, Fulton County, Georgia,0,0,0,0,0,0,0,0
-1,131210108013031.000000000000000,Block 3031, Block Group 3, Census Tract 108.01, Fulton County, Georgia,0,0,0,0,0,0,0,0
-1,131210108013039.000000000000000,Block 3039, Block Group 3, Census Tract 108.01, Fulton County, Georgia,0,0,0,0,0,0,0,0
-1,131210108013040.000000000000000,Block 3040, Block Group 3, Census Tract 108.01, Fulton County, Georgia,0,0,0,0,0,0,0,0
-1,131210108013041.000000000000000,Block 3041, Block Group 3, Census Tract 108.01, Fulton County, Georgia,0,0,0,0,0,0,0,0
-1,131210108021001.000000000000000,Block 1001, Block Group 1, Census Tract 108.02, Fulton County, Georgia,0,0,0,0,0,0,0,0
-1,131210108021005.000000000000000,Block 1005, Block Group 1, Census Tract 108.02, Fulton County, Georgia,0,0,0,0,0,0,0,0
-1,131210108021008.000000000000000,Block 1008, Block Group 1, Census Tract 108.02, Fulton County, Georgia,0,0,0,0,0,0,0,0
-1,131210108021009.000000000000000,Block 1009, Block Group 1, Census Tract 108.02, Fulton County, Georgia,0,0,0,0,0,0,0,0
-1,131210108022000.000000000000000,Block 2000, Block Group 2, Census Tract 108.02, Fulton County, Georgia,0,0,0,0,0,0,0,0
-1,131210108022006.000000000000000,Block 2006, Block Group 2, Census Tract 108.02, Fulton County, Georgia,0,0,0,0,0,0,0,0
-1,131210108023000.000000000000000,Block 3000, Block Group 3, Census Tract 108.02, Fulton County, Georgia,0,0,0,0,0,0,0,0
-1,131210108023010.000000000000000,Block 3010, Block Group 3, Census Tract 108.02, Fulton County, Georgia,0,0,0,0,0,0,0,0
-1,131210108023011.000000000000000,Block 3011, Block Group 3, Census Tract 108.02, Fulton County, Georgia,0,0,0,0,0,0,0,0
-1,131210108023012.000000000000000,Block 3012, Block Group 3, Census Tract 108.02, Fulton County, Georgia,0,0,0,0,0,0,0,0
-1,131210110001011.000000000000000,Block 1011, Block Group 1, Census Tract 110, Fulton County, Georgia,0,0,0,0,0,0,0,0
-1,131210110002002.000000000000000,Block 2002, Block Group 2, Census Tract 110, Fulton County, Georgia,0,0,0,0,0,0,0,0
-1,131210110002003.000000000000000,Block 2003, Block Group 2, Census Tract 110, Fulton County, Georgia,0,0,0,0,0,0,0,0
-1,131210110002004.000000000000000,Block 2004, Block Group 2, Census Tract 110, Fulton County, Georgia,0,0,0,0,0,0,0,0
-1,131210110002005.000000000000000,Block 2005, Block Group 2, Census Tract 110, Fulton County, Georgia,0,0,0,0,0,0,0,0
-1,131210110002018.000000000000000,Block 2018, Block Group 2, Census Tract 110, Fulton County, Georgia,0,0,0,0,0,0,0,0
-1,131210110002019.000000000000000,Block 2019, Block Group 2, Census Tract 110, Fulton County, Georgia,0,0,0,0,0,0,0,0
-1,131210110003000.000000000000000,Block 3000, Block Group 3, Census Tract 110, Fulton County, Georgia,0,0,0,0,0,0,0,0
-1,131210110003002.000000000000000,Block 3002, Block Group 3, Census Tract 110, Fulton County, Georgia,0,0,0,0,0,0,0,0
-1,131210110003007.000000000000000,Block 3007, Block Group 3, Census Tract 110, Fulton County, Georgia,0,0,0,0,0,0,0,0
-1,131210110003008.000000000000000,Block 3008, Block Group 3, Census Tract 110, Fulton County, Georgia,0,0,0,0,0,0,0,0
-1,131210110003018.000000000000000,Block 3018, Block Group 3, Census Tract 110, Fulton County, Georgia,0,0,0,0,0,0,0,0
-1,131210110003019.000000000000000,Block 3019, Block Group 3, Census Tract 110, Fulton County, Georgia,0,0,0,0,0,0,0,0
-1,131210111001002.000000000000000,Block 1002, Block Group 1, Census Tract 111, Fulton County, Georgia,0,0,0,0,0,0,0,0
-1,131210111001003.000000000000000,Block 1003, Block Group 1, Census Tract 111, Fulton County, Georgia,0,0,0,0,0,0,0,0
-1,131210111001004.000000000000000,Block 1004, Block Group 1, Census Tract 111, Fulton County, Georgia,0,0,0,0,0,0,0,0
-1,131210111001005.000000000000000,Block 1005, Block Group 1, Census Tract 111, Fulton County, Georgia,0,0,0,0,0,0,0,0
-1,131210111001006.000000000000000,Block 1006, Block Group 1, Census Tract 111, Fulton County, Georgia,0,0,0,0,0,0,0,0
-1,131210111001007.000000000000000,Block 1007, Block Group 1, Census Tract 111, Fulton County, Georgia,0,0,0,0,0,0,0,0
-1,131210111001008.000000000000000,Block 1008, Block Group 1, Census Tract 111, Fulton County, Georgia,0,0,0,0,0,0,0,0
-1,131210111001009.000000000000000,Block 1009, Block Group 1, Census Tract 111, Fulton County, Georgia,0,0,0,0,0,0,0,0
-1,131210111001010.000000000000000,Block 1010, Block Group 1, Census Tract 111, Fulton County, Georgia,0,0,0,0,0,0,0,0
-1,131210111001011.000000000000000,Block 1011, Block Group 1, Census Tract 111, Fulton County, Georgia,0,0,0,0,0,0,0,0
-1,131210111001012.000000000000000,Block 1012, Block Group 1, Census Tract 111, Fulton County, Georgia,0,0,0,0,0,0,0,0
-1,131210111001013.000000000000000,Block 1013, Block Group 1, Census Tract 111, Fulton County, Georgia,0,0,0,0,0,0,0,0
-1,131210111001016.000000000000000,Block 1016, Block Group 1, Census Tract 111, Fulton County, Georgia,0,0,0,0,0,0,0,0
-1,131210111001017.000000000000000,Block 1017, Block Group 1, Census Tract 111, Fulton County, Georgia,0,0,0,0,0,0,0,0
-1,131210111001018.000000000000000,Block 1018, Block Group 1, Census Tract 111, Fulton County, Georgia,0,0,0,0,0,0,0,0
-1,131210111001019.000000000000000,Block 1019, Block Group 1, Census Tract 111, Fulton County, Georgia,0,0,0,0,0,0,0,0
-1,131210111002006.000000000000000,Block 2006, Block Group 2, Census Tract 111, Fulton County, Georgia,0,0,0,0,0,0,0,0
-1,131210111002013.000000000000000,Block 2013, Block Group 2, Census Tract 111, Fulton County, Georgia,0,0,0,0,0,0,0,0
-1,131210111002014.000000000000000,Block 2014, Block Group 2, Census Tract 111, Fulton County, Georgia,0,0,0,0,0,0,0,0
-1,131210111002015.000000000000000,Block 2015, Block Group 2, Census Tract 111, Fulton County, Georgia,0,0,0,0,0,0,0,0
-1,131210111002016.000000000000000,Block 2016, Block Group 2, Census Tract 111, Fulton County, Georgia,0,0,0,0,0,0,0,0
-1,131210111002017.000000000000000,Block 2017, Block Group 2, Census Tract 111, Fulton County, Georgia,0,0,0,0,0,0,0,0
-1,131210111002018.000000000000000,Block 2018, Block Group 2, Census Tract 111, Fulton County, Georgia,0,0,0,0,0,0,0,0
-1,131210111002021.000000000000000,Block 2021, Block Group 2, Census Tract 111, Fulton County, Georgia,0,0,0,0,0,0,0,0
-1,131210112021000.000000000000000,Block 1000, Block Group 1, Census Tract 112.02, Fulton County, Georgia,0,0,0,0,0,0,0,0
-1,131210112023006.000000000000000,Block 3006, Block Group 3, Census Tract 112.02, Fulton County, Georgia,0,0,0,0,0,0,0,0
-1,131210112023007.000000000000000,Block 3007, Block Group 3, Census Tract 112.02, Fulton County, Georgia,0,0,0,0,0,0,0,0
-1,131210112023008.000000000000000,Block 3008, Block Group 3, Census Tract 112.02, Fulton County, Georgia,0,0,0,0,0,0,0,0
-1,131210112023010.000000000000000,Block 3010, Block Group 3, Census Tract 112.02, Fulton County, Georgia,0,0,0,0,0,0,0,0
-1,131210112023012.000000000000000,Block 3012, Block Group 3, Census Tract 112.02, Fulton County, Georgia,0,0,0,0,0,0,0,0
-1,131210112023013.000000000000000,Block 3013, Block Group 3, Census Tract 112.02, Fulton County, Georgia,0,0,0,0,0,0,0,0
-1,131210112023016.000000000000000,Block 3016, Block Group 3, Census Tract 112.02, Fulton County, Georgia,0,0,0,0,0,0,0,0
-1,131210112023017.000000000000000,Block 3017, Block Group 3, Census Tract 112.02, Fulton County, Georgia,0,0,0,0,0,0,0,0
-1,131210112023019.000000000000000,Block 3019, Block Group 3, Census Tract 112.02, Fulton County, Georgia,0,0,0,0,0,0,0,0
-1,131210112023020.000000000000000,Block 3020, Block Group 3, Census Tract 112.02, Fulton County, Georgia,0,0,0,0,0,0,0,0
-1,131210112023028.000000000000000,Block 3028, Block Group 3, Census Tract 112.02, Fulton County, Georgia,0,0,0,0,0,0,0,0
-1,131210112031000.000000000000000,Block 1000, Block Group 1, Census Tract 112.03, Fulton County, Georgia,0,0,0,0,0,0,0,0
-1,131210112031001.000000000000000,Block 1001, Block Group 1, Census Tract 112.03, Fulton County, Georgia,0,0,0,0,0,0,0,0
-1,131210112032012.000000000000000,Block 2012, Block Group 2, Census Tract 112.03, Fulton County, Georgia,0,0,0,0,0,0,0,0
-1,131210112032013.000000000000000,Block 2013, Block Group 2, Census Tract 112.03, Fulton County, Georgia,0,0,0,0,0,0,0,0
-1,131210112032024.000000000000000,Block 2024, Block Group 2, Census Tract 112.03, Fulton County, Georgia,0,0,0,0,0,0,0,0
-1,131210112032026.000000000000000,Block 2026, Block Group 2, Census Tract 112.03, Fulton County, Georgia,0,0,0,0,0,0,0,0
-1,131210112041000.000000000000000,Block 1000, Block Group 1, Census Tract 112.04, Fulton County, Georgia,0,0,0,0,0,0,0,0
-1,131210112041004.000000000000000,Block 1004, Block Group 1, Census Tract 112.04, Fulton County, Georgia,0,0,0,0,0,0,0,0
-1,131210112041009.000000000000000,Block 1009, Block Group 1, Census Tract 112.04, Fulton County, Georgia,0,0,0,0,0,0,0,0
-1,131210112041012.000000000000000,Block 1012, Block Group 1, Census Tract 112.04, Fulton County, Georgia,0,0,0,0,0,0,0,0
-1,131210112041013.000000000000000,Block 1013, Block Group 1, Census Tract 112.04, Fulton County, Georgia,0,0,0,0,0,0,0,0
-1,131210112041014.000000000000000,Block 1014, Block Group 1, Census Tract 112.04, Fulton County, Georgia,0,0,0,0,0,0,0,0
-1,131210112041016.000000000000000,Block 1016, Block Group 1, Census Tract 112.04, Fulton County, Georgia,0,0,0,0,0,0,0,0
-1,131210112042001.000000000000000,Block 2001, Block Group 2, Census Tract 112.04, Fulton County, Georgia,0,0,0,0,0,0,0,0
-1,131210112042007.000000000000000,Block 2007, Block Group 2, Census Tract 112.04, Fulton County, Georgia,0,0,0,0,0,0,0,0
-1,131210112042008.000000000000000,Block 2008, Block Group 2, Census Tract 112.04, Fulton County, Georgia,0,0,0,0,0,0,0,0
-1,131210112042009.000000000000000,Block 2009, Block Group 2, Census Tract 112.04, Fulton County, Georgia,0,0,0,0,0,0,0,0
-1,131210113011001.000000000000000,Block 1001, Block Group 1, Census Tract 113.01, Fulton County, Georgia,0,0,0,0,0,0,0,0
-1,131210113011014.000000000000000,Block 1014, Block Group 1, Census Tract 113.01, Fulton County, Georgia,0,0,0,0,0,0,0,0
-1,131210113015006.000000000000000,Block 5006, Block Group 5, Census Tract 113.01, Fulton County, Georgia,0,0,0,0,0,0,0,0
-1,131210113061000.000000000000000,Block 1000, Block Group 1, Census Tract 113.06, Fulton County, Georgia,0,0,0,0,0,0,0,0
-1,131210113061002.000000000000000,Block 1002, Block Group 1, Census Tract 113.06, Fulton County, Georgia,0,0,0,0,0,0,0,0
-1,131210113061003.000000000000000,Block 1003, Block Group 1, Census Tract 113.06, Fulton County, Georgia,0,0,0,0,0,0,0,0
-1,131210113061004.000000000000000,Block 1004, Block Group 1, Census Tract 113.06, Fulton County, Georgia,0,0,0,0,0,0,0,0
-1,131210113061005.000000000000000,Block 1005, Block Group 1, Census Tract 113.06, Fulton County, Georgia,0,0,0,0,0,0,0,0
-1,131210113061006.000000000000000,Block 1006, Block Group 1, Census Tract 113.06, Fulton County, Georgia,0,0,0,0,0,0,0,0
-1,131210113061007.000000000000000,Block 1007, Block Group 1, Census Tract 113.06, Fulton County, Georgia,0,0,0,0,0,0,0,0
-1,131210113061008.000000000000000,Block 1008, Block Group 1, Census Tract 113.06, Fulton County, Georgia,0,0,0,0,0,0,0,0
-1,131210113061013.000000000000000,Block 1013, Block Group 1, Census Tract 113.06, Fulton County, Georgia,0,0,0,0,0,0,0,0
-1,131210113061014.000000000000000,Block 1014, Block Group 1, Census Tract 113.06, Fulton County, Georgia,0,0,0,0,0,0,0,0
-1,131210113061015.000000000000000,Block 1015, Block Group 1, Census Tract 113.06, Fulton County, Georgia,0,0,0,0,0,0,0,0
-1,131210113061018.000000000000000,Block 1018, Block Group 1, Census Tract 113.06, Fulton County, Georgia,0,0,0,0,0,0,0,0
-1,131210113061019.000000000000000,Block 1019, Block Group 1, Census Tract 113.06, Fulton County, Georgia,0,0,0,0,0,0,0,0
-1,131210113061020.000000000000000,Block 1020, Block Group 1, Census Tract 113.06, Fulton County, Georgia,0,0,0,0,0,0,0,0
-1,131210113061021.000000000000000,Block 1021, Block Group 1, Census Tract 113.06, Fulton County, Georgia,0,0,0,0,0,0,0,0
-1,131210113061022.000000000000000,Block 1022, Block Group 1, Census Tract 113.06, Fulton County, Georgia,0,0,0,0,0,0,0,0
-1,131210113061024.000000000000000,Block 1024, Block Group 1, Census Tract 113.06, Fulton County, Georgia,0,0,0,0,0,0,0,0
-1,131210113062000.000000000000000,Block 2000, Block Group 2, Census Tract 113.06, Fulton County, Georgia,0,0,0,0,0,0,0,0
-1,131210113062003.000000000000000,Block 2003, Block Group 2, Census Tract 113.06, Fulton County, Georgia,0,0,0,0,0,0,0,0
-1,131210113062006.000000000000000,Block 2006, Block Group 2, Census Tract 113.06, Fulton County, Georgia,0,0,0,0,0,0,0,0
-1,131210113063000.000000000000000,Block 3000, Block Group 3, Census Tract 113.06, Fulton County, Georgia,0,0,0,0,0,0,0,0
-1,131210113063002.000000000000000,Block 3002, Block Group 3, Census Tract 113.06, Fulton County, Georgia,0,0,0,0,0,0,0,0
-1,131210113063003.000000000000000,Block 3003, Block Group 3, Census Tract 113.06, Fulton County, Georgia,0,0,0,0,0,0,0,0
-1,131210113063004.000000000000000,Block 3004, Block Group 3, Census Tract 113.06, Fulton County, Georgia,0,0,0,0,0,0,0,0
-1,131210113063006.000000000000000,Block 3006, Block Group 3, Census Tract 113.06, Fulton County, Georgia,0,0,0,0,0,0,0,0
-1,131210113063007.000000000000000,Block 3007, Block Group 3, Census Tract 113.06, Fulton County, Georgia,0,0,0,0,0,0,0,0
-1,131210113063008.000000000000000,Block 3008, Block Group 3, Census Tract 113.06, Fulton County, Georgia,0,0,0,0,0,0,0,0
-1,131210113063009.000000000000000,Block 3009, Block Group 3, Census Tract 113.06, Fulton County, Georgia,0,0,0,0,0,0,0,0
-1,131210113063010.000000000000000,Block 3010, Block Group 3, Census Tract 113.06, Fulton County, Georgia,0,0,0,0,0,0,0,0
-1,131210113071005.000000000000000,Block 1005, Block Group 1, Census Tract 113.07, Fulton County, Georgia,0,0,0,0,0,0,0,0
-1,131210113071006.000000000000000,Block 1006, Block Group 1, Census Tract 113.07, Fulton County, Georgia,0,0,0,0,0,0,0,0
-1,131210113071007.000000000000000,Block 1007, Block Group 1, Census Tract 113.07, Fulton County, Georgia,0,0,0,0,0,0,0,0
-1,131210113071008.000000000000000,Block 1008, Block Group 1, Census Tract 113.07, Fulton County, Georgia,0,0,0,0,0,0,0,0
-1,131210113071013.000000000000000,Block 1013, Block Group 1, Census Tract 113.07, Fulton County, Georgia,0,0,0,0,0,0,0,0
-1,131210113072002.000000000000000,Block 2002, Block Group 2, Census Tract 113.07, Fulton County, Georgia,0,0,0,0,0,0,0,0
-1,131210113072004.000000000000000,Block 2004, Block Group 2, Census Tract 113.07, Fulton County, Georgia,0,0,0,0,0,0,0,0
-1,131210113072005.000000000000000,Block 2005, Block Group 2, Census Tract 113.07, Fulton County, Georgia,0,0,0,0,0,0,0,0
-1,131210113073000.000000000000000,Block 3000, Block Group 3, Census Tract 113.07, Fulton County, Georgia,0,0,0,0,0,0,0,0
-1,131210113073008.000000000000000,Block 3008, Block Group 3, Census Tract 113.07, Fulton County, Georgia,0,0,0,0,0,0,0,0
-1,131210113081010.000000000000000,Block 1010, Block Group 1, Census Tract 113.08, Fulton County, Georgia,0,0,0,0,0,0,0,0
-1,131210113081014.000000000000000,Block 1014, Block Group 1, Census Tract 113.08, Fulton County, Georgia,0,0,0,0,0,0,0,0
-1,131210113081015.000000000000000,Block 1015, Block Group 1, Census Tract 113.08, Fulton County, Georgia,0,0,0,0,0,0,0,0
-1,131210113081016.000000000000000,Block 1016, Block Group 1, Census Tract 113.08, Fulton County, Georgia,0,0,0,0,0,0,0,0
-1,131210113092000.000000000000000,Block 2000, Block Group 2, Census Tract 113.09, Fulton County, Georgia,0,0,0,0,0,0,0,0
-1,131210113092001.000000000000000,Block 2001, Block Group 2, Census Tract 113.09, Fulton County, Georgia,0,0,0,0,0,0,0,0
-1,131210113101001.000000000000000,Block 1001, Block Group 1, Census Tract 113.10, Fulton County, Georgia,0,0,0,0,0,0,0,0
-1,131210113101003.000000000000000,Block 1003, Block Group 1, Census Tract 113.10, Fulton County, Georgia,0,0,0,0,0,0,0,0
-1,131210113101004.000000000000000,Block 1004, Block Group 1, Census Tract 113.10, Fulton County, Georgia,0,0,0,0,0,0,0,0
-1,131210113102013.000000000000000,Block 2013, Block Group 2, Census Tract 113.10, Fulton County, Georgia,0,0,0,0,0,0,0,0
-1,131210113103006.000000000000000,Block 3006, Block Group 3, Census Tract 113.10, Fulton County, Georgia,0,0,0,0,0,0,0,0
-1,131210113103007.000000000000000,Block 3007, Block Group 3, Census Tract 113.10, Fulton County, Georgia,0,0,0,0,0,0,0,0
-1,131210113103008.000000000000000,Block 3008, Block Group 3, Census Tract 113.10, Fulton County, Georgia,0,0,0,0,0,0,0,0
-1,131210113103009.000000000000000,Block 3009, Block Group 3, Census Tract 113.10, Fulton County, Georgia,0,0,0,0,0,0,0,0
-1,131210113105010.000000000000000,Block 5010, Block Group 5, Census Tract 113.10, Fulton County, Georgia,0,0,0,0,0,0,0,0
-1,131210114162007.000000000000000,Block 2007, Block Group 2, Census Tract 114.16, Fulton County, Georgia,0,0,0,0,0,0,0,0
-1,131210114163007.000000000000000,Block 3007, Block Group 3, Census Tract 114.16, Fulton County, Georgia,0,0,0,0,0,0,0,0
-1,131210114164005.000000000000000,Block 4005, Block Group 4, Census Tract 114.16, Fulton County, Georgia,0,0,0,0,0,0,0,0
-1,131210114164009.000000000000000,Block 4009, Block Group 4, Census Tract 114.16, Fulton County, Georgia,0,0,0,0,0,0,0,0
-1,131210114171006.000000000000000,Block 1006, Block Group 1, Census Tract 114.17, Fulton County, Georgia,0,0,0,0,0,0,0,0
-1,131210114172014.000000000000000,Block 2014, Block Group 2, Census Tract 114.17, Fulton County, Georgia,0,0,0,0,0,0,0,0
-1,131210114173001.000000000000000,Block 3001, Block Group 3, Census Tract 114.17, Fulton County, Georgia,0,0,0,0,0,0,0,0
-1,131210114174000.000000000000000,Block 4000, Block Group 4, Census Tract 114.17, Fulton County, Georgia,0,0,0,0,0,0,0,0
-1,131210114191000.000000000000000,Block 1000, Block Group 1, Census Tract 114.19, Fulton County, Georgia,0,0,0,0,0,0,0,0
-1,131210114191001.000000000000000,Block 1001, Block Group 1, Census Tract 114.19, Fulton County, Georgia,0,0,0,0,0,0,0,0
-1,131210114191008.000000000000000,Block 1008, Block Group 1, Census Tract 114.19, Fulton County, Georgia,0,0,0,0,0,0,0,0
-1,131210114192000.000000000000000,Block 2000, Block Group 2, Census Tract 114.19, Fulton County, Georgia,0,0,0,0,0,0,0,0
-1,131210114192007.000000000000000,Block 2007, Block Group 2, Census Tract 114.19, Fulton County, Georgia,0,0,0,0,0,0,0,0
-1,131210114192009.000000000000000,Block 2009, Block Group 2, Census Tract 114.19, Fulton County, Georgia,0,0,0,0,0,0,0,0
-1,131210114192014.000000000000000,Block 2014, Block Group 2, Census Tract 114.19, Fulton County, Georgia,0,0,0,0,0,0,0,0
-1,131210114192015.000000000000000,Block 2015, Block Group 2, Census Tract 114.19, Fulton County, Georgia,0,0,0,0,0,0,0,0
-1,131210114193000.000000000000000,Block 3000, Block Group 3, Census Tract 114.19, Fulton County, Georgia,0,0,0,0,0,0,0,0
-1,131210114194000.000000000000000,Block 4000, Block Group 4, Census Tract 114.19, Fulton County, Georgia,0,0,0,0,0,0,0,0
-1,131210114194001.000000000000000,Block 4001, Block Group 4, Census Tract 114.19, Fulton County, Georgia,0,0,0,0,0,0,0,0
-1,131210114194002.000000000000000,Block 4002, Block Group 4, Census Tract 114.19, Fulton County, Georgia,0,0,0,0,0,0,0,0
-1,131210114194003.000000000000000,Block 4003, Block Group 4, Census Tract 114.19, Fulton County, Georgia,0,0,0,0,0,0,0,0
-1,131210114194006.000000000000000,Block 4006, Block Group 4, Census Tract 114.19, Fulton County, Georgia,0,0,0,0,0,0,0,0
-1,131210114194016.000000000000000,Block 4016, Block Group 4, Census Tract 114.19, Fulton County, Georgia,0,0,0,0,0,0,0,0
-1,131210114194026.000000000000000,Block 4026, Block Group 4, Census Tract 114.19, Fulton County, Georgia,0,0,0,0,0,0,0,0
-1,131210114194027.000000000000000,Block 4027, Block Group 4, Census Tract 114.19, Fulton County, Georgia,0,0,0,0,0,0,0,0
-1,131210114194028.000000000000000,Block 4028, Block Group 4, Census Tract 114.19, Fulton County, Georgia,0,0,0,0,0,0,0,0
-1,131210114211000.000000000000000,Block 1000, Block Group 1, Census Tract 114.21, Fulton County, Georgia,0,0,0,0,0,0,0,0
-1,131210114211001.000000000000000,Block 1001, Block Group 1, Census Tract 114.21, Fulton County, Georgia,0,0,0,0,0,0,0,0
-1,131210114211003.000000000000000,Block 1003, Block Group 1, Census Tract 114.21, Fulton County, Georgia,0,0,0,0,0,0,0,0
-1,131210114211006.000000000000000,Block 1006, Block Group 1, Census Tract 114.21, Fulton County, Georgia,0,0,0,0,0,0,0,0
-1,131210114211007.000000000000000,Block 1007, Block Group 1, Census Tract 114.21, Fulton County, Georgia,0,0,0,0,0,0,0,0
-1,131210114211008.000000000000000,Block 1008, Block Group 1, Census Tract 114.21, Fulton County, Georgia,0,0,0,0,0,0,0,0
-1,131210114212003.000000000000000,Block 2003, Block Group 2, Census Tract 114.21, Fulton County, Georgia,0,0,0,0,0,0,0,0
-1,131210114212004.000000000000000,Block 2004, Block Group 2, Census Tract 114.21, Fulton County, Georgia,0,0,0,0,0,0,0,0
-1,131210114212005.000000000000000,Block 2005, Block Group 2, Census Tract 114.21, Fulton County, Georgia,0,0,0,0,0,0,0,0
-1,131210114212006.000000000000000,Block 2006, Block Group 2, Census Tract 114.21, Fulton County, Georgia,0,0,0,0,0,0,0,0
-1,131210114214000.000000000000000,Block 4000, Block Group 4, Census Tract 114.21, Fulton County, Georgia,0,0,0,0,0,0,0,0
-1,131210114214001.000000000000000,Block 4001, Block Group 4, Census Tract 114.21, Fulton County, Georgia,0,0,0,0,0,0,0,0
-1,131210114214003.000000000000000,Block 4003, Block Group 4, Census Tract 114.21, Fulton County, Georgia,0,0,0,0,0,0,0,0
-1,131210114214004.000000000000000,Block 4004, Block Group 4, Census Tract 114.21, Fulton County, Georgia,0,0,0,0,0,0,0,0
-1,131210114214006.000000000000000,Block 4006, Block Group 4, Census Tract 114.21, Fulton County, Georgia,0,0,0,0,0,0,0,0
-1,131210114221000.000000000000000,Block 1000, Block Group 1, Census Tract 114.22, Fulton County, Georgia,0,0,0,0,0,0,0,0
-1,131210114221004.000000000000000,Block 1004, Block Group 1, Census Tract 114.22, Fulton County, Georgia,0,0,0,0,0,0,0,0
-1,131210114221007.000000000000000,Block 1007, Block Group 1, Census Tract 114.22, Fulton County, Georgia,0,0,0,0,0,0,0,0
-1,131210114222006.000000000000000,Block 2006, Block Group 2, Census Tract 114.22, Fulton County, Georgia,0,0,0,0,0,0,0,0
-1,131210114222007.000000000000000,Block 2007, Block Group 2, Census Tract 114.22, Fulton County, Georgia,0,0,0,0,0,0,0,0
-1,131210114223000.000000000000000,Block 3000, Block Group 3, Census Tract 114.22, Fulton County, Georgia,0,0,0,0,0,0,0,0
-1,131210114223013.000000000000000,Block 3013, Block Group 3, Census Tract 114.22, Fulton County, Georgia,0,0,0,0,0,0,0,0
-1,131210114231010.000000000000000,Block 1010, Block Group 1, Census Tract 114.23, Fulton County, Georgia,0,0,0,0,0,0,0,0
-1,131210114241004.000000000000000,Block 1004, Block Group 1, Census Tract 114.24, Fulton County, Georgia,0,0,0,0,0,0,0,0
-1,131210114241005.000000000000000,Block 1005, Block Group 1, Census Tract 114.24, Fulton County, Georgia,0,0,0,0,0,0,0,0
-1,131210114241007.000000000000000,Block 1007, Block Group 1, Census Tract 114.24, Fulton County, Georgia,0,0,0,0,0,0,0,0
-1,131210114241010.000000000000000,Block 1010, Block Group 1, Census Tract 114.24, Fulton County, Georgia,0,0,0,0,0,0,0,0
-1,131210114241011.000000000000000,Block 1011, Block Group 1, Census Tract 114.24, Fulton County, Georgia,0,0,0,0,0,0,0,0
-1,131210114242001.000000000000000,Block 2001, Block Group 2, Census Tract 114.24, Fulton County, Georgia,0,0,0,0,0,0,0,0
-1,131210114242003.000000000000000,Block 2003, Block Group 2, Census Tract 114.24, Fulton County, Georgia,0,0,0,0,0,0,0,0
-1,131210114244000.000000000000000,Block 4000, Block Group 4, Census Tract 114.24, Fulton County, Georgia,0,0,0,0,0,0,0,0
-1,131210114261000.000000000000000,Block 1000, Block Group 1, Census Tract 114.26, Fulton County, Georgia,0,0,0,0,0,0,0,0
-1,131210114261003.000000000000000,Block 1003, Block Group 1, Census Tract 114.26, Fulton County, Georgia,0,0,0,0,0,0,0,0
-1,131210114281003.000000000000000,Block 1003, Block Group 1, Census Tract 114.28, Fulton County, Georgia,0,0,0,0,0,0,0,0
-1,131210114281005.000000000000000,Block 1005, Block Group 1, Census Tract 114.28, Fulton County, Georgia,0,0,0,0,0,0,0,0
-1,131210114281006.000000000000000,Block 1006, Block Group 1, Census Tract 114.28, Fulton County, Georgia,0,0,0,0,0,0,0,0
-1,131210114282002.000000000000000,Block 2002, Block Group 2, Census Tract 114.28, Fulton County, Georgia,0,0,0,0,0,0,0,0
-1,131210114292001.000000000000000,Block 2001, Block Group 2, Census Tract 114.29, Fulton County, Georgia,0,0,0,0,0,0,0,0
-1,131210114292006.000000000000000,Block 2006, Block Group 2, Census Tract 114.29, Fulton County, Georgia,0,0,0,0,0,0,0,0
-1,131210114292008.000000000000000,Block 2008, Block Group 2, Census Tract 114.29, Fulton County, Georgia,0,0,0,0,0,0,0,0
-1,131210114292009.000000000000000,Block 2009, Block Group 2, Census Tract 114.29, Fulton County, Georgia,0,0,0,0,0,0,0,0
-1,131210114293001.000000000000000,Block 3001, Block Group 3, Census Tract 114.29, Fulton County, Georgia,0,0,0,0,0,0,0,0
-1,131210114293004.000000000000000,Block 3004, Block Group 3, Census Tract 114.29, Fulton County, Georgia,0,0,0,0,0,0,0,0
-1,131210114294002.000000000000000,Block 4002, Block Group 4, Census Tract 114.29, Fulton County, Georgia,0,0,0,0,0,0,0,0
-1,131210114294005.000000000000000,Block 4005, Block Group 4, Census Tract 114.29, Fulton County, Georgia,0,0,0,0,0,0,0,0
-1,131210114301000.000000000000000,Block 1000, Block Group 1, Census Tract 114.30, Fulton County, Georgia,0,0,0,0,0,0,0,0
-1,131210114301006.000000000000000,Block 1006, Block Group 1, Census Tract 114.30, Fulton County, Georgia,0,0,0,0,0,0,0,0
-1,131210114301009.000000000000000,Block 1009, Block Group 1, Census Tract 114.30, Fulton County, Georgia,0,0,0,0,0,0,0,0
-1,131210114302005.000000000000000,Block 2005, Block Group 2, Census Tract 114.30, Fulton County, Georgia,0,0,0,0,0,0,0,0
-1,131210114331000.000000000000000,Block 1000, Block Group 1, Census Tract 114.33, Fulton County, Georgia,0,0,0,0,0,0,0,0
-1,131210114332001.000000000000000,Block 2001, Block Group 2, Census Tract 114.33, Fulton County, Georgia,0,0,0,0,0,0,0,0
-1,131210114332003.000000000000000,Block 2003, Block Group 2, Census Tract 114.33, Fulton County, Georgia,0,0,0,0,0,0,0,0
-1,131210114332004.000000000000000,Block 2004, Block Group 2, Census Tract 114.33, Fulton County, Georgia,0,0,0,0,0,0,0,0
-1,131210114332005.000000000000000,Block 2005, Block Group 2, Census Tract 114.33, Fulton County, Georgia,0,0,0,0,0,0,0,0
-1,131210114333001.000000000000000,Block 3001, Block Group 3, Census Tract 114.33, Fulton County, Georgia,0,0,0,0,0,0,0,0
-1,131210114341000.000000000000000,Block 1000, Block Group 1, Census Tract 114.34, Fulton County, Georgia,0,0,0,0,0,0,0,0
-1,131210114341001.000000000000000,Block 1001, Block Group 1, Census Tract 114.34, Fulton County, Georgia,0,0,0,0,0,0,0,0
-1,131210114341002.000000000000000,Block 1002, Block Group 1, Census Tract 114.34, Fulton County, Georgia,0,0,0,0,0,0,0,0
-1,131210114341003.000000000000000,Block 1003, Block Group 1, Census Tract 114.34, Fulton County, Georgia,0,0,0,0,0,0,0,0
-1,131210114341005.000000000000000,Block 1005, Block Group 1, Census Tract 114.34, Fulton County, Georgia,0,0,0,0,0,0,0,0
-1,131210114341006.000000000000000,Block 1006, Block Group 1, Census Tract 114.34, Fulton County, Georgia,0,0,0,0,0,0,0,0
-1,131210114341007.000000000000000,Block 1007, Block Group 1, Census Tract 114.34, Fulton County, Georgia,0,0,0,0,0,0,0,0
-1,131210114341008.000000000000000,Block 1008, Block Group 1, Census Tract 114.34, Fulton County, Georgia,0,0,0,0,0,0,0,0
-1,131210114342002.000000000000000,Block 2002, Block Group 2, Census Tract 114.34, Fulton County, Georgia,0,0,0,0,0,0,0,0
-1,131210114342004.000000000000000,Block 2004, Block Group 2, Census Tract 114.34, Fulton County, Georgia,0,0,0,0,0,0,0,0
-1,131210114342005.000000000000000,Block 2005, Block Group 2, Census Tract 114.34, Fulton County, Georgia,0,0,0,0,0,0,0,0
-1,131210114351001.000000000000000,Block 1001, Block Group 1, Census Tract 114.35, Fulton County, Georgia,0,0,0,0,0,0,0,0
-1,131210114351004.000000000000000,Block 1004, Block Group 1, Census Tract 114.35, Fulton County, Georgia,0,0,0,0,0,0,0,0
-1,131210114351005.000000000000000,Block 1005, Block Group 1, Census Tract 114.35, Fulton County, Georgia,0,0,0,0,0,0,0,0
-1,131210114351006.000000000000000,Block 1006, Block Group 1, Census Tract 114.35, Fulton County, Georgia,0,0,0,0,0,0,0,0
-1,131210114351007.000000000000000,Block 1007, Block Group 1, Census Tract 114.35, Fulton County, Georgia,0,0,0,0,0,0,0,0
-1,131210114352012.000000000000000,Block 2012, Block Group 2, Census Tract 114.35, Fulton County, Georgia,0,0,0,0,0,0,0,0
-1,131210114353010.000000000000000,Block 3010, Block Group 3, Census Tract 114.35, Fulton County, Georgia,0,0,0,0,0,0,0,0
-1,131210114353012.000000000000000,Block 3012, Block Group 3, Census Tract 114.35, Fulton County, Georgia,0,0,0,0,0,0,0,0
-1,131210114353013.000000000000000,Block 3013, Block Group 3, Census Tract 114.35, Fulton County, Georgia,0,0,0,0,0,0,0,0
-1,131210114353014.000000000000000,Block 3014, Block Group 3, Census Tract 114.35, Fulton County, Georgia,0,0,0,0,0,0,0,0
-1,131210114353015.000000000000000,Block 3015, Block Group 3, Census Tract 114.35, Fulton County, Georgia,0,0,0,0,0,0,0,0
-1,131210114353016.000000000000000,Block 3016, Block Group 3, Census Tract 114.35, Fulton County, Georgia,0,0,0,0,0,0,0,0
-1,131210114353017.000000000000000,Block 3017, Block Group 3, Census Tract 114.35, Fulton County, Georgia,0,0,0,0,0,0,0,0
-1,131210114353018.000000000000000,Block 3018, Block Group 3, Census Tract 114.35, Fulton County, Georgia,0,0,0,0,0,0,0,0
-1,131210114361000.000000000000000,Block 1000, Block Group 1, Census Tract 114.36, Fulton County, Georgia,0,0,0,0,0,0,0,0
-1,131210114361006.000000000000000,Block 1006, Block Group 1, Census Tract 114.36, Fulton County, Georgia,0,0,0,0,0,0,0,0
-1,131210114361008.000000000000000,Block 1008, Block Group 1, Census Tract 114.36, Fulton County, Georgia,0,0,0,0,0,0,0,0
-1,131210114363004.000000000000000,Block 3004, Block Group 3, Census Tract 114.36, Fulton County, Georgia,0,0,0,0,0,0,0,0
-1,131210114363008.000000000000000,Block 3008, Block Group 3, Census Tract 114.36, Fulton County, Georgia,0,0,0,0,0,0,0,0
-1,131210114363010.000000000000000,Block 3010, Block Group 3, Census Tract 114.36, Fulton County, Georgia,0,0,0,0,0,0,0,0
-1,131210114363011.000000000000000,Block 3011, Block Group 3, Census Tract 114.36, Fulton County, Georgia,0,0,0,0,0,0,0,0
-1,131210114363012.000000000000000,Block 3012, Block Group 3, Census Tract 114.36, Fulton County, Georgia,0,0,0,0,0,0,0,0
-1,131210114363013.000000000000000,Block 3013, Block Group 3, Census Tract 114.36, Fulton County, Georgia,0,0,0,0,0,0,0,0
-1,131210114371003.000000000000000,Block 1003, Block Group 1, Census Tract 114.37, Fulton County, Georgia,0,0,0,0,0,0,0,0
-1,131210114371005.000000000000000,Block 1005, Block Group 1, Census Tract 114.37, Fulton County, Georgia,0,0,0,0,0,0,0,0
-1,131210114371009.000000000000000,Block 1009, Block Group 1, Census Tract 114.37, Fulton County, Georgia,0,0,0,0,0,0,0,0
-1,131210114371012.000000000000000,Block 1012, Block Group 1, Census Tract 114.37, Fulton County, Georgia,0,0,0,0,0,0,0,0
-1,131210114371013.000000000000000,Block 1013, Block Group 1, Census Tract 114.37, Fulton County, Georgia,0,0,0,0,0,0,0,0
-1,131210114371014.000000000000000,Block 1014, Block Group 1, Census Tract 114.37, Fulton County, Georgia,0,0,0,0,0,0,0,0
-1,131210114372000.000000000000000,Block 2000, Block Group 2, Census Tract 114.37, Fulton County, Georgia,0,0,0,0,0,0,0,0
-1,131210114372001.000000000000000,Block 2001, Block Group 2, Census Tract 114.37, Fulton County, Georgia,0,0,0,0,0,0,0,0
-1,131210114372002.000000000000000,Block 2002, Block Group 2, Census Tract 114.37, Fulton County, Georgia,0,0,0,0,0,0,0,0
-1,131210114372004.000000000000000,Block 2004, Block Group 2, Census Tract 114.37, Fulton County, Georgia,0,0,0,0,0,0,0,0
-1,131210114372011.000000000000000,Block 2011, Block Group 2, Census Tract 114.37, Fulton County, Georgia,0,0,0,0,0,0,0,0
-1,131210114372012.000000000000000,Block 2012, Block Group 2, Census Tract 114.37, Fulton County, Georgia,0,0,0,0,0,0,0,0
-1,131210114372013.000000000000000,Block 2013, Block Group 2, Census Tract 114.37, Fulton County, Georgia,0,0,0,0,0,0,0,0
-1,131210114372016.000000000000000,Block 2016, Block Group 2, Census Tract 114.37, Fulton County, Georgia,0,0,0,0,0,0,0,0
-1,131210114373004.000000000000000,Block 3004, Block Group 3, Census Tract 114.37, Fulton County, Georgia,0,0,0,0,0,0,0,0
-1,131210114381000.000000000000000,Block 1000, Block Group 1, Census Tract 114.38, Fulton County, Georgia,0,0,0,0,0,0,0,0
-1,131210114381001.000000000000000,Block 1001, Block Group 1, Census Tract 114.38, Fulton County, Georgia,0,0,0,0,0,0,0,0
-1,131210114381003.000000000000000,Block 1003, Block Group 1, Census Tract 114.38, Fulton County, Georgia,0,0,0,0,0,0,0,0
-1,131210114382000.000000000000000,Block 2000, Block Group 2, Census Tract 114.38, Fulton County, Georgia,0,0,0,0,0,0,0,0
-1,131210114382001.000000000000000,Block 2001, Block Group 2, Census Tract 114.38, Fulton County, Georgia,0,0,0,0,0,0,0,0
-1,131210114382005.000000000000000,Block 2005, Block Group 2, Census Tract 114.38, Fulton County, Georgia,0,0,0,0,0,0,0,0
-1,131210114382014.000000000000000,Block 2014, Block Group 2, Census Tract 114.38, Fulton County, Georgia,0,0,0,0,0,0,0,0
-1,131210114382017.000000000000000,Block 2017, Block Group 2, Census Tract 114.38, Fulton County, Georgia,0,0,0,0,0,0,0,0
-1,131210114383000.000000000000000,Block 3000, Block Group 3, Census Tract 114.38, Fulton County, Georgia,0,0,0,0,0,0,0,0
-1,131210114384000.000000000000000,Block 4000, Block Group 4, Census Tract 114.38, Fulton County, Georgia,0,0,0,0,0,0,0,0
-1,131210114391001.000000000000000,Block 1001, Block Group 1, Census Tract 114.39, Fulton County, Georgia,0,0,0,0,0,0,0,0
-1,131210114391002.000000000000000,Block 1002, Block Group 1, Census Tract 114.39, Fulton County, Georgia,0,0,0,0,0,0,0,0
-1,131210114392002.000000000000000,Block 2002, Block Group 2, Census Tract 114.39, Fulton County, Georgia,0,0,0,0,0,0,0,0
-1,131210114392003.000000000000000,Block 2003, Block Group 2, Census Tract 114.39, Fulton County, Georgia,0,0,0,0,0,0,0,0
-1,131210114392004.000000000000000,Block 2004, Block Group 2, Census Tract 114.39, Fulton County, Georgia,0,0,0,0,0,0,0,0
-1,131210114392007.000000000000000,Block 2007, Block Group 2, Census Tract 114.39, Fulton County, Georgia,0,0,0,0,0,0,0,0
-1,131210114392008.000000000000000,Block 2008, Block Group 2, Census Tract 114.39, Fulton County, Georgia,0,0,0,0,0,0,0,0
-1,131210114392009.000000000000000,Block 2009, Block Group 2, Census Tract 114.39, Fulton County, Georgia,0,0,0,0,0,0,0,0
-1,131210114401005.000000000000000,Block 1005, Block Group 1, Census Tract 114.40, Fulton County, Georgia,0,0,0,0,0,0,0,0
-1,131210114401006.000000000000000,Block 1006, Block Group 1, Census Tract 114.40, Fulton County, Georgia,0,0,0,0,0,0,0,0
-1,131210114401007.000000000000000,Block 1007, Block Group 1, Census Tract 114.40, Fulton County, Georgia,0,0,0,0,0,0,0,0
-1,131210114401008.000000000000000,Block 1008, Block Group 1, Census Tract 114.40, Fulton County, Georgia,0,0,0,0,0,0,0,0
-1,131210114401009.000000000000000,Block 1009, Block Group 1, Census Tract 114.40, Fulton County, Georgia,0,0,0,0,0,0,0,0
-1,131210114401010.000000000000000,Block 1010, Block Group 1, Census Tract 114.40, Fulton County, Georgia,0,0,0,0,0,0,0,0
-1,131210114411005.000000000000000,Block 1005, Block Group 1, Census Tract 114.41, Fulton County, Georgia,0,0,0,0,0,0,0,0
-1,131210114412000.000000000000000,Block 2000, Block Group 2, Census Tract 114.41, Fulton County, Georgia,0,0,0,0,0,0,0,0
-1,131210114413005.000000000000000,Block 3005, Block Group 3, Census Tract 114.41, Fulton County, Georgia,0,0,0,0,0,0,0,0
-1,131210114422015.000000000000000,Block 2015, Block Group 2, Census Tract 114.42, Fulton County, Georgia,0,0,0,0,0,0,0,0
-1,131210114441003.000000000000000,Block 1003, Block Group 1, Census Tract 114.44, Fulton County, Georgia,0,0,0,0,0,0,0,0
-1,131210114441007.000000000000000,Block 1007, Block Group 1, Census Tract 114.44, Fulton County, Georgia,0,0,0,0,0,0,0,0
-1,131210114442000.000000000000000,Block 2000, Block Group 2, Census Tract 114.44, Fulton County, Georgia,0,0,0,0,0,0,0,0
-1,131210114442003.000000000000000,Block 2003, Block Group 2, Census Tract 114.44, Fulton County, Georgia,0,0,0,0,0,0,0,0
-1,131210114442004.000000000000000,Block 2004, Block Group 2, Census Tract 114.44, Fulton County, Georgia,0,0,0,0,0,0,0,0
-1,131210114442005.000000000000000,Block 2005, Block Group 2, Census Tract 114.44, Fulton County, Georgia,0,0,0,0,0,0,0,0
-1,131210114442006.000000000000000,Block 2006, Block Group 2, Census Tract 114.44, Fulton County, Georgia,0,0,0,0,0,0,0,0
-1,131210114442007.000000000000000,Block 2007, Block Group 2, Census Tract 114.44, Fulton County, Georgia,0,0,0,0,0,0,0,0
-1,131210114442008.000000000000000,Block 2008, Block Group 2, Census Tract 114.44, Fulton County, Georgia,0,0,0,0,0,0,0,0
-1,131210114442014.000000000000000,Block 2014, Block Group 2, Census Tract 114.44, Fulton County, Georgia,0,0,0,0,0,0,0,0
-1,131210114442015.000000000000000,Block 2015, Block Group 2, Census Tract 114.44, Fulton County, Georgia,0,0,0,0,0,0,0,0
-1,131210114451015.000000000000000,Block 1015, Block Group 1, Census Tract 114.45, Fulton County, Georgia,0,0,0,0,0,0,0,0
-1,131210114451016.000000000000000,Block 1016, Block Group 1, Census Tract 114.45, Fulton County, Georgia,0,0,0,0,0,0,0,0
-1,131210114461000.000000000000000,Block 1000, Block Group 1, Census Tract 114.46, Fulton County, Georgia,0,0,0,0,0,0,0,0
-1,131210114461006.000000000000000,Block 1006, Block Group 1, Census Tract 114.46, Fulton County, Georgia,0,0,0,0,0,0,0,0
-1,131210114461007.000000000000000,Block 1007, Block Group 1, Census Tract 114.46, Fulton County, Georgia,0,0,0,0,0,0,0,0
-1,131210114461008.000000000000000,Block 1008, Block Group 1, Census Tract 114.46, Fulton County, Georgia,0,0,0,0,0,0,0,0
-1,131210114461009.000000000000000,Block 1009, Block Group 1, Census Tract 114.46, Fulton County, Georgia,0,0,0,0,0,0,0,0
-1,131210115052002.000000000000000,Block 2002, Block Group 2, Census Tract 115.05, Fulton County, Georgia,0,0,0,0,0,0,0,0
-1,131210115053006.000000000000000,Block 3006, Block Group 3, Census Tract 115.05, Fulton County, Georgia,0,0,0,0,0,0,0,0
-1,131210115053010.000000000000000,Block 3010, Block Group 3, Census Tract 115.05, Fulton County, Georgia,0,0,0,0,0,0,0,0
-1,131210115053011.000000000000000,Block 3011, Block Group 3, Census Tract 115.05, Fulton County, Georgia,0,0,0,0,0,0,0,0
-1,131210115071000.000000000000000,Block 1000, Block Group 1, Census Tract 115.07, Fulton County, Georgia,0,0,0,0,0,0,0,0
-1,131210115073010.000000000000000,Block 3010, Block Group 3, Census Tract 115.07, Fulton County, Georgia,0,0,0,0,0,0,0,0
-1,131210115082018.000000000000000,Block 2018, Block Group 2, Census Tract 115.08, Fulton County, Georgia,0,0,0,0,0,0,0,0
-1,131210115082025.000000000000000,Block 2025, Block Group 2, Census Tract 115.08, Fulton County, Georgia,0,0,0,0,0,0,0,0
-1,131210115091000.000000000000000,Block 1000, Block Group 1, Census Tract 115.09, Fulton County, Georgia,0,0,0,0,0,0,0,0
-1,131210115091003.000000000000000,Block 1003, Block Group 1, Census Tract 115.09, Fulton County, Georgia,0,0,0,0,0,0,0,0
-1,131210115091004.000000000000000,Block 1004, Block Group 1, Census Tract 115.09, Fulton County, Georgia,0,0,0,0,0,0,0,0
-1,131210115091005.000000000000000,Block 1005, Block Group 1, Census Tract 115.09, Fulton County, Georgia,0,0,0,0,0,0,0,0
-1,131210115091007.000000000000000,Block 1007, Block Group 1, Census Tract 115.09, Fulton County, Georgia,0,0,0,0,0,0,0,0
-1,131210115091016.000000000000000,Block 1016, Block Group 1, Census Tract 115.09, Fulton County, Georgia,0,0,0,0,0,0,0,0
-1,131210115092003.000000000000000,Block 2003, Block Group 2, Census Tract 115.09, Fulton County, Georgia,0,0,0,0,0,0,0,0
-1,131210115092008.000000000000000,Block 2008, Block Group 2, Census Tract 115.09, Fulton County, Georgia,0,0,0,0,0,0,0,0
-1,131210115101000.000000000000000,Block 1000, Block Group 1, Census Tract 115.10, Fulton County, Georgia,0,0,0,0,0,0,0,0
-1,131210115101001.000000000000000,Block 1001, Block Group 1, Census Tract 115.10, Fulton County, Georgia,0,0,0,0,0,0,0,0
-1,131210115101004.000000000000000,Block 1004, Block Group 1, Census Tract 115.10, Fulton County, Georgia,0,0,0,0,0,0,0,0
-1,131210115101006.000000000000000,Block 1006, Block Group 1, Census Tract 115.10, Fulton County, Georgia,0,0,0,0,0,0,0,0
-1,131210115101008.000000000000000,Block 1008, Block Group 1, Census Tract 115.10, Fulton County, Georgia,0,0,0,0,0,0,0,0
-1,131210115101011.000000000000000,Block 1011, Block Group 1, Census Tract 115.10, Fulton County, Georgia,0,0,0,0,0,0,0,0
-1,131210115101020.000000000000000,Block 1020, Block Group 1, Census Tract 115.10, Fulton County, Georgia,0,0,0,0,0,0,0,0
-1,131210115101032.000000000000000,Block 1032, Block Group 1, Census Tract 115.10, Fulton County, Georgia,0,0,0,0,0,0,0,0
-1,131210115102007.000000000000000,Block 2007, Block Group 2, Census Tract 115.10, Fulton County, Georgia,0,0,0,0,0,0,0,0
-1,131210115102016.000000000000000,Block 2016, Block Group 2, Census Tract 115.10, Fulton County, Georgia,0,0,0,0,0,0,0,0
-1,131210115102018.000000000000000,Block 2018, Block Group 2, Census Tract 115.10, Fulton County, Georgia,0,0,0,0,0,0,0,0
-1,131210115102022.000000000000000,Block 2022, Block Group 2, Census Tract 115.10, Fulton County, Georgia,0,0,0,0,0,0,0,0
-1,131210115102023.000000000000000,Block 2023, Block Group 2, Census Tract 115.10, Fulton County, Georgia,0,0,0,0,0,0,0,0
-1,131210115102026.000000000000000,Block 2026, Block Group 2, Census Tract 115.10, Fulton County, Georgia,0,0,0,0,0,0,0,0
-1,131210115102027.000000000000000,Block 2027, Block Group 2, Census Tract 115.10, Fulton County, Georgia,0,0,0,0,0,0,0,0
-1,131210115102028.000000000000000,Block 2028, Block Group 2, Census Tract 115.10, Fulton County, Georgia,0,0,0,0,0,0,0,0
-1,131210115102029.000000000000000,Block 2029, Block Group 2, Census Tract 115.10, Fulton County, Georgia,0,0,0,0,0,0,0,0
-1,131210115102031.000000000000000,Block 2031, Block Group 2, Census Tract 115.10, Fulton County, Georgia,0,0,0,0,0,0,0,0
-1,131210115102033.000000000000000,Block 2033, Block Group 2, Census Tract 115.10, Fulton County, Georgia,0,0,0,0,0,0,0,0
-1,131210115103000.000000000000000,Block 3000, Block Group 3, Census Tract 115.10, Fulton County, Georgia,0,0,0,0,0,0,0,0
-1,131210115111006.000000000000000,Block 1006, Block Group 1, Census Tract 115.11, Fulton County, Georgia,0,0,0,0,0,0,0,0
-1,131210115112003.000000000000000,Block 2003, Block Group 2, Census Tract 115.11, Fulton County, Georgia,0,0,0,0,0,0,0,0
-1,131210115112012.000000000000000,Block 2012, Block Group 2, Census Tract 115.11, Fulton County, Georgia,0,0,0,0,0,0,0,0
-1,131210115112015.000000000000000,Block 2015, Block Group 2, Census Tract 115.11, Fulton County, Georgia,0,0,0,0,0,0,0,0
-1,131210115112016.000000000000000,Block 2016, Block Group 2, Census Tract 115.11, Fulton County, Georgia,0,0,0,0,0,0,0,0
-1,131210115121001.000000000000000,Block 1001, Block Group 1, Census Tract 115.12, Fulton County, Georgia,0,0,0,0,0,0,0,0
-1,131210115121003.000000000000000,Block 1003, Block Group 1, Census Tract 115.12, Fulton County, Georgia,0,0,0,0,0,0,0,0
-1,131210115121011.000000000000000,Block 1011, Block Group 1, Census Tract 115.12, Fulton County, Georgia,0,0,0,0,0,0,0,0
-1,131210115121015.000000000000000,Block 1015, Block Group 1, Census Tract 115.12, Fulton County, Georgia,0,0,0,0,0,0,0,0
-1,131210115122006.000000000000000,Block 2006, Block Group 2, Census Tract 115.12, Fulton County, Georgia,0,0,0,0,0,0,0,0
-1,131210115122012.000000000000000,Block 2012, Block Group 2, Census Tract 115.12, Fulton County, Georgia,0,0,0,0,0,0,0,0
-1,131210115122013.000000000000000,Block 2013, Block Group 2, Census Tract 115.12, Fulton County, Georgia,0,0,0,0,0,0,0,0
-1,131210115122014.000000000000000,Block 2014, Block Group 2, Census Tract 115.12, Fulton County, Georgia,0,0,0,0,0,0,0,0
-1,131210115131001.000000000000000,Block 1001, Block Group 1, Census Tract 115.13, Fulton County, Georgia,0,0,0,0,0,0,0,0
-1,131210115132004.000000000000000,Block 2004, Block Group 2, Census Tract 115.13, Fulton County, Georgia,0,0,0,0,0,0,0,0
-1,131210115141009.000000000000000,Block 1009, Block Group 1, Census Tract 115.14, Fulton County, Georgia,0,0,0,0,0,0,0,0
-1,131210115141014.000000000000000,Block 1014, Block Group 1, Census Tract 115.14, Fulton County, Georgia,0,0,0,0,0,0,0,0
-1,131210116121003.000000000000000,Block 1003, Block Group 1, Census Tract 116.12, Fulton County, Georgia,0,0,0,0,0,0,0,0
-1,131210116121005.000000000000000,Block 1005, Block Group 1, Census Tract 116.12, Fulton County, Georgia,0,0,0,0,0,0,0,0
-1,131210116121009.000000000000000,Block 1009, Block Group 1, Census Tract 116.12, Fulton County, Georgia,0,0,0,0,0,0,0,0
-1,131210116121010.000000000000000,Block 1010, Block Group 1, Census Tract 116.12, Fulton County, Georgia,0,0,0,0,0,0,0,0
-1,131210116123000.000000000000000,Block 3000, Block Group 3, Census Tract 116.12, Fulton County, Georgia,0,0,0,0,0,0,0,0
-1,131210116123001.000000000000000,Block 3001, Block Group 3, Census Tract 116.12, Fulton County, Georgia,0,0,0,0,0,0,0,0
-1,131210116123006.000000000000000,Block 3006, Block Group 3, Census Tract 116.12, Fulton County, Georgia,0,0,0,0,0,0,0,0
-1,131210116123009.000000000000000,Block 3009, Block Group 3, Census Tract 116.12, Fulton County, Georgia,0,0,0,0,0,0,0,0
-1,131210116123010.000000000000000,Block 3010, Block Group 3, Census Tract 116.12, Fulton County, Georgia,0,0,0,0,0,0,0,0
-1,131210116183000.000000000000000,Block 3000, Block Group 3, Census Tract 116.18, Fulton County, Georgia,0,0,0,0,0,0,0,0
-1,131210116183001.000000000000000,Block 3001, Block Group 3, Census Tract 116.18, Fulton County, Georgia,0,0,0,0,0,0,0,0
-1,131210116183002.000000000000000,Block 3002, Block Group 3, Census Tract 116.18, Fulton County, Georgia,0,0,0,0,0,0,0,0
-1,131210116183003.000000000000000,Block 3003, Block Group 3, Census Tract 116.18, Fulton County, Georgia,0,0,0,0,0,0,0,0
-1,131210116183004.000000000000000,Block 3004, Block Group 3, Census Tract 116.18, Fulton County, Georgia,0,0,0,0,0,0,0,0
-1,131210116183005.000000000000000,Block 3005, Block Group 3, Census Tract 116.18, Fulton County, Georgia,0,0,0,0,0,0,0,0
-1,131210116183007.000000000000000,Block 3007, Block Group 3, Census Tract 116.18, Fulton County, Georgia,0,0,0,0,0,0,0,0
-1,131210116183008.000000000000000,Block 3008, Block Group 3, Census Tract 116.18, Fulton County, Georgia,0,0,0,0,0,0,0,0
-1,131210116183009.000000000000000,Block 3009, Block Group 3, Census Tract 116.18, Fulton County, Georgia,0,0,0,0,0,0,0,0
-1,131210116183010.000000000000000,Block 3010, Block Group 3, Census Tract 116.18, Fulton County, Georgia,0,0,0,0,0,0,0,0
-1,131210116183012.000000000000000,Block 3012, Block Group 3, Census Tract 116.18, Fulton County, Georgia,0,0,0,0,0,0,0,0
-1,131210116183014.000000000000000,Block 3014, Block Group 3, Census Tract 116.18, Fulton County, Georgia,0,0,0,0,0,0,0,0
-1,131210116183015.000000000000000,Block 3015, Block Group 3, Census Tract 116.18, Fulton County, Georgia,0,0,0,0,0,0,0,0
-1,131210116241006.000000000000000,Block 1006, Block Group 1, Census Tract 116.24, Fulton County, Georgia,0,0,0,0,0,0,0,0
-1,131210116271005.000000000000000,Block 1005, Block Group 1, Census Tract 116.27, Fulton County, Georgia,0,0,0,0,0,0,0,0
-1,131210116272001.000000000000000,Block 2001, Block Group 2, Census Tract 116.27, Fulton County, Georgia,0,0,0,0,0,0,0,0
-1,131210116273001.000000000000000,Block 3001, Block Group 3, Census Tract 116.27, Fulton County, Georgia,0,0,0,0,0,0,0,0
-1,131210116273002.000000000000000,Block 3002, Block Group 3, Census Tract 116.27, Fulton County, Georgia,0,0,0,0,0,0,0,0
-1,131210116273003.000000000000000,Block 3003, Block Group 3, Census Tract 116.27, Fulton County, Georgia,0,0,0,0,0,0,0,0
-1,131210116273004.000000000000000,Block 3004, Block Group 3, Census Tract 116.27, Fulton County, Georgia,0,0,0,0,0,0,0,0
-1,131210116281005.000000000000000,Block 1005, Block Group 1, Census Tract 116.28, Fulton County, Georgia,0,0,0,0,0,0,0,0
-1,131210116281006.000000000000000,Block 1006, Block Group 1, Census Tract 116.28, Fulton County, Georgia,0,0,0,0,0,0,0,0
-1,131210116281007.000000000000000,Block 1007, Block Group 1, Census Tract 116.28, Fulton County, Georgia,0,0,0,0,0,0,0,0
-1,131210116281008.000000000000000,Block 1008, Block Group 1, Census Tract 116.28, Fulton County, Georgia,0,0,0,0,0,0,0,0
-1,131210116281009.000000000000000,Block 1009, Block Group 1, Census Tract 116.28, Fulton County, Georgia,0,0,0,0,0,0,0,0
-1,131210116291005.000000000000000,Block 1005, Block Group 1, Census Tract 116.29, Fulton County, Georgia,0,0,0,0,0,0,0,0
-1,131210116291006.000000000000000,Block 1006, Block Group 1, Census Tract 116.29, Fulton County, Georgia,0,0,0,0,0,0,0,0
-1,131210116291007.000000000000000,Block 1007, Block Group 1, Census Tract 116.29, Fulton County, Georgia,0,0,0,0,0,0,0,0
-1,131210116291009.000000000000000,Block 1009, Block Group 1, Census Tract 116.29, Fulton County, Georgia,0,0,0,0,0,0,0,0
-1,131210116292010.000000000000000,Block 2010, Block Group 2, Census Tract 116.29, Fulton County, Georgia,0,0,0,0,0,0,0,0
-1,131210116292011.000000000000000,Block 2011, Block Group 2, Census Tract 116.29, Fulton County, Georgia,0,0,0,0,0,0,0,0
-1,131210116293001.000000000000000,Block 3001, Block Group 3, Census Tract 116.29, Fulton County, Georgia,0,0,0,0,0,0,0,0
-1,131210116293007.000000000000000,Block 3007, Block Group 3, Census Tract 116.29, Fulton County, Georgia,0,0,0,0,0,0,0,0
-1,131210116293010.000000000000000,Block 3010, Block Group 3, Census Tract 116.29, Fulton County, Georgia,0,0,0,0,0,0,0,0
-1,131210116302003.000000000000000,Block 2003, Block Group 2, Census Tract 116.30, Fulton County, Georgia,0,0,0,0,0,0,0,0
-1,131210116311000.000000000000000,Block 1000, Block Group 1, Census Tract 116.31, Fulton County, Georgia,0,0,0,0,0,0,0,0
-1,131210116311001.000000000000000,Block 1001, Block Group 1, Census Tract 116.31, Fulton County, Georgia,0,0,0,0,0,0,0,0
-1,131210116311002.000000000000000,Block 1002, Block Group 1, Census Tract 116.31, Fulton County, Georgia,0,0,0,0,0,0,0,0
-1,131210116311004.000000000000000,Block 1004, Block Group 1, Census Tract 116.31, Fulton County, Georgia,0,0,0,0,0,0,0,0
-1,131210116311005.000000000000000,Block 1005, Block Group 1, Census Tract 116.31, Fulton County, Georgia,0,0,0,0,0,0,0,0
-1,131210116311006.000000000000000,Block 1006, Block Group 1, Census Tract 116.31, Fulton County, Georgia,0,0,0,0,0,0,0,0
-1,131210116311007.000000000000000,Block 1007, Block Group 1, Census Tract 116.31, Fulton County, Georgia,0,0,0,0,0,0,0,0
-1,131210116311009.000000000000000,Block 1009, Block Group 1, Census Tract 116.31, Fulton County, Georgia,0,0,0,0,0,0,0,0
-1,131210116311012.000000000000000,Block 1012, Block Group 1, Census Tract 116.31, Fulton County, Georgia,0,0,0,0,0,0,0,0
-1,131210116321011.000000000000000,Block 1011, Block Group 1, Census Tract 116.32, Fulton County, Georgia,0,0,0,0,0,0,0,0
-1,131210116321012.000000000000000,Block 1012, Block Group 1, Census Tract 116.32, Fulton County, Georgia,0,0,0,0,0,0,0,0
-1,131210116331000.000000000000000,Block 1000, Block Group 1, Census Tract 116.33, Fulton County, Georgia,0,0,0,0,0,0,0,0
-1,131210116333001.000000000000000,Block 3001, Block Group 3, Census Tract 116.33, Fulton County, Georgia,0,0,0,0,0,0,0,0
-1,131210116333002.000000000000000,Block 3002, Block Group 3, Census Tract 116.33, Fulton County, Georgia,0,0,0,0,0,0,0,0
-1,131210116341006.000000000000000,Block 1006, Block Group 1, Census Tract 116.34, Fulton County, Georgia,0,0,0,0,0,0,0,0
-1,131210116341007.000000000000000,Block 1007, Block Group 1, Census Tract 116.34, Fulton County, Georgia,0,0,0,0,0,0,0,0
-1,131210116341008.000000000000000,Block 1008, Block Group 1, Census Tract 116.34, Fulton County, Georgia,0,0,0,0,0,0,0,0
-1,131210116341009.000000000000000,Block 1009, Block Group 1, Census Tract 116.34, Fulton County, Georgia,0,0,0,0,0,0,0,0
-1,131210116342003.000000000000000,Block 2003, Block Group 2, Census Tract 116.34, Fulton County, Georgia,0,0,0,0,0,0,0,0
-1,131210116351000.000000000000000,Block 1000, Block Group 1, Census Tract 116.35, Fulton County, Georgia,0,0,0,0,0,0,0,0
-1,131210116351003.000000000000000,Block 1003, Block Group 1, Census Tract 116.35, Fulton County, Georgia,0,0,0,0,0,0,0,0
-1,131210116351005.000000000000000,Block 1005, Block Group 1, Census Tract 116.35, Fulton County, Georgia,0,0,0,0,0,0,0,0
-1,131210116352000.000000000000000,Block 2000, Block Group 2, Census Tract 116.35, Fulton County, Georgia,0,0,0,0,0,0,0,0
-1,131210116352001.000000000000000,Block 2001, Block Group 2, Census Tract 116.35, Fulton County, Georgia,0,0,0,0,0,0,0,0
-1,131210116352002.000000000000000,Block 2002, Block Group 2, Census Tract 116.35, Fulton County, Georgia,0,0,0,0,0,0,0,0
-1,131210116352006.000000000000000,Block 2006, Block Group 2, Census Tract 116.35, Fulton County, Georgia,0,0,0,0,0,0,0,0
-1,131210116353000.000000000000000,Block 3000, Block Group 3, Census Tract 116.35, Fulton County, Georgia,0,0,0,0,0,0,0,0
-1,131210116353001.000000000000000,Block 3001, Block Group 3, Census Tract 116.35, Fulton County, Georgia,0,0,0,0,0,0,0,0
-1,131210116353002.000000000000000,Block 3002, Block Group 3, Census Tract 116.35, Fulton County, Georgia,0,0,0,0,0,0,0,0
-1,131210116353007.000000000000000,Block 3007, Block Group 3, Census Tract 116.35, Fulton County, Georgia,0,0,0,0,0,0,0,0
-1,131210116353019.000000000000000,Block 3019, Block Group 3, Census Tract 116.35, Fulton County, Georgia,0,0,0,0,0,0,0,0
-1,131210116353020.000000000000000,Block 3020, Block Group 3, Census Tract 116.35, Fulton County, Georgia,0,0,0,0,0,0,0,0
-1,131210116361001.000000000000000,Block 1001, Block Group 1, Census Tract 116.36, Fulton County, Georgia,0,0,0,0,0,0,0,0
-1,131210116361006.000000000000000,Block 1006, Block Group 1, Census Tract 116.36, Fulton County, Georgia,0,0,0,0,0,0,0,0
-1,131210116361007.000000000000000,Block 1007, Block Group 1, Census Tract 116.36, Fulton County, Georgia,0,0,0,0,0,0,0,0
-1,131210116361008.000000000000000,Block 1008, Block Group 1, Census Tract 116.36, Fulton County, Georgia,0,0,0,0,0,0,0,0
-1,131210116361009.000000000000000,Block 1009, Block Group 1, Census Tract 116.36, Fulton County, Georgia,0,0,0,0,0,0,0,0
-1,131210116361010.000000000000000,Block 1010, Block Group 1, Census Tract 116.36, Fulton County, Georgia,0,0,0,0,0,0,0,0
-1,131210116361011.000000000000000,Block 1011, Block Group 1, Census Tract 116.36, Fulton County, Georgia,0,0,0,0,0,0,0,0
-1,131210116361015.000000000000000,Block 1015, Block Group 1, Census Tract 116.36, Fulton County, Georgia,0,0,0,0,0,0,0,0
-1,131210116371002.000000000000000,Block 1002, Block Group 1, Census Tract 116.37, Fulton County, Georgia,0,0,0,0,0,0,0,0
-1,131210116371003.000000000000000,Block 1003, Block Group 1, Census Tract 116.37, Fulton County, Georgia,0,0,0,0,0,0,0,0
-1,131210116371004.000000000000000,Block 1004, Block Group 1, Census Tract 116.37, Fulton County, Georgia,0,0,0,0,0,0,0,0
-1,131210116372000.000000000000000,Block 2000, Block Group 2, Census Tract 116.37, Fulton County, Georgia,0,0,0,0,0,0,0,0
-1,131210116372001.000000000000000,Block 2001, Block Group 2, Census Tract 116.37, Fulton County, Georgia,0,0,0,0,0,0,0,0
-1,131210116372007.000000000000000,Block 2007, Block Group 2, Census Tract 116.37, Fulton County, Georgia,0,0,0,0,0,0,0,0
-1,131210116372008.000000000000000,Block 2008, Block Group 2, Census Tract 116.37, Fulton County, Georgia,0,0,0,0,0,0,0,0
-1,131210116372009.000000000000000,Block 2009, Block Group 2, Census Tract 116.37, Fulton County, Georgia,0,0,0,0,0,0,0,0
-1,131210116372017.000000000000000,Block 2017, Block Group 2, Census Tract 116.37, Fulton County, Georgia,0,0,0,0,0,0,0,0
-1,131210116372018.000000000000000,Block 2018, Block Group 2, Census Tract 116.37, Fulton County, Georgia,0,0,0,0,0,0,0,0
-1,131210116372019.000000000000000,Block 2019, Block Group 2, Census Tract 116.37, Fulton County, Georgia,0,0,0,0,0,0,0,0
-1,131210116372020.000000000000000,Block 2020, Block Group 2, Census Tract 116.37, Fulton County, Georgia,0,0,0,0,0,0,0,0
-1,131210116372022.000000000000000,Block 2022, Block Group 2, Census Tract 116.37, Fulton County, Georgia,0,0,0,0,0,0,0,0
-1,131210116372025.000000000000000,Block 2025, Block Group 2, Census Tract 116.37, Fulton County, Georgia,0,0,0,0,0,0,0,0
-1,131210116383000.000000000000000,Block 3000, Block Group 3, Census Tract 116.38, Fulton County, Georgia,0,0,0,0,0,0,0,0
-1,131210116383008.000000000000000,Block 3008, Block Group 3, Census Tract 116.38, Fulton County, Georgia,0,0,0,0,0,0,0,0
-1,131210116383009.000000000000000,Block 3009, Block Group 3, Census Tract 116.38, Fulton County, Georgia,0,0,0,0,0,0,0,0
-1,131210116383010.000000000000000,Block 3010, Block Group 3, Census Tract 116.38, Fulton County, Georgia,0,0,0,0,0,0,0,0
-1,131210116383011.000000000000000,Block 3011, Block Group 3, Census Tract 116.38, Fulton County, Georgia,0,0,0,0,0,0,0,0
-1,131210116383014.000000000000000,Block 3014, Block Group 3, Census Tract 116.38, Fulton County, Georgia,0,0,0,0,0,0,0,0
-1,131210116384002.000000000000000,Block 4002, Block Group 4, Census Tract 116.38, Fulton County, Georgia,0,0,0,0,0,0,0,0
-1,131210116384003.000000000000000,Block 4003, Block Group 4, Census Tract 116.38, Fulton County, Georgia,0,0,0,0,0,0,0,0
-1,131210116384004.000000000000000,Block 4004, Block Group 4, Census Tract 116.38, Fulton County, Georgia,0,0,0,0,0,0,0,0
-1,131210116391000.000000000000000,Block 1000, Block Group 1, Census Tract 116.39, Fulton County, Georgia,0,0,0,0,0,0,0,0
-1,131210116391001.000000000000000,Block 1001, Block Group 1, Census Tract 116.39, Fulton County, Georgia,0,0,0,0,0,0,0,0
-1,131210116391002.000000000000000,Block 1002, Block Group 1, Census Tract 116.39, Fulton County, Georgia,0,0,0,0,0,0,0,0
-1,131210116391003.000000000000000,Block 1003, Block Group 1, Census Tract 116.39, Fulton County, Georgia,0,0,0,0,0,0,0,0
-1,131210116391004.000000000000000,Block 1004, Block Group 1, Census Tract 116.39, Fulton County, Georgia,0,0,0,0,0,0,0,0
-1,131210116391008.000000000000000,Block 1008, Block Group 1, Census Tract 116.39, Fulton County, Georgia,0,0,0,0,0,0,0,0
-1,131210116391009.000000000000000,Block 1009, Block Group 1, Census Tract 116.39, Fulton County, Georgia,0,0,0,0,0,0,0,0
-1,131210116391012.000000000000000,Block 1012, Block Group 1, Census Tract 116.39, Fulton County, Georgia,0,0,0,0,0,0,0,0
-1,131210116391014.000000000000000,Block 1014, Block Group 1, Census Tract 116.39, Fulton County, Georgia,0,0,0,0,0,0,0,0
-1,131210116391016.000000000000000,Block 1016, Block Group 1, Census Tract 116.39, Fulton County, Georgia,0,0,0,0,0,0,0,0
-1,131210116391017.000000000000000,Block 1017, Block Group 1, Census Tract 116.39, Fulton County, Georgia,0,0,0,0,0,0,0,0
-1,131210116391018.000000000000000,Block 1018, Block Group 1, Census Tract 116.39, Fulton County, Georgia,0,0,0,0,0,0,0,0
-1,131210116391019.000000000000000,Block 1019, Block Group 1, Census Tract 116.39, Fulton County, Georgia,0,0,0,0,0,0,0,0
-1,131210116391020.000000000000000,Block 1020, Block Group 1, Census Tract 116.39, Fulton County, Georgia,0,0,0,0,0,0,0,0
-1,131210116391021.000000000000000,Block 1021, Block Group 1, Census Tract 116.39, Fulton County, Georgia,0,0,0,0,0,0,0,0
-1,131210116391023.000000000000000,Block 1023, Block Group 1, Census Tract 116.39, Fulton County, Georgia,0,0,0,0,0,0,0,0
-1,131210116391025.000000000000000,Block 1025, Block Group 1, Census Tract 116.39, Fulton County, Georgia,0,0,0,0,0,0,0,0
-1,131210116391026.000000000000000,Block 1026, Block Group 1, Census Tract 116.39, Fulton County, Georgia,0,0,0,0,0,0,0,0
-1,131210116391027.000000000000000,Block 1027, Block Group 1, Census Tract 116.39, Fulton County, Georgia,0,0,0,0,0,0,0,0
-1,131210116401000.000000000000000,Block 1000, Block Group 1, Census Tract 116.40, Fulton County, Georgia,0,0,0,0,0,0,0,0
-1,131210116401001.000000000000000,Block 1001, Block Group 1, Census Tract 116.40, Fulton County, Georgia,0,0,0,0,0,0,0,0
-1,131210116401002.000000000000000,Block 1002, Block Group 1, Census Tract 116.40, Fulton County, Georgia,0,0,0,0,0,0,0,0
-1,131210116401003.000000000000000,Block 1003, Block Group 1, Census Tract 116.40, Fulton County, Georgia,0,0,0,0,0,0,0,0
-1,131210116401004.000000000000000,Block 1004, Block Group 1, Census Tract 116.40, Fulton County, Georgia,0,0,0,0,0,0,0,0
-1,131210116401018.000000000000000,Block 1018, Block Group 1, Census Tract 116.40, Fulton County, Georgia,0,0,0,0,0,0,0,0
-1,131210116402000.000000000000000,Block 2000, Block Group 2, Census Tract 116.40, Fulton County, Georgia,0,0,0,0,0,0,0,0
-1,131210116402001.000000000000000,Block 2001, Block Group 2, Census Tract 116.40, Fulton County, Georgia,0,0,0,0,0,0,0,0
-1,131210116402006.000000000000000,Block 2006, Block Group 2, Census Tract 116.40, Fulton County, Georgia,0,0,0,0,0,0,0,0
-1,131210116402015.000000000000000,Block 2015, Block Group 2, Census Tract 116.40, Fulton County, Georgia,0,0,0,0,0,0,0,0
-1,131210116402016.000000000000000,Block 2016, Block Group 2, Census Tract 116.40, Fulton County, Georgia,0,0,0,0,0,0,0,0
-1,131210116402017.000000000000000,Block 2017, Block Group 2, Census Tract 116.40, Fulton County, Georgia,0,0,0,0,0,0,0,0
-1,131210116402023.000000000000000,Block 2023, Block Group 2, Census Tract 116.40, Fulton County, Georgia,0,0,0,0,0,0,0,0
-1,131210116402027.000000000000000,Block 2027, Block Group 2, Census Tract 116.40, Fulton County, Georgia,0,0,0,0,0,0,0,0
-1,131210116402028.000000000000000,Block 2028, Block Group 2, Census Tract 116.40, Fulton County, Georgia,0,0,0,0,0,0,0,0
-1,131210116402035.000000000000000,Block 2035, Block Group 2, Census Tract 116.40, Fulton County, Georgia,0,0,0,0,0,0,0,0
-1,131210116402037.000000000000000,Block 2037, Block Group 2, Census Tract 116.40, Fulton County, Georgia,0,0,0,0,0,0,0,0
-1,131210116402038.000000000000000,Block 2038, Block Group 2, Census Tract 116.40, Fulton County, Georgia,0,0,0,0,0,0,0,0
-1,131210116411009.000000000000000,Block 1009, Block Group 1, Census Tract 116.41, Fulton County, Georgia,0,0,0,0,0,0,0,0
-1,131210116411012.000000000000000,Block 1012, Block Group 1, Census Tract 116.41, Fulton County, Georgia,0,0,0,0,0,0,0,0
-1,131210116413000.000000000000000,Block 3000, Block Group 3, Census Tract 116.41, Fulton County, Georgia,0,0,0,0,0,0,0,0
-1,131210116421002.000000000000000,Block 1002, Block Group 1, Census Tract 116.42, Fulton County, Georgia,0,0,0,0,0,0,0,0
-1,131210116421003.000000000000000,Block 1003, Block Group 1, Census Tract 116.42, Fulton County, Georgia,0,0,0,0,0,0,0,0
-1,131210116423005.000000000000000,Block 3005, Block Group 3, Census Tract 116.42, Fulton County, Georgia,0,0,0,0,0,0,0,0
-1,131210116423007.000000000000000,Block 3007, Block Group 3, Census Tract 116.42, Fulton County, Georgia,0,0,0,0,0,0,0,0
-1,131210116431008.000000000000000,Block 1008, Block Group 1, Census Tract 116.43, Fulton County, Georgia,0,0,0,0,0,0,0,0
-1,131210116432000.000000000000000,Block 2000, Block Group 2, Census Tract 116.43, Fulton County, Georgia,0,0,0,0,0,0,0,0
-1,131210116432003.000000000000000,Block 2003, Block Group 2, Census Tract 116.43, Fulton County, Georgia,0,0,0,0,0,0,0,0
-1,131210116432004.000000000000000,Block 2004, Block Group 2, Census Tract 116.43, Fulton County, Georgia,0,0,0,0,0,0,0,0
-1,131210116432005.000000000000000,Block 2005, Block Group 2, Census Tract 116.43, Fulton County, Georgia,0,0,0,0,0,0,0,0
-1,131210116433000.000000000000000,Block 3000, Block Group 3, Census Tract 116.43, Fulton County, Georgia,0,0,0,0,0,0,0,0
-1,131210116433006.000000000000000,Block 3006, Block Group 3, Census Tract 116.43, Fulton County, Georgia,0,0,0,0,0,0,0,0
-1,131210116433007.000000000000000,Block 3007, Block Group 3, Census Tract 116.43, Fulton County, Georgia,0,0,0,0,0,0,0,0
-1,131210116433009.000000000000000,Block 3009, Block Group 3, Census Tract 116.43, Fulton County, Georgia,0,0,0,0,0,0,0,0
-1,131210116433010.000000000000000,Block 3010, Block Group 3, Census Tract 116.43, Fulton County, Georgia,0,0,0,0,0,0,0,0
-1,131210116433011.000000000000000,Block 3011, Block Group 3, Census Tract 116.43, Fulton County, Georgia,0,0,0,0,0,0,0,0
-1,131210116433012.000000000000000,Block 3012, Block Group 3, Census Tract 116.43, Fulton County, Georgia,0,0,0,0,0,0,0,0
-1,131210116433013.000000000000000,Block 3013, Block Group 3, Census Tract 116.43, Fulton County, Georgia,0,0,0,0,0,0,0,0
-1,131210116433014.000000000000000,Block 3014, Block Group 3, Census Tract 116.43, Fulton County, Georgia,0,0,0,0,0,0,0,0
-1,131210116433015.000000000000000,Block 3015, Block Group 3, Census Tract 116.43, Fulton County, Georgia,0,0,0,0,0,0,0,0
-1,131210116433016.000000000000000,Block 3016, Block Group 3, Census Tract 116.43, Fulton County, Georgia,0,0,0,0,0,0,0,0
-1,131210116433017.000000000000000,Block 3017, Block Group 3, Census Tract 116.43, Fulton County, Georgia,0,0,0,0,0,0,0,0
-1,131210116433018.000000000000000,Block 3018, Block Group 3, Census Tract 116.43, Fulton County, Georgia,0,0,0,0,0,0,0,0
-1,131210116433019.000000000000000,Block 3019, Block Group 3, Census Tract 116.43, Fulton County, Georgia,0,0,0,0,0,0,0,0
-1,131210116433020.000000000000000,Block 3020, Block Group 3, Census Tract 116.43, Fulton County, Georgia,0,0,0,0,0,0,0,0
-1,131210116433021.000000000000000,Block 3021, Block Group 3, Census Tract 116.43, Fulton County, Georgia,0,0,0,0,0,0,0,0
-1,131210116433022.000000000000000,Block 3022, Block Group 3, Census Tract 116.43, Fulton County, Georgia,0,0,0,0,0,0,0,0
-1,131210116433023.000000000000000,Block 3023, Block Group 3, Census Tract 116.43, Fulton County, Georgia,0,0,0,0,0,0,0,0
-1,131210116433024.000000000000000,Block 3024, Block Group 3, Census Tract 116.43, Fulton County, Georgia,0,0,0,0,0,0,0,0
-1,131210116433025.000000000000000,Block 3025, Block Group 3, Census Tract 116.43, Fulton County, Georgia,0,0,0,0,0,0,0,0
-1,131210116433026.000000000000000,Block 3026, Block Group 3, Census Tract 116.43, Fulton County, Georgia,0,0,0,0,0,0,0,0
-1,131210116441002.000000000000000,Block 1002, Block Group 1, Census Tract 116.44, Fulton County, Georgia,0,0,0,0,0,0,0,0
-1,131210116441008.000000000000000,Block 1008, Block Group 1, Census Tract 116.44, Fulton County, Georgia,0,0,0,0,0,0,0,0
-1,131210116441011.000000000000000,Block 1011, Block Group 1, Census Tract 116.44, Fulton County, Georgia,0,0,0,0,0,0,0,0
-1,131210116441013.000000000000000,Block 1013, Block Group 1, Census Tract 116.44, Fulton County, Georgia,0,0,0,0,0,0,0,0
-1,131210116441016.000000000000000,Block 1016, Block Group 1, Census Tract 116.44, Fulton County, Georgia,0,0,0,0,0,0,0,0
-1,131210116441017.000000000000000,Block 1017, Block Group 1, Census Tract 116.44, Fulton County, Georgia,0,0,0,0,0,0,0,0
-1,131210116443005.000000000000000,Block 3005, Block Group 3, Census Tract 116.44, Fulton County, Georgia,0,0,0,0,0,0,0,0
-1,131210116443006.000000000000000,Block 3006, Block Group 3, Census Tract 116.44, Fulton County, Georgia,0,0,0,0,0,0,0,0
-1,131210116443009.000000000000000,Block 3009, Block Group 3, Census Tract 116.44, Fulton County, Georgia,0,0,0,0,0,0,0,0
-1,131210116443010.000000000000000,Block 3010, Block Group 3, Census Tract 116.44, Fulton County, Georgia,0,0,0,0,0,0,0,0
-1,131210116461000.000000000000000,Block 1000, Block Group 1, Census Tract 116.46, Fulton County, Georgia,0,0,0,0,0,0,0,0
-1,131210116461002.000000000000000,Block 1002, Block Group 1, Census Tract 116.46, Fulton County, Georgia,0,0,0,0,0,0,0,0
-1,131210116461003.000000000000000,Block 1003, Block Group 1, Census Tract 116.46, Fulton County, Georgia,0,0,0,0,0,0,0,0
-1,131210116461004.000000000000000,Block 1004, Block Group 1, Census Tract 116.46, Fulton County, Georgia,0,0,0,0,0,0,0,0
-1,131210116461005.000000000000000,Block 1005, Block Group 1, Census Tract 116.46, Fulton County, Georgia,0,0,0,0,0,0,0,0
-1,131210116461006.000000000000000,Block 1006, Block Group 1, Census Tract 116.46, Fulton County, Georgia,0,0,0,0,0,0,0,0
-1,131210116461007.000000000000000,Block 1007, Block Group 1, Census Tract 116.46, Fulton County, Georgia,0,0,0,0,0,0,0,0
-1,131210116461008.000000000000000,Block 1008, Block Group 1, Census Tract 116.46, Fulton County, Georgia,0,0,0,0,0,0,0,0
-1,131210116461009.000000000000000,Block 1009, Block Group 1, Census Tract 116.46, Fulton County, Georgia,0,0,0,0,0,0,0,0
-1,131210116461011.000000000000000,Block 1011, Block Group 1, Census Tract 116.46, Fulton County, Georgia,0,0,0,0,0,0,0,0
-1,131210116461012.000000000000000,Block 1012, Block Group 1, Census Tract 116.46, Fulton County, Georgia,0,0,0,0,0,0,0,0
-1,131210116461013.000000000000000,Block 1013, Block Group 1, Census Tract 116.46, Fulton County, Georgia,0,0,0,0,0,0,0,0
-1,131210116461014.000000000000000,Block 1014, Block Group 1, Census Tract 116.46, Fulton County, Georgia,0,0,0,0,0,0,0,0
-1,131210116461017.000000000000000,Block 1017, Block Group 1, Census Tract 116.46, Fulton County, Georgia,0,0,0,0,0,0,0,0
-1,131210116462009.000000000000000,Block 2009, Block Group 2, Census Tract 116.46, Fulton County, Georgia,0,0,0,0,0,0,0,0
-1,131210116462010.000000000000000,Block 2010, Block Group 2, Census Tract 116.46, Fulton County, Georgia,0,0,0,0,0,0,0,0
-1,131210116462011.000000000000000,Block 2011, Block Group 2, Census Tract 116.46, Fulton County, Georgia,0,0,0,0,0,0,0,0
-1,131210116462014.000000000000000,Block 2014, Block Group 2, Census Tract 116.46, Fulton County, Georgia,0,0,0,0,0,0,0,0
-1,131210116462015.000000000000000,Block 2015, Block Group 2, Census Tract 116.46, Fulton County, Georgia,0,0,0,0,0,0,0,0
-1,131210116462020.000000000000000,Block 2020, Block Group 2, Census Tract 116.46, Fulton County, Georgia,0,0,0,0,0,0,0,0
-1,131210116462021.000000000000000,Block 2021, Block Group 2, Census Tract 116.46, Fulton County, Georgia,0,0,0,0,0,0,0,0
-1,131210116462022.000000000000000,Block 2022, Block Group 2, Census Tract 116.46, Fulton County, Georgia,0,0,0,0,0,0,0,0
-1,131210116462023.000000000000000,Block 2023, Block Group 2, Census Tract 116.46, Fulton County, Georgia,0,0,0,0,0,0,0,0
-1,131210116462024.000000000000000,Block 2024, Block Group 2, Census Tract 116.46, Fulton County, Georgia,0,0,0,0,0,0,0,0
-1,131210116471000.000000000000000,Block 1000, Block Group 1, Census Tract 116.47, Fulton County, Georgia,0,0,0,0,0,0,0,0
-1,131210116471002.000000000000000,Block 1002, Block Group 1, Census Tract 116.47, Fulton County, Georgia,0,0,0,0,0,0,0,0
-1,131210116471008.000000000000000,Block 1008, Block Group 1, Census Tract 116.47, Fulton County, Georgia,0,0,0,0,0,0,0,0
-1,131210116471010.000000000000000,Block 1010, Block Group 1, Census Tract 116.47, Fulton County, Georgia,0,0,0,0,0,0,0,0
-1,131210116471015.000000000000000,Block 1015, Block Group 1, Census Tract 116.47, Fulton County, Georgia,0,0,0,0,0,0,0,0
-1,131210116471016.000000000000000,Block 1016, Block Group 1, Census Tract 116.47, Fulton County, Georgia,0,0,0,0,0,0,0,0
-1,131210116472002.000000000000000,Block 2002, Block Group 2, Census Tract 116.47, Fulton County, Georgia,0,0,0,0,0,0,0,0
-1,131210116472003.000000000000000,Block 2003, Block Group 2, Census Tract 116.47, Fulton County, Georgia,0,0,0,0,0,0,0,0
-1,131210116472004.000000000000000,Block 2004, Block Group 2, Census Tract 116.47, Fulton County, Georgia,0,0,0,0,0,0,0,0
-1,131210116472005.000000000000000,Block 2005, Block Group 2, Census Tract 116.47, Fulton County, Georgia,0,0,0,0,0,0,0,0
-1,131210116472006.000000000000000,Block 2006, Block Group 2, Census Tract 116.47, Fulton County, Georgia,0,0,0,0,0,0,0,0
-1,131210116472007.000000000000000,Block 2007, Block Group 2, Census Tract 116.47, Fulton County, Georgia,0,0,0,0,0,0,0,0
-1,131210116472008.000000000000000,Block 2008, Block Group 2, Census Tract 116.47, Fulton County, Georgia,0,0,0,0,0,0,0,0
-1,131210116472009.000000000000000,Block 2009, Block Group 2, Census Tract 116.47, Fulton County, Georgia,0,0,0,0,0,0,0,0
-1,131210116472015.000000000000000,Block 2015, Block Group 2, Census Tract 116.47, Fulton County, Georgia,0,0,0,0,0,0,0,0
-1,131210116472017.000000000000000,Block 2017, Block Group 2, Census Tract 116.47, Fulton County, Georgia,0,0,0,0,0,0,0,0
-1,131210116473000.000000000000000,Block 3000, Block Group 3, Census Tract 116.47, Fulton County, Georgia,0,0,0,0,0,0,0,0
-1,131210116473002.000000000000000,Block 3002, Block Group 3, Census Tract 116.47, Fulton County, Georgia,0,0,0,0,0,0,0,0
-1,131210116473005.000000000000000,Block 3005, Block Group 3, Census Tract 116.47, Fulton County, Georgia,0,0,0,0,0,0,0,0
-1,131210116473006.000000000000000,Block 3006, Block Group 3, Census Tract 116.47, Fulton County, Georgia,0,0,0,0,0,0,0,0
-1,131210116473010.000000000000000,Block 3010, Block Group 3, Census Tract 116.47, Fulton County, Georgia,0,0,0,0,0,0,0,0
-1,131210116473011.000000000000000,Block 3011, Block Group 3, Census Tract 116.47, Fulton County, Georgia,0,0,0,0,0,0,0,0
-1,131210116473012.000000000000000,Block 3012, Block Group 3, Census Tract 116.47, Fulton County, Georgia,0,0,0,0,0,0,0,0
-1,131210116473013.000000000000000,Block 3013, Block Group 3, Census Tract 116.47, Fulton County, Georgia,0,0,0,0,0,0,0,0
-1,131210116473014.000000000000000,Block 3014, Block Group 3, Census Tract 116.47, Fulton County, Georgia,0,0,0,0,0,0,0,0
-1,131210116473016.000000000000000,Block 3016, Block Group 3, Census Tract 116.47, Fulton County, Georgia,0,0,0,0,0,0,0,0
-1,131210116473019.000000000000000,Block 3019, Block Group 3, Census Tract 116.47, Fulton County, Georgia,0,0,0,0,0,0,0,0
-1,131210116473020.000000000000000,Block 3020, Block Group 3, Census Tract 116.47, Fulton County, Georgia,0,0,0,0,0,0,0,0
-1,131210116474000.000000000000000,Block 4000, Block Group 4, Census Tract 116.47, Fulton County, Georgia,0,0,0,0,0,0,0,0
-1,131210116474001.000000000000000,Block 4001, Block Group 4, Census Tract 116.47, Fulton County, Georgia,0,0,0,0,0,0,0,0
-1,131210116474002.000000000000000,Block 4002, Block Group 4, Census Tract 116.47, Fulton County, Georgia,0,0,0,0,0,0,0,0
-1,131210116474003.000000000000000,Block 4003, Block Group 4, Census Tract 116.47, Fulton County, Georgia,0,0,0,0,0,0,0,0
-1,131210116474013.000000000000000,Block 4013, Block Group 4, Census Tract 116.47, Fulton County, Georgia,0,0,0,0,0,0,0,0
-1,131210116474014.000000000000000,Block 4014, Block Group 4, Census Tract 116.47, Fulton County, Georgia,0,0,0,0,0,0,0,0
-1,131210116481004.000000000000000,Block 1004, Block Group 1, Census Tract 116.48, Fulton County, Georgia,0,0,0,0,0,0,0,0
-1,131210116481005.000000000000000,Block 1005, Block Group 1, Census Tract 116.48, Fulton County, Georgia,0,0,0,0,0,0,0,0
-1,131210116482000.000000000000000,Block 2000, Block Group 2, Census Tract 116.48, Fulton County, Georgia,0,0,0,0,0,0,0,0
-1,131210116482007.000000000000000,Block 2007, Block Group 2, Census Tract 116.48, Fulton County, Georgia,0,0,0,0,0,0,0,0
-1,131210116482009.000000000000000,Block 2009, Block Group 2, Census Tract 116.48, Fulton County, Georgia,0,0,0,0,0,0,0,0
-1,131210116482010.000000000000000,Block 2010, Block Group 2, Census Tract 116.48, Fulton County, Georgia,0,0,0,0,0,0,0,0
-1,131210116493000.000000000000000,Block 3000, Block Group 3, Census Tract 116.49, Fulton County, Georgia,0,0,0,0,0,0,0,0
-1,131210116493002.000000000000000,Block 3002, Block Group 3, Census Tract 116.49, Fulton County, Georgia,0,0,0,0,0,0,0,0
-1,131210116493003.000000000000000,Block 3003, Block Group 3, Census Tract 116.49, Fulton County, Georgia,0,0,0,0,0,0,0,0
-1,131210116493004.000000000000000,Block 3004, Block Group 3, Census Tract 116.49, Fulton County, Georgia,0,0,0,0,0,0,0,0
-1,131210116493005.000000000000000,Block 3005, Block Group 3, Census Tract 116.49, Fulton County, Georgia,0,0,0,0,0,0,0,0
-1,131210116493007.000000000000000,Block 3007, Block Group 3, Census Tract 116.49, Fulton County, Georgia,0,0,0,0,0,0,0,0
-1,131210116493008.000000000000000,Block 3008, Block Group 3, Census Tract 116.49, Fulton County, Georgia,0,0,0,0,0,0,0,0
-1,131210116493011.000000000000000,Block 3011, Block Group 3, Census Tract 116.49, Fulton County, Georgia,0,0,0,0,0,0,0,0
-1,131210116493024.000000000000000,Block 3024, Block Group 3, Census Tract 116.49, Fulton County, Georgia,0,0,0,0,0,0,0,0
-1,131210116493025.000000000000000,Block 3025, Block Group 3, Census Tract 116.49, Fulton County, Georgia,0,0,0,0,0,0,0,0
-1,131210116493026.000000000000000,Block 3026, Block Group 3, Census Tract 116.49, Fulton County, Georgia,0,0,0,0,0,0,0,0
-1,131210116493027.000000000000000,Block 3027, Block Group 3, Census Tract 116.49, Fulton County, Georgia,0,0,0,0,0,0,0,0
-1,131210116501002.000000000000000,Block 1002, Block Group 1, Census Tract 116.50, Fulton County, Georgia,0,0,0,0,0,0,0,0
-1,131210116501005.000000000000000,Block 1005, Block Group 1, Census Tract 116.50, Fulton County, Georgia,0,0,0,0,0,0,0,0
-1,131210116501006.000000000000000,Block 1006, Block Group 1, Census Tract 116.50, Fulton County, Georgia,0,0,0,0,0,0,0,0
-1,131210116501008.000000000000000,Block 1008, Block Group 1, Census Tract 116.50, Fulton County, Georgia,0,0,0,0,0,0,0,0
-1,131210116501009.000000000000000,Block 1009, Block Group 1, Census Tract 116.50, Fulton County, Georgia,0,0,0,0,0,0,0,0
-1,131210116501010.000000000000000,Block 1010, Block Group 1, Census Tract 116.50, Fulton County, Georgia,0,0,0,0,0,0,0,0
-1,131210116501011.000000000000000,Block 1011, Block Group 1, Census Tract 116.50, Fulton County, Georgia,0,0,0,0,0,0,0,0
-1,131210116501012.000000000000000,Block 1012, Block Group 1, Census Tract 116.50, Fulton County, Georgia,0,0,0,0,0,0,0,0
-1,131210116501013.000000000000000,Block 1013, Block Group 1, Census Tract 116.50, Fulton County, Georgia,0,0,0,0,0,0,0,0
-1,131210116501015.000000000000000,Block 1015, Block Group 1, Census Tract 116.50, Fulton County, Georgia,0,0,0,0,0,0,0,0
-1,131210116501016.000000000000000,Block 1016, Block Group 1, Census Tract 116.50, Fulton County, Georgia,0,0,0,0,0,0,0,0
-1,131210116501019.000000000000000,Block 1019, Block Group 1, Census Tract 116.50, Fulton County, Georgia,0,0,0,0,0,0,0,0
-1,131210116503004.000000000000000,Block 3004, Block Group 3, Census Tract 116.50, Fulton County, Georgia,0,0,0,0,0,0,0,0
-1,131210116503006.000000000000000,Block 3006, Block Group 3, Census Tract 116.50, Fulton County, Georgia,0,0,0,0,0,0,0,0
-1,131210116511001.000000000000000,Block 1001, Block Group 1, Census Tract 116.51, Fulton County, Georgia,0,0,0,0,0,0,0,0
-1,131210116511005.000000000000000,Block 1005, Block Group 1, Census Tract 116.51, Fulton County, Georgia,0,0,0,0,0,0,0,0
-1,131210116512000.000000000000000,Block 2000, Block Group 2, Census Tract 116.51, Fulton County, Georgia,0,0,0,0,0,0,0,0
-1,131210116512002.000000000000000,Block 2002, Block Group 2, Census Tract 116.51, Fulton County, Georgia,0,0,0,0,0,0,0,0
-1,131210116512003.000000000000000,Block 2003, Block Group 2, Census Tract 116.51, Fulton County, Georgia,0,0,0,0,0,0,0,0
-1,131210116512004.000000000000000,Block 2004, Block Group 2, Census Tract 116.51, Fulton County, Georgia,0,0,0,0,0,0,0,0
-1,131210116512005.000000000000000,Block 2005, Block Group 2, Census Tract 116.51, Fulton County, Georgia,0,0,0,0,0,0,0,0
-1,131210116512006.000000000000000,Block 2006, Block Group 2, Census Tract 116.51, Fulton County, Georgia,0,0,0,0,0,0,0,0
-1,131210116512007.000000000000000,Block 2007, Block Group 2, Census Tract 116.51, Fulton County, Georgia,0,0,0,0,0,0,0,0
-1,131210116512009.000000000000000,Block 2009, Block Group 2, Census Tract 116.51, Fulton County, Georgia,0,0,0,0,0,0,0,0
-1,131210116512011.000000000000000,Block 2011, Block Group 2, Census Tract 116.51, Fulton County, Georgia,0,0,0,0,0,0,0,0
-1,131210116512016.000000000000000,Block 2016, Block Group 2, Census Tract 116.51, Fulton County, Georgia,0,0,0,0,0,0,0,0
-1,131210116512017.000000000000000,Block 2017, Block Group 2, Census Tract 116.51, Fulton County, Georgia,0,0,0,0,0,0,0,0
-1,131210116512018.000000000000000,Block 2018, Block Group 2, Census Tract 116.51, Fulton County, Georgia,0,0,0,0,0,0,0,0
-1,131210116512020.000000000000000,Block 2020, Block Group 2, Census Tract 116.51, Fulton County, Georgia,0,0,0,0,0,0,0,0
-1,131210116512021.000000000000000,Block 2021, Block Group 2, Census Tract 116.51, Fulton County, Georgia,0,0,0,0,0,0,0,0
-1,131210116512022.000000000000000,Block 2022, Block Group 2, Census Tract 116.51, Fulton County, Georgia,0,0,0,0,0,0,0,0
-1,131210116512023.000000000000000,Block 2023, Block Group 2, Census Tract 116.51, Fulton County, Georgia,0,0,0,0,0,0,0,0
-1,131210116512024.000000000000000,Block 2024, Block Group 2, Census Tract 116.51, Fulton County, Georgia,0,0,0,0,0,0,0,0
-1,131210116512025.000000000000000,Block 2025, Block Group 2, Census Tract 116.51, Fulton County, Georgia,0,0,0,0,0,0,0,0
-1,131210116512026.000000000000000,Block 2026, Block Group 2, Census Tract 116.51, Fulton County, Georgia,0,0,0,0,0,0,0,0
-1,131210116521001.000000000000000,Block 1001, Block Group 1, Census Tract 116.52, Fulton County, Georgia,0,0,0,0,0,0,0,0
-1,131210116521002.000000000000000,Block 1002, Block Group 1, Census Tract 116.52, Fulton County, Georgia,0,0,0,0,0,0,0,0
-1,131210116521003.000000000000000,Block 1003, Block Group 1, Census Tract 116.52, Fulton County, Georgia,0,0,0,0,0,0,0,0
-1,131210116521004.000000000000000,Block 1004, Block Group 1, Census Tract 116.52, Fulton County, Georgia,0,0,0,0,0,0,0,0
-1,131210116521005.000000000000000,Block 1005, Block Group 1, Census Tract 116.52, Fulton County, Georgia,0,0,0,0,0,0,0,0
-1,131210116521006.000000000000000,Block 1006, Block Group 1, Census Tract 116.52, Fulton County, Georgia,0,0,0,0,0,0,0,0
-1,131210116521007.000000000000000,Block 1007, Block Group 1, Census Tract 116.52, Fulton County, Georgia,0,0,0,0,0,0,0,0
-1,131210116521008.000000000000000,Block 1008, Block Group 1, Census Tract 116.52, Fulton County, Georgia,0,0,0,0,0,0,0,0
-1,131210116521009.000000000000000,Block 1009, Block Group 1, Census Tract 116.52, Fulton County, Georgia,0,0,0,0,0,0,0,0
-1,131210116521010.000000000000000,Block 1010, Block Group 1, Census Tract 116.52, Fulton County, Georgia,0,0,0,0,0,0,0,0
-1,131210116521011.000000000000000,Block 1011, Block Group 1, Census Tract 116.52, Fulton County, Georgia,0,0,0,0,0,0,0,0
-1,131210116521012.000000000000000,Block 1012, Block Group 1, Census Tract 116.52, Fulton County, Georgia,0,0,0,0,0,0,0,0
-1,131210116521016.000000000000000,Block 1016, Block Group 1, Census Tract 116.52, Fulton County, Georgia,0,0,0,0,0,0,0,0
-1,131210116521017.000000000000000,Block 1017, Block Group 1, Census Tract 116.52, Fulton County, Georgia,0,0,0,0,0,0,0,0
-1,131210116521021.000000000000000,Block 1021, Block Group 1, Census Tract 116.52, Fulton County, Georgia,0,0,0,0,0,0,0,0
-1,131210116521022.000000000000000,Block 1022, Block Group 1, Census Tract 116.52, Fulton County, Georgia,0,0,0,0,0,0,0,0
-1,131210116521026.000000000000000,Block 1026, Block Group 1, Census Tract 116.52, Fulton County, Georgia,0,0,0,0,0,0,0,0
-1,131210116521028.000000000000000,Block 1028, Block Group 1, Census Tract 116.52, Fulton County, Georgia,0,0,0,0,0,0,0,0
-1,131210116522004.000000000000000,Block 2004, Block Group 2, Census Tract 116.52, Fulton County, Georgia,0,0,0,0,0,0,0,0
-1,131210116522005.000000000000000,Block 2005, Block Group 2, Census Tract 116.52, Fulton County, Georgia,0,0,0,0,0,0,0,0
-1,131210116522006.000000000000000,Block 2006, Block Group 2, Census Tract 116.52, Fulton County, Georgia,0,0,0,0,0,0,0,0
-1,131210116531000.000000000000000,Block 1000, Block Group 1, Census Tract 116.53, Fulton County, Georgia,0,0,0,0,0,0,0,0
-1,131210116531009.000000000000000,Block 1009, Block Group 1, Census Tract 116.53, Fulton County, Georgia,0,0,0,0,0,0,0,0
-1,131210116532001.000000000000000,Block 2001, Block Group 2, Census Tract 116.53, Fulton County, Georgia,0,0,0,0,0,0,0,0
-1,131210116532002.000000000000000,Block 2002, Block Group 2, Census Tract 116.53, Fulton County, Georgia,0,0,0,0,0,0,0,0
-1,131210116532004.000000000000000,Block 2004, Block Group 2, Census Tract 116.53, Fulton County, Georgia,0,0,0,0,0,0,0,0
-1,131210116532005.000000000000000,Block 2005, Block Group 2, Census Tract 116.53, Fulton County, Georgia,0,0,0,0,0,0,0,0
-1,131210116533000.000000000000000,Block 3000, Block Group 3, Census Tract 116.53, Fulton County, Georgia,0,0,0,0,0,0,0,0
-1,131210116533002.000000000000000,Block 3002, Block Group 3, Census Tract 116.53, Fulton County, Georgia,0,0,0,0,0,0,0,0
-1,131210116533005.000000000000000,Block 3005, Block Group 3, Census Tract 116.53, Fulton County, Georgia,0,0,0,0,0,0,0,0
-1,131210116541005.000000000000000,Block 1005, Block Group 1, Census Tract 116.54, Fulton County, Georgia,0,0,0,0,0,0,0,0
-1,131210116542001.000000000000000,Block 2001, Block Group 2, Census Tract 116.54, Fulton County, Georgia,0,0,0,0,0,0,0,0
-1,131210116542008.000000000000000,Block 2008, Block Group 2, Census Tract 116.54, Fulton County, Georgia,0,0,0,0,0,0,0,0
-1,131210116542009.000000000000000,Block 2009, Block Group 2, Census Tract 116.54, Fulton County, Georgia,0,0,0,0,0,0,0,0
-1,131210116542010.000000000000000,Block 2010, Block Group 2, Census Tract 116.54, Fulton County, Georgia,0,0,0,0,0,0,0,0
-1,131210116542011.000000000000000,Block 2011, Block Group 2, Census Tract 116.54, Fulton County, Georgia,0,0,0,0,0,0,0,0
-1,131210116551003.000000000000000,Block 1003, Block Group 1, Census Tract 116.55, Fulton County, Georgia,0,0,0,0,0,0,0,0
-1,131210116552002.000000000000000,Block 2002, Block Group 2, Census Tract 116.55, Fulton County, Georgia,0,0,0,0,0,0,0,0
-1,131210116552003.000000000000000,Block 2003, Block Group 2, Census Tract 116.55, Fulton County, Georgia,0,0,0,0,0,0,0,0
-1,131210116552013.000000000000000,Block 2013, Block Group 2, Census Tract 116.55, Fulton County, Georgia,0,0,0,0,0,0,0,0
-1,131210116552015.000000000000000,Block 2015, Block Group 2, Census Tract 116.55, Fulton County, Georgia,0,0,0,0,0,0,0,0
-1,131210116561002.000000000000000,Block 1002, Block Group 1, Census Tract 116.56, Fulton County, Georgia,0,0,0,0,0,0,0,0
-1,131210116561004.000000000000000,Block 1004, Block Group 1, Census Tract 116.56, Fulton County, Georgia,0,0,0,0,0,0,0,0
-1,131210116561005.000000000000000,Block 1005, Block Group 1, Census Tract 116.56, Fulton County, Georgia,0,0,0,0,0,0,0,0
-1,131210116562002.000000000000000,Block 2002, Block Group 2, Census Tract 116.56, Fulton County, Georgia,0,0,0,0,0,0,0,0
-1,131210116562003.000000000000000,Block 2003, Block Group 2, Census Tract 116.56, Fulton County, Georgia,0,0,0,0,0,0,0,0
-1,131210116562005.000000000000000,Block 2005, Block Group 2, Census Tract 116.56, Fulton County, Georgia,0,0,0,0,0,0,0,0
-1,131210116562008.000000000000000,Block 2008, Block Group 2, Census Tract 116.56, Fulton County, Georgia,0,0,0,0,0,0,0,0
-1,131210116562009.000000000000000,Block 2009, Block Group 2, Census Tract 116.56, Fulton County, Georgia,0,0,0,0,0,0,0,0
-1,131210116562010.000000000000000,Block 2010, Block Group 2, Census Tract 116.56, Fulton County, Georgia,0,0,0,0,0,0,0,0
-1,131210116562013.000000000000000,Block 2013, Block Group 2, Census Tract 116.56, Fulton County, Georgia,0,0,0,0,0,0,0,0
-1,131210116562014.000000000000000,Block 2014, Block Group 2, Census Tract 116.56, Fulton County, Georgia,0,0,0,0,0,0,0,0
-1,131210116581006.000000000000000,Block 1006, Block Group 1, Census Tract 116.58, Fulton County, Georgia,0,0,0,0,0,0,0,0
-1,131210116581007.000000000000000,Block 1007, Block Group 1, Census Tract 116.58, Fulton County, Georgia,0,0,0,0,0,0,0,0
-1,131210116581008.000000000000000,Block 1008, Block Group 1, Census Tract 116.58, Fulton County, Georgia,0,0,0,0,0,0,0,0
-1,131210116582006.000000000000000,Block 2006, Block Group 2, Census Tract 116.58, Fulton County, Georgia,0,0,0,0,0,0,0,0
-1,131210116582011.000000000000000,Block 2011, Block Group 2, Census Tract 116.58, Fulton County, Georgia,0,0,0,0,0,0,0,0
-1,131210116601000.000000000000000,Block 1000, Block Group 1, Census Tract 116.60, Fulton County, Georgia,0,0,0,0,0,0,0,0
-1,131210116601016.000000000000000,Block 1016, Block Group 1, Census Tract 116.60, Fulton County, Georgia,0,0,0,0,0,0,0,0
-1,131210116601017.000000000000000,Block 1017, Block Group 1, Census Tract 116.60, Fulton County, Georgia,0,0,0,0,0,0,0,0
-1,131210116601018.000000000000000,Block 1018, Block Group 1, Census Tract 116.60, Fulton County, Georgia,0,0,0,0,0,0,0,0
-1,131210116601019.000000000000000,Block 1019, Block Group 1, Census Tract 116.60, Fulton County, Georgia,0,0,0,0,0,0,0,0
-1,131210116602000.000000000000000,Block 2000, Block Group 2, Census Tract 116.60, Fulton County, Georgia,0,0,0,0,0,0,0,0
-1,131210116602001.000000000000000,Block 2001, Block Group 2, Census Tract 116.60, Fulton County, Georgia,0,0,0,0,0,0,0,0
-1,131210116602003.000000000000000,Block 2003, Block Group 2, Census Tract 116.60, Fulton County, Georgia,0,0,0,0,0,0,0,0
-1,131210116602015.000000000000000,Block 2015, Block Group 2, Census Tract 116.60, Fulton County, Georgia,0,0,0,0,0,0,0,0
-1,131210116602017.000000000000000,Block 2017, Block Group 2, Census Tract 116.60, Fulton County, Georgia,0,0,0,0,0,0,0,0
-1,131210116602022.000000000000000,Block 2022, Block Group 2, Census Tract 116.60, Fulton County, Georgia,0,0,0,0,0,0,0,0
-1,131210116602023.000000000000000,Block 2023, Block Group 2, Census Tract 116.60, Fulton County, Georgia,0,0,0,0,0,0,0,0
-1,131210116611000.000000000000000,Block 1000, Block Group 1, Census Tract 116.61, Fulton County, Georgia,0,0,0,0,0,0,0,0
-1,131210116611004.000000000000000,Block 1004, Block Group 1, Census Tract 116.61, Fulton County, Georgia,0,0,0,0,0,0,0,0
-1,131210118011001.000000000000000,Block 1001, Block Group 1, Census Tract 118.01, Fulton County, Georgia,0,0,0,0,0,0,0,0
-1,131210118011002.000000000000000,Block 1002, Block Group 1, Census Tract 118.01, Fulton County, Georgia,0,0,0,0,0,0,0,0
-1,131210118011003.000000000000000,Block 1003, Block Group 1, Census Tract 118.01, Fulton County, Georgia,0,0,0,0,0,0,0,0
-1,131210118011004.000000000000000,Block 1004, Block Group 1, Census Tract 118.01, Fulton County, Georgia,0,0,0,0,0,0,0,0
-1,131210118011005.000000000000000,Block 1005, Block Group 1, Census Tract 118.01, Fulton County, Georgia,0,0,0,0,0,0,0,0
-1,131210118011007.000000000000000,Block 1007, Block Group 1, Census Tract 118.01, Fulton County, Georgia,0,0,0,0,0,0,0,0
-1,131210118011009.000000000000000,Block 1009, Block Group 1, Census Tract 118.01, Fulton County, Georgia,0,0,0,0,0,0,0,0
-1,131210118011010.000000000000000,Block 1010, Block Group 1, Census Tract 118.01, Fulton County, Georgia,0,0,0,0,0,0,0,0
-1,131210118011011.000000000000000,Block 1011, Block Group 1, Census Tract 118.01, Fulton County, Georgia,0,0,0,0,0,0,0,0
-1,131210118011012.000000000000000,Block 1012, Block Group 1, Census Tract 118.01, Fulton County, Georgia,0,0,0,0,0,0,0,0
-1,131210118011013.000000000000000,Block 1013, Block Group 1, Census Tract 118.01, Fulton County, Georgia,0,0,0,0,0,0,0,0
-1,131210118011014.000000000000000,Block 1014, Block Group 1, Census Tract 118.01, Fulton County, Georgia,0,0,0,0,0,0,0,0
-1,131210118011015.000000000000000,Block 1015, Block Group 1, Census Tract 118.01, Fulton County, Georgia,0,0,0,0,0,0,0,0
-1,131210118011016.000000000000000,Block 1016, Block Group 1, Census Tract 118.01, Fulton County, Georgia,0,0,0,0,0,0,0,0
-1,131210118011018.000000000000000,Block 1018, Block Group 1, Census Tract 118.01, Fulton County, Georgia,0,0,0,0,0,0,0,0
-1,131210118011019.000000000000000,Block 1019, Block Group 1, Census Tract 118.01, Fulton County, Georgia,0,0,0,0,0,0,0,0
-1,131210118021000.000000000000000,Block 1000, Block Group 1, Census Tract 118.02, Fulton County, Georgia,0,0,0,0,0,0,0,0
-1,131210118021001.000000000000000,Block 1001, Block Group 1, Census Tract 118.02, Fulton County, Georgia,0,0,0,0,0,0,0,0
-1,131210118021003.000000000000000,Block 1003, Block Group 1, Census Tract 118.02, Fulton County, Georgia,0,0,0,0,0,0,0,0
-1,131210118021004.000000000000000,Block 1004, Block Group 1, Census Tract 118.02, Fulton County, Georgia,0,0,0,0,0,0,0,0
-1,131210118021005.000000000000000,Block 1005, Block Group 1, Census Tract 118.02, Fulton County, Georgia,0,0,0,0,0,0,0,0
-1,131210118021006.000000000000000,Block 1006, Block Group 1, Census Tract 118.02, Fulton County, Georgia,0,0,0,0,0,0,0,0
-1,131210118021007.000000000000000,Block 1007, Block Group 1, Census Tract 118.02, Fulton County, Georgia,0,0,0,0,0,0,0,0
-1,131210118021008.000000000000000,Block 1008, Block Group 1, Census Tract 118.02, Fulton County, Georgia,0,0,0,0,0,0,0,0
-1,131210118021009.000000000000000,Block 1009, Block Group 1, Census Tract 118.02, Fulton County, Georgia,0,0,0,0,0,0,0,0
-1,131210118021015.000000000000000,Block 1015, Block Group 1, Census Tract 118.02, Fulton County, Georgia,0,0,0,0,0,0,0,0
-1,131210118022000.000000000000000,Block 2000, Block Group 2, Census Tract 118.02, Fulton County, Georgia,0,0,0,0,0,0,0,0
-1,131210118022001.000000000000000,Block 2001, Block Group 2, Census Tract 118.02, Fulton County, Georgia,0,0,0,0,0,0,0,0
-1,131210118022002.000000000000000,Block 2002, Block Group 2, Census Tract 118.02, Fulton County, Georgia,0,0,0,0,0,0,0,0
-1,131210118022004.000000000000000,Block 2004, Block Group 2, Census Tract 118.02, Fulton County, Georgia,0,0,0,0,0,0,0,0
-1,131210118022005.000000000000000,Block 2005, Block Group 2, Census Tract 118.02, Fulton County, Georgia,0,0,0,0,0,0,0,0
-1,131210118022007.000000000000000,Block 2007, Block Group 2, Census Tract 118.02, Fulton County, Georgia,0,0,0,0,0,0,0,0
-1,131210118022019.000000000000000,Block 2019, Block Group 2, Census Tract 118.02, Fulton County, Georgia,0,0,0,0,0,0,0,0
-1,131210118022020.000000000000000,Block 2020, Block Group 2, Census Tract 118.02, Fulton County, Georgia,0,0,0,0,0,0,0,0
-1,131210118022021.000000000000000,Block 2021, Block Group 2, Census Tract 118.02, Fulton County, Georgia,0,0,0,0,0,0,0,0
-1,131210118022022.000000000000000,Block 2022, Block Group 2, Census Tract 118.02, Fulton County, Georgia,0,0,0,0,0,0,0,0
-1,131210118022026.000000000000000,Block 2026, Block Group 2, Census Tract 118.02, Fulton County, Georgia,0,0,0,0,0,0,0,0
-1,131210119011001.000000000000000,Block 1001, Block Group 1, Census Tract 119.01, Fulton County, Georgia,0,0,0,0,0,0,0,0
-1,131210119011002.000000000000000,Block 1002, Block Group 1, Census Tract 119.01, Fulton County, Georgia,0,0,0,0,0,0,0,0
-1,131210119011004.000000000000000,Block 1004, Block Group 1, Census Tract 119.01, Fulton County, Georgia,0,0,0,0,0,0,0,0
-1,131210119011005.000000000000000,Block 1005, Block Group 1, Census Tract 119.01, Fulton County, Georgia,0,0,0,0,0,0,0,0
-1,131210119011006.000000000000000,Block 1006, Block Group 1, Census Tract 119.01, Fulton County, Georgia,0,0,0,0,0,0,0,0
-1,131210119011007.000000000000000,Block 1007, Block Group 1, Census Tract 119.01, Fulton County, Georgia,0,0,0,0,0,0,0,0
-1,131210119011008.000000000000000,Block 1008, Block Group 1, Census Tract 119.01, Fulton County, Georgia,0,0,0,0,0,0,0,0
-1,131210119011009.000000000000000,Block 1009, Block Group 1, Census Tract 119.01, Fulton County, Georgia,0,0,0,0,0,0,0,0
-1,131210119011010.000000000000000,Block 1010, Block Group 1, Census Tract 119.01, Fulton County, Georgia,0,0,0,0,0,0,0,0
-1,131210119011011.000000000000000,Block 1011, Block Group 1, Census Tract 119.01, Fulton County, Georgia,0,0,0,0,0,0,0,0
-1,131210119011012.000000000000000,Block 1012, Block Group 1, Census Tract 119.01, Fulton County, Georgia,0,0,0,0,0,0,0,0
-1,131210119011014.000000000000000,Block 1014, Block Group 1, Census Tract 119.01, Fulton County, Georgia,0,0,0,0,0,0,0,0
-1,131210119011015.000000000000000,Block 1015, Block Group 1, Census Tract 119.01, Fulton County, Georgia,0,0,0,0,0,0,0,0
-1,131210119011017.000000000000000,Block 1017, Block Group 1, Census Tract 119.01, Fulton County, Georgia,0,0,0,0,0,0,0,0
-1,131210119011020.000000000000000,Block 1020, Block Group 1, Census Tract 119.01, Fulton County, Georgia,0,0,0,0,0,0,0,0
-1,131210119011021.000000000000000,Block 1021, Block Group 1, Census Tract 119.01, Fulton County, Georgia,0,0,0,0,0,0,0,0
-1,131210119011023.000000000000000,Block 1023, Block Group 1, Census Tract 119.01, Fulton County, Georgia,0,0,0,0,0,0,0,0
-1,131210119011024.000000000000000,Block 1024, Block Group 1, Census Tract 119.01, Fulton County, Georgia,0,0,0,0,0,0,0,0
-1,131210119011025.000000000000000,Block 1025, Block Group 1, Census Tract 119.01, Fulton County, Georgia,0,0,0,0,0,0,0,0
-1,131210119011026.000000000000000,Block 1026, Block Group 1, Census Tract 119.01, Fulton County, Georgia,0,0,0,0,0,0,0,0
-1,131210119011029.000000000000000,Block 1029, Block Group 1, Census Tract 119.01, Fulton County, Georgia,0,0,0,0,0,0,0,0
-1,131210119011030.000000000000000,Block 1030, Block Group 1, Census Tract 119.01, Fulton County, Georgia,0,0,0,0,0,0,0,0
-1,131210119011031.000000000000000,Block 1031, Block Group 1, Census Tract 119.01, Fulton County, Georgia,0,0,0,0,0,0,0,0
-1,131210119011032.000000000000000,Block 1032, Block Group 1, Census Tract 119.01, Fulton County, Georgia,0,0,0,0,0,0,0,0
-1,131210119011036.000000000000000,Block 1036, Block Group 1, Census Tract 119.01, Fulton County, Georgia,0,0,0,0,0,0,0,0
-1,131210119011037.000000000000000,Block 1037, Block Group 1, Census Tract 119.01, Fulton County, Georgia,0,0,0,0,0,0,0,0
-1,131210119011038.000000000000000,Block 1038, Block Group 1, Census Tract 119.01, Fulton County, Georgia,0,0,0,0,0,0,0,0
-1,131210119011039.000000000000000,Block 1039, Block Group 1, Census Tract 119.01, Fulton County, Georgia,0,0,0,0,0,0,0,0
-1,131210119011041.000000000000000,Block 1041, Block Group 1, Census Tract 119.01, Fulton County, Georgia,0,0,0,0,0,0,0,0
-1,131210119011043.000000000000000,Block 1043, Block Group 1, Census Tract 119.01, Fulton County, Georgia,0,0,0,0,0,0,0,0
-1,131210119011044.000000000000000,Block 1044, Block Group 1, Census Tract 119.01, Fulton County, Georgia,0,0,0,0,0,0,0,0
-1,131210119011046.000000000000000,Block 1046, Block Group 1, Census Tract 119.01, Fulton County, Georgia,0,0,0,0,0,0,0,0
-1,131210119012002.000000000000000,Block 2002, Block Group 2, Census Tract 119.01, Fulton County, Georgia,0,0,0,0,0,0,0,0
-1,131210119013000.000000000000000,Block 3000, Block Group 3, Census Tract 119.01, Fulton County, Georgia,0,0,0,0,0,0,0,0
-1,131210119013001.000000000000000,Block 3001, Block Group 3, Census Tract 119.01, Fulton County, Georgia,0,0,0,0,0,0,0,0
-1,131210119013002.000000000000000,Block 3002, Block Group 3, Census Tract 119.01, Fulton County, Georgia,0,0,0,0,0,0,0,0
-1,131210119013005.000000000000000,Block 3005, Block Group 3, Census Tract 119.01, Fulton County, Georgia,0,0,0,0,0,0,0,0
-1,131210119013006.000000000000000,Block 3006, Block Group 3, Census Tract 119.01, Fulton County, Georgia,0,0,0,0,0,0,0,0
-1,131210119013007.000000000000000,Block 3007, Block Group 3, Census Tract 119.01, Fulton County, Georgia,0,0,0,0,0,0,0,0
-1,131210119013008.000000000000000,Block 3008, Block Group 3, Census Tract 119.01, Fulton County, Georgia,0,0,0,0,0,0,0,0
-1,131210119013010.000000000000000,Block 3010, Block Group 3, Census Tract 119.01, Fulton County, Georgia,0,0,0,0,0,0,0,0
-1,131210119013011.000000000000000,Block 3011, Block Group 3, Census Tract 119.01, Fulton County, Georgia,0,0,0,0,0,0,0,0
-1,131210119013012.000000000000000,Block 3012, Block Group 3, Census Tract 119.01, Fulton County, Georgia,0,0,0,0,0,0,0,0
-1,131210119013013.000000000000000,Block 3013, Block Group 3, Census Tract 119.01, Fulton County, Georgia,0,0,0,0,0,0,0,0
-1,131210119013015.000000000000000,Block 3015, Block Group 3, Census Tract 119.01, Fulton County, Georgia,0,0,0,0,0,0,0,0
-1,131210119013016.000000000000000,Block 3016, Block Group 3, Census Tract 119.01, Fulton County, Georgia,0,0,0,0,0,0,0,0
-1,131210119013018.000000000000000,Block 3018, Block Group 3, Census Tract 119.01, Fulton County, Georgia,0,0,0,0,0,0,0,0
-1,131210119013019.000000000000000,Block 3019, Block Group 3, Census Tract 119.01, Fulton County, Georgia,0,0,0,0,0,0,0,0
-1,131210119013020.000000000000000,Block 3020, Block Group 3, Census Tract 119.01, Fulton County, Georgia,0,0,0,0,0,0,0,0
-1,131210119013021.000000000000000,Block 3021, Block Group 3, Census Tract 119.01, Fulton County, Georgia,0,0,0,0,0,0,0,0
-1,131210119013023.000000000000000,Block 3023, Block Group 3, Census Tract 119.01, Fulton County, Georgia,0,0,0,0,0,0,0,0
-1,131210119013025.000000000000000,Block 3025, Block Group 3, Census Tract 119.01, Fulton County, Georgia,0,0,0,0,0,0,0,0
-1,131210119013026.000000000000000,Block 3026, Block Group 3, Census Tract 119.01, Fulton County, Georgia,0,0,0,0,0,0,0,0
-1,131210119013027.000000000000000,Block 3027, Block Group 3, Census Tract 119.01, Fulton County, Georgia,0,0,0,0,0,0,0,0
-1,131210119013028.000000000000000,Block 3028, Block Group 3, Census Tract 119.01, Fulton County, Georgia,0,0,0,0,0,0,0,0
-1,131210119013029.000000000000000,Block 3029, Block Group 3, Census Tract 119.01, Fulton County, Georgia,0,0,0,0,0,0,0,0
-1,131210119013030.000000000000000,Block 3030, Block Group 3, Census Tract 119.01, Fulton County, Georgia,0,0,0,0,0,0,0,0
-1,131210119013033.000000000000000,Block 3033, Block Group 3, Census Tract 119.01, Fulton County, Georgia,0,0,0,0,0,0,0,0
-1,131210119013034.000000000000000,Block 3034, Block Group 3, Census Tract 119.01, Fulton County, Georgia,0,0,0,0,0,0,0,0
-1,131210119013035.000000000000000,Block 3035, Block Group 3, Census Tract 119.01, Fulton County, Georgia,0,0,0,0,0,0,0,0
-1,131210119013036.000000000000000,Block 3036, Block Group 3, Census Tract 119.01, Fulton County, Georgia,0,0,0,0,0,0,0,0
-1,131210119013038.000000000000000,Block 3038, Block Group 3, Census Tract 119.01, Fulton County, Georgia,0,0,0,0,0,0,0,0
-1,131210119013039.000000000000000,Block 3039, Block Group 3, Census Tract 119.01, Fulton County, Georgia,0,0,0,0,0,0,0,0
-1,131210119021000.000000000000000,Block 1000, Block Group 1, Census Tract 119.02, Fulton County, Georgia,0,0,0,0,0,0,0,0
-1,131210119021004.000000000000000,Block 1004, Block Group 1, Census Tract 119.02, Fulton County, Georgia,0,0,0,0,0,0,0,0
-1,131210119021007.000000000000000,Block 1007, Block Group 1, Census Tract 119.02, Fulton County, Georgia,0,0,0,0,0,0,0,0
-1,131210119021008.000000000000000,Block 1008, Block Group 1, Census Tract 119.02, Fulton County, Georgia,0,0,0,0,0,0,0,0
-1,131210119021012.000000000000000,Block 1012, Block Group 1, Census Tract 119.02, Fulton County, Georgia,0,0,0,0,0,0,0,0
-1,131210119021013.000000000000000,Block 1013, Block Group 1, Census Tract 119.02, Fulton County, Georgia,0,0,0,0,0,0,0,0
-1,131210119021014.000000000000000,Block 1014, Block Group 1, Census Tract 119.02, Fulton County, Georgia,0,0,0,0,0,0,0,0
-1,131210119022000.000000000000000,Block 2000, Block Group 2, Census Tract 119.02, Fulton County, Georgia,0,0,0,0,0,0,0,0
-1,131210119022001.000000000000000,Block 2001, Block Group 2, Census Tract 119.02, Fulton County, Georgia,0,0,0,0,0,0,0,0
-1,131210119022002.000000000000000,Block 2002, Block Group 2, Census Tract 119.02, Fulton County, Georgia,0,0,0,0,0,0,0,0
-1,131210119022010.000000000000000,Block 2010, Block Group 2, Census Tract 119.02, Fulton County, Georgia,0,0,0,0,0,0,0,0
-1,131210119022012.000000000000000,Block 2012, Block Group 2, Census Tract 119.02, Fulton County, Georgia,0,0,0,0,0,0,0,0
-1,131210120001000.000000000000000,Block 1000, Block Group 1, Census Tract 120, Fulton County, Georgia,0,0,0,0,0,0,0,0
-1,131210120001005.000000000000000,Block 1005, Block Group 1, Census Tract 120, Fulton County, Georgia,0,0,0,0,0,0,0,0
-1,131210120001010.000000000000000,Block 1010, Block Group 1, Census Tract 120, Fulton County, Georgia,0,0,0,0,0,0,0,0
-1,131210120001016.000000000000000,Block 1016, Block Group 1, Census Tract 120, Fulton County, Georgia,0,0,0,0,0,0,0,0
-1,131210120001018.000000000000000,Block 1018, Block Group 1, Census Tract 120, Fulton County, Georgia,0,0,0,0,0,0,0,0
-1,131210120002000.000000000000000,Block 2000, Block Group 2, Census Tract 120, Fulton County, Georgia,0,0,0,0,0,0,0,0
-1,131210120002001.000000000000000,Block 2001, Block Group 2, Census Tract 120, Fulton County, Georgia,0,0,0,0,0,0,0,0
-1,131210120002002.000000000000000,Block 2002, Block Group 2, Census Tract 120, Fulton County, Georgia,0,0,0,0,0,0,0,0
-1,131210120002018.000000000000000,Block 2018, Block Group 2, Census Tract 120, Fulton County, Georgia,0,0,0,0,0,0,0,0
-1,131210120002022.000000000000000,Block 2022, Block Group 2, Census Tract 120, Fulton County, Georgia,0,0,0,0,0,0,0,0
-1,131210120002023.000000000000000,Block 2023, Block Group 2, Census Tract 120, Fulton County, Georgia,0,0,0,0,0,0,0,0
-1,131210120003000.000000000000000,Block 3000, Block Group 3, Census Tract 120, Fulton County, Georgia,0,0,0,0,0,0,0,0
-1,131210120003001.000000000000000,Block 3001, Block Group 3, Census Tract 120, Fulton County, Georgia,0,0,0,0,0,0,0,0
-1,131210120003005.000000000000000,Block 3005, Block Group 3, Census Tract 120, Fulton County, Georgia,0,0,0,0,0,0,0,0
-1,131210120003006.000000000000000,Block 3006, Block Group 3, Census Tract 120, Fulton County, Georgia,0,0,0,0,0,0,0,0
-1,131210120003007.000000000000000,Block 3007, Block Group 3, Census Tract 120, Fulton County, Georgia,0,0,0,0,0,0,0,0
-1,131210120003008.000000000000000,Block 3008, Block Group 3, Census Tract 120, Fulton County, Georgia,0,0,0,0,0,0,0,0
-1,131210120003009.000000000000000,Block 3009, Block Group 3, Census Tract 120, Fulton County, Georgia,0,0,0,0,0,0,0,0
-1,131210120003010.000000000000000,Block 3010, Block Group 3, Census Tract 120, Fulton County, Georgia,0,0,0,0,0,0,0,0
-1,131210120003012.000000000000000,Block 3012, Block Group 3, Census Tract 120, Fulton County, Georgia,0,0,0,0,0,0,0,0
-1,131210120003013.000000000000000,Block 3013, Block Group 3, Census Tract 120, Fulton County, Georgia,0,0,0,0,0,0,0,0
-1,131210120003016.000000000000000,Block 3016, Block Group 3, Census Tract 120, Fulton County, Georgia,0,0,0,0,0,0,0,0
-1,131210120003017.000000000000000,Block 3017, Block Group 3, Census Tract 120, Fulton County, Georgia,0,0,0,0,0,0,0,0
-1,131210120003018.000000000000000,Block 3018, Block Group 3, Census Tract 120, Fulton County, Georgia,0,0,0,0,0,0,0,0
-1,131210120003019.000000000000000,Block 3019, Block Group 3, Census Tract 120, Fulton County, Georgia,0,0,0,0,0,0,0,0
-1,131210120003020.000000000000000,Block 3020, Block Group 3, Census Tract 120, Fulton County, Georgia,0,0,0,0,0,0,0,0
-1,131210120003021.000000000000000,Block 3021, Block Group 3, Census Tract 120, Fulton County, Georgia,0,0,0,0,0,0,0,0
-1,131210120003023.000000000000000,Block 3023, Block Group 3, Census Tract 120, Fulton County, Georgia,0,0,0,0,0,0,0,0
-1,131210120003024.000000000000000,Block 3024, Block Group 3, Census Tract 120, Fulton County, Georgia,0,0,0,0,0,0,0,0
-1,131210120003025.000000000000000,Block 3025, Block Group 3, Census Tract 120, Fulton County, Georgia,0,0,0,0,0,0,0,0
-1,131210120003026.000000000000000,Block 3026, Block Group 3, Census Tract 120, Fulton County, Georgia,0,0,0,0,0,0,0,0
-1,131210120003033.000000000000000,Block 3033, Block Group 3, Census Tract 120, Fulton County, Georgia,0,0,0,0,0,0,0,0
-1,131210120003034.000000000000000,Block 3034, Block Group 3, Census Tract 120, Fulton County, Georgia,0,0,0,0,0,0,0,0
-1,131210120003035.000000000000000,Block 3035, Block Group 3, Census Tract 120, Fulton County, Georgia,0,0,0,0,0,0,0,0
-1,131210120003044.000000000000000,Block 3044, Block Group 3, Census Tract 120, Fulton County, Georgia,0,0,0,0,0,0,0,0
-1,131210120003046.000000000000000,Block 3046, Block Group 3, Census Tract 120, Fulton County, Georgia,0,0,0,0,0,0,0,0
-1,131210123001000.000000000000000,Block 1000, Block Group 1, Census Tract 123, Fulton County, Georgia,0,0,0,0,0,0,0,0
-1,131210123001009.000000000000000,Block 1009, Block Group 1, Census Tract 123, Fulton County, Georgia,0,0,0,0,0,0,0,0
-1,131210123001010.000000000000000,Block 1010, Block Group 1, Census Tract 123, Fulton County, Georgia,0,0,0,0,0,0,0,0
-1,131210123001011.000000000000000,Block 1011, Block Group 1, Census Tract 123, Fulton County, Georgia,0,0,0,0,0,0,0,0
-1,131210123001012.000000000000000,Block 1012, Block Group 1, Census Tract 123, Fulton County, Georgia,0,0,0,0,0,0,0,0
-1,131210123001017.000000000000000,Block 1017, Block Group 1, Census Tract 123, Fulton County, Georgia,0,0,0,0,0,0,0,0
-1,131210123001018.000000000000000,Block 1018, Block Group 1, Census Tract 123, Fulton County, Georgia,0,0,0,0,0,0,0,0
-1,131210123001019.000000000000000,Block 1019, Block Group 1, Census Tract 123, Fulton County, Georgia,0,0,0,0,0,0,0,0
-1,131210123001020.000000000000000,Block 1020, Block Group 1, Census Tract 123, Fulton County, Georgia,0,0,0,0,0,0,0,0
-1,131210123002000.000000000000000,Block 2000, Block Group 2, Census Tract 123, Fulton County, Georgia,0,0,0,0,0,0,0,0
-1,131210123002002.000000000000000,Block 2002, Block Group 2, Census Tract 123, Fulton County, Georgia,0,0,0,0,0,0,0,0
-1,131210123002003.000000000000000,Block 2003, Block Group 2, Census Tract 123, Fulton County, Georgia,0,0,0,0,0,0,0,0
-1,131210123002004.000000000000000,Block 2004, Block Group 2, Census Tract 123, Fulton County, Georgia,0,0,0,0,0,0,0,0
-1,131210123002005.000000000000000,Block 2005, Block Group 2, Census Tract 123, Fulton County, Georgia,0,0,0,0,0,0,0,0
-1,131210123002006.000000000000000,Block 2006, Block Group 2, Census Tract 123, Fulton County, Georgia,0,0,0,0,0,0,0,0
-1,131210123002007.000000000000000,Block 2007, Block Group 2, Census Tract 123, Fulton County, Georgia,0,0,0,0,0,0,0,0
-1,131210123002012.000000000000000,Block 2012, Block Group 2, Census Tract 123, Fulton County, Georgia,0,0,0,0,0,0,0,0
-1,131210123002013.000000000000000,Block 2013, Block Group 2, Census Tract 123, Fulton County, Georgia,0,0,0,0,0,0,0,0
-1,131210123002014.000000000000000,Block 2014, Block Group 2, Census Tract 123, Fulton County, Georgia,0,0,0,0,0,0,0,0
-1,131210123002015.000000000000000,Block 2015, Block Group 2, Census Tract 123, Fulton County, Georgia,0,0,0,0,0,0,0,0
-1,131210123002016.000000000000000,Block 2016, Block Group 2, Census Tract 123, Fulton County, Georgia,0,0,0,0,0,0,0,0
-1,131210123002017.000000000000000,Block 2017, Block Group 2, Census Tract 123, Fulton County, Georgia,0,0,0,0,0,0,0,0
-1,131210123002018.000000000000000,Block 2018, Block Group 2, Census Tract 123, Fulton County, Georgia,0,0,0,0,0,0,0,0
-1,131210123002021.000000000000000,Block 2021, Block Group 2, Census Tract 123, Fulton County, Georgia,0,0,0,0,0,0,0,0
-1,131210123002024.000000000000000,Block 2024, Block Group 2, Census Tract 123, Fulton County, Georgia,0,0,0,0,0,0,0,0
-1,131210123002026.000000000000000,Block 2026, Block Group 2, Census Tract 123, Fulton County, Georgia,0,0,0,0,0,0,0,0
-1,131210123002027.000000000000000,Block 2027, Block Group 2, Census Tract 123, Fulton County, Georgia,0,0,0,0,0,0,0,0
-1,131210123002038.000000000000000,Block 2038, Block Group 2, Census Tract 123, Fulton County, Georgia,0,0,0,0,0,0,0,0
-1,131210123002039.000000000000000,Block 2039, Block Group 2, Census Tract 123, Fulton County, Georgia,0,0,0,0,0,0,0,0
-1,131210123002042.000000000000000,Block 2042, Block Group 2, Census Tract 123, Fulton County, Georgia,0,0,0,0,0,0,0,0
-1,131210123002043.000000000000000,Block 2043, Block Group 2, Census Tract 123, Fulton County, Georgia,0,0,0,0,0,0,0,0
-1,131210123002044.000000000000000,Block 2044, Block Group 2, Census Tract 123, Fulton County, Georgia,0,0,0,0,0,0,0,0
-1,131210123002048.000000000000000,Block 2048, Block Group 2, Census Tract 123, Fulton County, Georgia,0,0,0,0,0,0,0,0
-1,131210123002049.000000000000000,Block 2049, Block Group 2, Census Tract 123, Fulton County, Georgia,0,0,0,0,0,0,0,0
-1,131210123002050.000000000000000,Block 2050, Block Group 2, Census Tract 123, Fulton County, Georgia,0,0,0,0,0,0,0,0
-1,131210123002051.000000000000000,Block 2051, Block Group 2, Census Tract 123, Fulton County, Georgia,0,0,0,0,0,0,0,0
-1,131210123002052.000000000000000,Block 2052, Block Group 2, Census Tract 123, Fulton County, Georgia,0,0,0,0,0,0,0,0
-1,131210123002057.000000000000000,Block 2057, Block Group 2, Census Tract 123, Fulton County, Georgia,0,0,0,0,0,0,0,0
-1,131210123002058.000000000000000,Block 2058, Block Group 2, Census Tract 123, Fulton County, Georgia,0,0,0,0,0,0,0,0
-1,131210123003003.000000000000000,Block 3003, Block Group 3, Census Tract 123, Fulton County, Georgia,0,0,0,0,0,0,0,0
-1,131210123003014.000000000000000,Block 3014, Block Group 3, Census Tract 123, Fulton County, Georgia,0,0,0,0,0,0,0,0
-1,131210123003025.000000000000000,Block 3025, Block Group 3, Census Tract 123, Fulton County, Georgia,0,0,0,0,0,0,0,0
-1,131210123003030.000000000000000,Block 3030, Block Group 3, Census Tract 123, Fulton County, Georgia,0,0,0,0,0,0,0,0
-1,131210123003031.000000000000000,Block 3031, Block Group 3, Census Tract 123, Fulton County, Georgia,0,0,0,0,0,0,0,0
-1,131210123003032.000000000000000,Block 3032, Block Group 3, Census Tract 123, Fulton County, Georgia,0,0,0,0,0,0,0,0
-1,131210123003033.000000000000000,Block 3033, Block Group 3, Census Tract 123, Fulton County, Georgia,0,0,0,0,0,0,0,0
-1,131210123003034.000000000000000,Block 3034, Block Group 3, Census Tract 123, Fulton County, Georgia,0,0,0,0,0,0,0,0
-1,131210123003035.000000000000000,Block 3035, Block Group 3, Census Tract 123, Fulton County, Georgia,0,0,0,0,0,0,0,0
-1,131210123003036.000000000000000,Block 3036, Block Group 3, Census Tract 123, Fulton County, Georgia,0,0,0,0,0,0,0,0
-1,131210123003037.000000000000000,Block 3037, Block Group 3, Census Tract 123, Fulton County, Georgia,0,0,0,0,0,0,0,0
-1,131210123004000.000000000000000,Block 4000, Block Group 4, Census Tract 123, Fulton County, Georgia,0,0,0,0,0,0,0,0
-1,131210123004005.000000000000000,Block 4005, Block Group 4, Census Tract 123, Fulton County, Georgia,0,0,0,0,0,0,0,0
-1,131210123004008.000000000000000,Block 4008, Block Group 4, Census Tract 123, Fulton County, Georgia,0,0,0,0,0,0,0,0
-1,131210123004009.000000000000000,Block 4009, Block Group 4, Census Tract 123, Fulton County, Georgia,0,0,0,0,0,0,0,0
-1,131210123004010.000000000000000,Block 4010, Block Group 4, Census Tract 123, Fulton County, Georgia,0,0,0,0,0,0,0,0
-1,131210123004011.000000000000000,Block 4011, Block Group 4, Census Tract 123, Fulton County, Georgia,0,0,0,0,0,0,0,0
-1,131210123004012.000000000000000,Block 4012, Block Group 4, Census Tract 123, Fulton County, Georgia,0,0,0,0,0,0,0,0
-1,131210123004019.000000000000000,Block 4019, Block Group 4, Census Tract 123, Fulton County, Georgia,0,0,0,0,0,0,0,0
-1,131210123004021.000000000000000,Block 4021, Block Group 4, Census Tract 123, Fulton County, Georgia,0,0,0,0,0,0,0,0
-1,131210123004022.000000000000000,Block 4022, Block Group 4, Census Tract 123, Fulton County, Georgia,0,0,0,0,0,0,0,0
-1,131210123004031.000000000000000,Block 4031, Block Group 4, Census Tract 123, Fulton County, Georgia,0,0,0,0,0,0,0,0
-1,131210123004032.000000000000000,Block 4032, Block Group 4, Census Tract 123, Fulton County, Georgia,0,0,0,0,0,0,0,0
-1,131219800001000.000000000000000,Block 1000, Block Group 1, Census Tract 9800, Fulton County, Georgia,0,0,0,0,0,0,0,0
-1,131219800001001.000000000000000,Block 1001, Block Group 1, Census Tract 9800, Fulton County, Georgia,0,0,0,0,0,0,0,0
-1,131219800001002.000000000000000,Block 1002, Block Group 1, Census Tract 9800, Fulton County, Georgia,0,0,0,0,0,0,0,0
-1,131219800001003.000000000000000,Block 1003, Block Group 1, Census Tract 9800, Fulton County, Georgia,0,0,0,0,0,0,0,0
-1,131219800001004.000000000000000,Block 1004, Block Group 1, Census Tract 9800, Fulton County, Georgia,0,0,0,0,0,0,0,0
-1,131219800001005.000000000000000,Block 1005, Block Group 1, Census Tract 9800, Fulton County, Georgia,0,0,0,0,0,0,0,0
-1,131219800001006.000000000000000,Block 1006, Block Group 1, Census Tract 9800, Fulton County, Georgia,0,0,0,0,0,0,0,0
-1,131219800001007.000000000000000,Block 1007, Block Group 1, Census Tract 9800, Fulton County, Georgia,0,0,0,0,0,0,0,0
-1,131219800001008.000000000000000,Block 1008, Block Group 1, Census Tract 9800, Fulton County, Georgia,0,0,0,0,0,0,0,0
-1,131219800001009.000000000000000,Block 1009, Block Group 1, Census Tract 9800, Fulton County, Georgia,0,0,0,0,0,0,0,0
-1,131219800001010.000000000000000,Block 1010, Block Group 1, Census Tract 9800, Fulton County, Georgia,0,0,0,0,0,0,0,0
-1,131219800001011.000000000000000,Block 1011, Block Group 1, Census Tract 9800, Fulton County, Georgia,0,0,0,0,0,0,0,0
-1,131219800001012.000000000000000,Block 1012, Block Group 1, Census Tract 9800, Fulton County, Georgia,0,0,0,0,0,0,0,0
-1,131219800001013.000000000000000,Block 1013, Block Group 1, Census Tract 9800, Fulton County, Georgia,0,0,0,0,0,0,0,0
-1,131219800001014.000000000000000,Block 1014, Block Group 1, Census Tract 9800, Fulton County, Georgia,0,0,0,0,0,0,0,0
-1,131219800001015.000000000000000,Block 1015, Block Group 1, Census Tract 9800, Fulton County, Georgia,0,0,0,0,0,0,0,0
-1,131219800001016.000000000000000,Block 1016, Block Group 1, Census Tract 9800, Fulton County, Georgia,0,0,0,0,0,0,0,0
-1,131219800001017.000000000000000,Block 1017, Block Group 1, Census Tract 9800, Fulton County, Georgia,0,0,0,0,0,0,0,0
-1,131219800001018.000000000000000,Block 1018, Block Group 1, Census Tract 9800, Fulton County, Georgia,0,0,0,0,0,0,0,0
-1,131219800001019.000000000000000,Block 1019, Block Group 1, Census Tract 9800, Fulton County, Georgia,0,0,0,0,0,0,0,0
